num,GL02,GL02-GL55,date,contra_account,contra_account_name,note,debit_amount,credit_amount,balance
,,,,111,現金,,29608790,28847774,761016
2,0001-20090401-18-1-1-463,0,2009-04-01,726,旅費交通費,旅費,0,18572,-18572
3,0001-20090401-18-1-1-463,1,2009-04-01,191,仮払消費税等,旅費,0,928,-19500
6,0001-20090401-246-2-1-465,0,2009-04-01,726,旅費交通費,旅費,0,9524,-29024
7,0001-20090401-246-2-1-465,1,2009-04-01,191,仮払消費税等,旅費,0,476,-29500
10,0001-20090402-122-5-1-471,0,2009-04-02,727,通信費,証明書発行手数料,0,1000,-30500
11,0001-20090402-122-5-1-471,1,2009-04-02,191,仮払消費税等,証明書発行手数料,0,50,-30550
14,0001-20090402-142-6-1-473,0,2009-04-02,740,車両費,高速代,0,2458,-33008
15,0001-20090402-142-6-1-473,1,2009-04-02,191,仮払消費税等,高速代,0,122,-33130
17,0001-20090402-142-6-1-473,3,2009-04-02,740,車両費,駐車代,0,591,-33721
18,0001-20090402-142-6-1-473,4,2009-04-02,191,仮払消費税等,駐車代,0,29,-33750
19,0001-20090402-142-6-1-473,5,2009-04-02,740,車両費,ガソリン代,0,4620,-38370
20,0001-20090402-142-6-1-473,6,2009-04-02,191,仮払消費税等,ガソリン代,0,230,-38600
21,0001-20090402-142-6-1-473,7,2009-04-02,740,車両費,洗車券代,0,5715,-44315
22,0001-20090402-142-6-1-473,8,2009-04-02,191,仮払消費税等,洗車券代,0,285,-44600
24,0001-20090402-19-3-1-467,0,2009-04-02,726,旅費交通費,旅費,0,10477,-55077
25,0001-20090402-19-3-1-467,1,2009-04-02,191,仮払消費税等,旅費,0,523,-55600
28,0001-20090402-68-4-1-469,0,2009-04-02,791,雑費,トイレットペーパー他,0,2829,-58429
29,0001-20090402-68-4-1-469,1,2009-04-02,191,仮払消費税等,トイレットペーパー他,0,141,-58570
32,0001-20090403-134-8-1-477,0,2009-04-03,754,事務用消耗品費,用紙,0,14858,-73428
33,0001-20090403-134-8-1-477,1,2009-04-03,191,仮払消費税等,用紙,0,742,-74170
37,0001-20090403-41-7-1-475,1,2009-04-03,733,交際接待費,結婚式会費,0,12000,-86170
39,0001-20090404-310-9-1-479,0,2009-04-04,740,車両費,ガソリン代,0,6486,-92656
40,0001-20090404-310-9-1-479,1,2009-04-04,191,仮払消費税等,ガソリン代,0,324,-92980
42,0001-20090404-310-9-1-479,3,2009-04-04,740,車両費,高速代,0,9715,-102695
43,0001-20090404-310-9-1-479,4,2009-04-04,191,仮払消費税等,高速代,0,485,-103180
44,0001-20090404-310-9-1-479,5,2009-04-04,740,車両費,駐車代,0,1200,-104380
45,0001-20090404-310-9-1-479,6,2009-04-04,191,仮払消費税等,駐車代,0,60,-104440
85,0001-20090406-10-16-1-493,0,2009-04-06,740,車両費,ガソリン代,0,4023,-108463
86,0001-20090406-10-16-1-493,1,2009-04-06,191,仮払消費税等,ガソリン代,0,201,-108664
89,0001-20090406-106-19-1-499,0,2009-04-06,733,交際接待費,食事代　ホテルララダ2名,0,5372,-114036
90,0001-20090406-106-19-1-499,1,2009-04-06,191,仮払消費税等,食事代　ホテルララダ2名,0,268,-114304
92,0001-20090406-106-19-1-499,3,2009-04-06,733,交際接待費,飲食代　スナック北新地,0,30648,-144952
93,0001-20090406-106-19-1-499,4,2009-04-06,191,仮払消費税等,飲食代　スナック北新地,0,1532,-146484
95,0001-20090406-110-20-1-501,0,2009-04-06,726,旅費交通費,タクシー代,0,2181,-148665
96,0001-20090406-110-20-1-501,1,2009-04-06,191,仮払消費税等,タクシー代,0,109,-148774
99,0001-20090406-123-21-1-503,0,2009-04-06,727,通信費,切手代,0,38096,-186870
100,0001-20090406-123-21-1-503,1,2009-04-06,191,仮払消費税等,切手代,0,1904,-188774
104,0001-20090406-124-22-1-505,1,2009-04-06,738,租税公課,収入印紙,0,6000,-194774
110,0001-20090406-156-24-1-509,0,2009-04-06,726,旅費交通費,出張旅費,0,7143,-201917
111,0001-20090406-156-24-1-509,1,2009-04-06,191,仮払消費税等,出張旅費,0,357,-202274
114,0001-20090406-236-25-1-511,0,2009-04-06,733,交際接待費,ゴルフプレー代2名,0,25239,-227513
115,0001-20090406-236-25-1-511,1,2009-04-06,191,仮払消費税等,ゴルフプレー代2名,0,1261,-228774
125,0001-20090406-42-17-1-495,0,2009-04-06,733,交際接待費,昼食代　フロンティホテル,0,4429,-233203
126,0001-20090406-42-17-1-495,1,2009-04-06,191,仮払消費税等,昼食代　フロンティホテル,0,221,-233424
129,0001-20090406-84-18-1-497,0,2009-04-06,727,通信費,切手代,0,66667,-300091
130,0001-20090406-84-18-1-497,1,2009-04-06,191,仮払消費税等,切手代,0,3333,-303424
133,0001-20090407-102-35-1-531,0,2009-04-07,733,交際接待費,手土産代　阿部商店,0,1000,-304424
134,0001-20090407-102-35-1-531,1,2009-04-07,191,仮払消費税等,手土産代　阿部商店,0,50,-304474
137,0001-20090407-20-27-1-515,0,2009-04-07,726,旅費交通費,旅費,0,37143,-341617
138,0001-20090407-20-27-1-515,1,2009-04-07,191,仮払消費税等,旅費,0,1857,-343474
141,0001-20090407-21-28-1-517,0,2009-04-07,726,旅費交通費,JR代,0,66191,-409665
142,0001-20090407-21-28-1-517,1,2009-04-07,191,仮払消費税等,JR代,0,3309,-412974
145,0001-20090407-22-29-1-519,0,2009-04-07,726,旅費交通費,旅費,0,47620,-460594
146,0001-20090407-22-29-1-519,1,2009-04-07,191,仮払消費税等,旅費,0,2380,-462974
149,0001-20090407-43-30-1-521,0,2009-04-07,733,交際接待費,手土産代　阿部商事,0,6315,-469289
150,0001-20090407-43-30-1-521,1,2009-04-07,191,仮払消費税等,手土産代　阿部商事,0,315,-469604
153,0001-20090407-56-31-1-523,0,2009-04-07,726,旅費交通費,旅費,0,20477,-490081
154,0001-20090407-56-31-1-523,1,2009-04-07,191,仮払消費税等,旅費,0,1023,-491104
157,0001-20090407-57-32-1-525,0,2009-04-07,726,旅費交通費,JR代,0,93143,-584247
158,0001-20090407-57-32-1-525,1,2009-04-07,191,仮払消費税等,JR代,0,4657,-588904
161,0001-20090407-58-33-1-527,0,2009-04-07,726,旅費交通費,旅費,0,66667,-655571
162,0001-20090407-58-33-1-527,1,2009-04-07,191,仮払消費税等,旅費,0,3333,-658904
165,0001-20090407-69-34-1-529,0,2009-04-07,791,雑費,お茶代,0,1332,-660236
166,0001-20090407-69-34-1-529,1,2009-04-07,191,仮払消費税等,お茶代,0,66,-660302
168,0001-20090407-69-34-1-529,3,2009-04-07,791,雑費,コーヒー代,0,2839,-663141
169,0001-20090407-69-34-1-529,4,2009-04-07,191,仮払消費税等,コーヒー代,0,141,-663282
171,0001-20090408-143-37-1-535,0,2009-04-08,740,車両費,ガソリン代,0,6796,-670078
172,0001-20090408-143-37-1-535,1,2009-04-08,191,仮払消費税等,ガソリン代,0,339,-670417
175,0001-20090408-50-36-1-533,0,2009-04-08,740,車両費,高速代,0,1143,-671560
176,0001-20090408-50-36-1-533,1,2009-04-08,191,仮払消費税等,高速代,0,57,-671617
191,0001-20090410-149-42-1-545,0,2009-04-10,733,交際接待費,食事代　うどん亭4名,0,5486,-677103
192,0001-20090410-149-42-1-545,1,2009-04-10,191,仮払消費税等,食事代　うどん亭4名,0,274,-677377
201,0001-20090410-162-44-1-549,0,2009-04-10,734,会議費,会議　食事代,0,23805,-701182
202,0001-20090410-162-44-1-549,1,2009-04-10,191,仮払消費税等,会議　食事代,0,1190,-702372
250,0001-20090410-248-51-1-563,0,2009-04-10,726,旅費交通費,旅費,0,9953,-712325
251,0001-20090410-248-51-1-563,1,2009-04-10,191,仮払消費税等,旅費,0,497,-712822
313,0001-20090411-229-61-1-583,3,2009-04-11,131,普通預金,引き出し,2000000,0,1287178
317,0001-20090411-73-59-1-579,0,2009-04-11,733,交際接待費,飲食代　居酒屋富士6名,0,25267,1261911
318,0001-20090411-73-59-1-579,1,2009-04-11,191,仮払消費税等,飲食代　居酒屋富士6名,0,1263,1260648
321,0001-20090411-74-60-1-581,0,2009-04-11,733,交際接待費,飲食代　スナック新世界6名,0,37143,1223505
322,0001-20090411-74-60-1-581,1,2009-04-11,191,仮払消費税等,飲食代　スナック新世界6名,0,1857,1221648
325,0001-20090412-155-62-1-585,0,2009-04-12,740,車両費,ガソリン代,0,4500,1217148
326,0001-20090412-155-62-1-585,1,2009-04-12,191,仮払消費税等,ガソリン代,0,225,1216923
328,0001-20090412-155-62-1-585,3,2009-04-12,740,車両費,駐車代,0,572,1216351
329,0001-20090412-155-62-1-585,4,2009-04-12,191,仮払消費税等,駐車代,0,28,1216323
331,0001-20090412-249-63-1-587,0,2009-04-12,726,旅費交通費,旅費,0,10286,1206037
332,0001-20090412-249-63-1-587,1,2009-04-12,191,仮払消費税等,旅費,0,514,1205523
334,0001-20090412-249-63-1-587,3,2009-04-12,726,旅費交通費,タクシー代,0,4762,1200761
335,0001-20090412-249-63-1-587,4,2009-04-12,191,仮払消費税等,タクシー代,0,238,1200523
337,0001-20090412-311-64-1-589,0,2009-04-12,740,車両費,タイヤ交換,0,70477,1130046
338,0001-20090412-311-64-1-589,1,2009-04-12,191,仮払消費税等,タイヤ交換,0,3523,1126523
341,0001-20090413-11-65-1-591,0,2009-04-13,740,車両費,ガソリン代,0,3058,1123465
342,0001-20090413-11-65-1-591,1,2009-04-13,191,仮払消費税等,ガソリン代,0,152,1123313
345,0001-20090413-144-67-1-595,0,2009-04-13,740,車両費,ウォッシャー液代,0,572,1122741
346,0001-20090413-144-67-1-595,1,2009-04-13,191,仮払消費税等,ウォッシャー液代,0,28,1122713
348,0001-20090413-144-67-1-595,3,2009-04-13,740,車両費,高速代,0,2286,1120427
349,0001-20090413-144-67-1-595,4,2009-04-13,191,仮払消費税等,高速代,0,114,1120313
350,0001-20090413-144-67-1-595,5,2009-04-13,740,車両費,ガソリン代,0,5833,1114480
351,0001-20090413-144-67-1-595,6,2009-04-13,191,仮払消費税等,ガソリン代,0,291,1114189
353,0001-20090413-150-68-1-597,0,2009-04-13,733,交際接待費,ゴルフプレー代,0,13334,1100855
354,0001-20090413-150-68-1-597,1,2009-04-13,191,仮払消費税等,ゴルフプレー代,0,666,1100189
357,0001-20090413-158-69-1-599,0,2009-04-13,726,旅費交通費,出張旅費,0,14286,1085903
358,0001-20090413-158-69-1-599,1,2009-04-13,191,仮払消費税等,出張旅費,0,714,1085189
361,0001-20090413-17-66-1-593,0,2009-04-13,740,車両費,ウォッシャー液,0,351,1084838
362,0001-20090413-17-66-1-593,1,2009-04-13,191,仮払消費税等,ウォッシャー液,0,17,1084821
364,0001-20090413-17-66-1-593,3,2009-04-13,740,車両費,駐車代,0,762,1084059
365,0001-20090413-17-66-1-593,4,2009-04-13,191,仮払消費税等,駐車代,0,38,1084021
367,0001-20090414-23-70-1-601,0,2009-04-14,726,旅費交通費,旅費,0,26667,1057354
368,0001-20090414-23-70-1-601,1,2009-04-14,191,仮払消費税等,旅費,0,1333,1056021
370,0001-20090414-23-70-1-601,3,2009-04-14,726,旅費交通費,旅費,0,29524,1026497
371,0001-20090414-23-70-1-601,4,2009-04-14,191,仮払消費税等,旅費,0,1476,1025021
372,0001-20090414-23-70-1-601,5,2009-04-14,726,旅費交通費,旅費,0,36667,988354
373,0001-20090414-23-70-1-601,6,2009-04-14,191,仮払消費税等,旅費,0,1833,986521
375,0001-20090414-46-71-1-603,0,2009-04-14,740,車両費,ガソリン代,0,2341,984180
376,0001-20090414-46-71-1-603,1,2009-04-14,191,仮払消費税等,ガソリン代,0,117,984063
378,0001-20090414-46-71-1-603,3,2009-04-14,740,車両費,駐車代,0,1762,982301
379,0001-20090414-46-71-1-603,4,2009-04-14,191,仮払消費税等,駐車代,0,88,982213
380,0001-20090414-46-71-1-603,5,2009-04-14,740,車両費,高速代,0,3048,979165
381,0001-20090414-46-71-1-603,6,2009-04-14,191,仮払消費税等,高速代,0,152,979013
383,0001-20090414-51-72-1-605,0,2009-04-14,740,車両費,高速代,0,1505,977508
384,0001-20090414-51-72-1-605,1,2009-04-14,191,仮払消費税等,高速代,0,75,977433
386,0001-20090414-51-72-1-605,3,2009-04-14,740,車両費,駐車代,0,620,976813
387,0001-20090414-51-72-1-605,4,2009-04-14,191,仮払消費税等,駐車代,0,30,976783
388,0001-20090414-51-72-1-605,5,2009-04-14,740,車両費,駐車代,0,810,975973
389,0001-20090414-51-72-1-605,6,2009-04-14,191,仮払消費税等,駐車代,0,40,975933
390,0001-20090414-51-72-1-605,7,2009-04-14,740,車両費,高速代,0,1096,974837
391,0001-20090414-51-72-1-605,8,2009-04-14,191,仮払消費税等,高速代,0,54,974783
394,0001-20090415-117-75-1-611,1,2009-04-15,742,諸会費,会費,0,20000,954783
401,0001-20090415-151-77-1-615,0,2009-04-15,733,交際接待費,飲食代　居酒屋バージョイ,0,16741,938042
402,0001-20090415-151-77-1-615,1,2009-04-15,191,仮払消費税等,飲食代　居酒屋バージョイ,0,837,937205
404,0001-20090415-151-77-1-615,3,2009-04-15,733,交際接待費,飲食代　ハプコミック,0,21000,916205
405,0001-20090415-151-77-1-615,4,2009-04-15,191,仮払消費税等,飲食代　ハプコミック,0,1050,915155
407,0001-20090415-243-78-1-617,0,2009-04-15,740,車両費,ガソリン代,0,5942,909213
408,0001-20090415-243-78-1-617,1,2009-04-15,191,仮払消費税等,ガソリン代,0,297,908916
412,0001-20090415-252-79-1-619,1,2009-04-15,721,雑給,4月給与その他 0060 パート･アルバイト,0,378068,530848
466,0001-20090415-79-74-1-609,0,2009-04-15,724,福利厚生費,景品代,0,43312,487536
467,0001-20090415-79-74-1-609,1,2009-04-15,191,仮払消費税等,景品代,0,2165,485371
470,0001-20090416-103-87-1-635,0,2009-04-16,733,交際接待費,コーヒー代5名,0,2553,482818
471,0001-20090416-103-87-1-635,1,2009-04-16,191,仮払消費税等,コーヒー代5名,0,127,482691
474,0001-20090416-136-88-1-637,0,2009-04-16,791,雑費,ダスキン代,0,15715,466976
475,0001-20090416-136-88-1-637,1,2009-04-16,191,仮払消費税等,ダスキン代,0,785,466191
484,0001-20090417-12-89-1-639,0,2009-04-17,740,車両費,ガソリン代,0,4456,461735
485,0001-20090417-12-89-1-639,1,2009-04-17,191,仮払消費税等,ガソリン代,0,222,461513
487,0001-20090417-12-89-1-639,3,2009-04-17,740,車両費,高速代,0,572,460941
488,0001-20090417-12-89-1-639,4,2009-04-17,191,仮払消費税等,高速代,0,28,460913
489,0001-20090417-12-89-1-639,5,2009-04-17,740,車両費,駐車代,0,1143,459770
490,0001-20090417-12-89-1-639,6,2009-04-17,191,仮払消費税等,駐車代,0,57,459713
492,0001-20090417-47-90-1-641,0,2009-04-17,740,車両費,ガソリン代,0,2420,457293
493,0001-20090417-47-90-1-641,1,2009-04-17,191,仮払消費税等,ガソリン代,0,120,457173
496,0001-20090417-52-91-1-643,0,2009-04-17,740,車両費,ガソリン代,0,2191,454982
497,0001-20090417-52-91-1-643,1,2009-04-17,191,仮払消費税等,ガソリン代,0,109,454873
499,0001-20090417-52-91-1-643,3,2009-04-17,740,車両費,高速代,0,1096,453777
500,0001-20090417-52-91-1-643,4,2009-04-17,191,仮払消費税等,高速代,0,54,453723
501,0001-20090417-52-91-1-643,5,2009-04-17,740,車両費,駐車代,0,1143,452580
502,0001-20090417-52-91-1-643,6,2009-04-17,191,仮払消費税等,駐車代,0,57,452523
504,0001-20090418-237-92-1-645,0,2009-04-18,733,交際接待費,ゴルフプレー代,0,11429,441094
505,0001-20090418-237-92-1-645,1,2009-04-18,191,仮払消費税等,ゴルフプレー代,0,571,440523
508,0001-20090419-244-93-1-647,0,2009-04-19,740,車両費,ガソリン代,0,6727,433796
509,0001-20090419-244-93-1-647,1,2009-04-19,191,仮払消費税等,ガソリン代,0,336,433460
545,0001-20090420-153-114-1-689,0,2009-04-20,733,交際接待費,コーヒー代他2名,0,1848,431612
546,0001-20090420-153-114-1-689,1,2009-04-20,191,仮払消費税等,コーヒー代他2名,0,92,431520
550,0001-20090420-163-115-1-691,1,2009-04-20,742,諸会費,会費,0,18000,413520
564,0001-20090420-24-97-1-655,0,2009-04-20,726,旅費交通費,JR回数券,0,78686,334834
565,0001-20090420-24-97-1-655,1,2009-04-20,191,仮払消費税等,JR回数券,0,3934,330900
626,0001-20090420-45-100-1-661,0,2009-04-20,733,交際接待費,食事代　トン吉4名,0,7867,323033
627,0001-20090420-45-100-1-661,1,2009-04-20,191,仮払消費税等,食事代　トン吉4名,0,393,322640
630,0001-20090420-48-101-1-663,0,2009-04-20,740,車両費,ガソリン代,0,4099,318541
631,0001-20090420-48-101-1-663,1,2009-04-20,191,仮払消費税等,ガソリン代,0,204,318337
634,0001-20090420-53-102-1-665,0,2009-04-20,740,車両費,高速代,0,381,317956
635,0001-20090420-53-102-1-665,1,2009-04-20,191,仮払消費税等,高速代,0,19,317937
637,0001-20090420-53-102-1-665,3,2009-04-20,740,車両費,駐車代,0,2000,315937
638,0001-20090420-53-102-1-665,4,2009-04-20,191,仮払消費税等,駐車代,0,100,315837
639,0001-20090420-53-102-1-665,5,2009-04-20,740,車両費,ガソリン代,0,6102,309735
640,0001-20090420-53-102-1-665,6,2009-04-20,191,仮払消費税等,ガソリン代,0,305,309430
642,0001-20090420-6-95-1-651,0,2009-04-20,732,広告宣伝費,広告料,0,4762,304668
643,0001-20090420-6-95-1-651,1,2009-04-20,191,仮払消費税等,広告料,0,238,304430
654,0001-20090420-7-96-1-653,0,2009-04-20,733,交際接待費,食事代,0,1429,303001
655,0001-20090420-7-96-1-653,1,2009-04-20,191,仮払消費税等,食事代,0,71,302930
657,0001-20090420-7-96-1-653,3,2009-04-20,733,交際接待費,食事代,0,1176,301754
658,0001-20090420-7-96-1-653,4,2009-04-20,191,仮払消費税等,食事代,0,58,301696
691,0001-20090421-126-128-1-717,1,2009-04-21,738,租税公課,収入印紙,0,40000,261696
693,0001-20090421-160-129-1-719,0,2009-04-21,726,旅費交通費,出張旅費,0,66667,195029
694,0001-20090421-160-129-1-719,1,2009-04-21,191,仮払消費税等,出張旅費,0,3333,191696
697,0001-20090421-25-126-1-713,0,2009-04-21,726,旅費交通費,旅費,0,53334,138362
698,0001-20090421-25-126-1-713,1,2009-04-21,191,仮払消費税等,旅費,0,2666,135696
701,0001-20090421-59-127-1-715,0,2009-04-21,726,旅費交通費,旅費,0,28572,107124
702,0001-20090421-59-127-1-715,1,2009-04-21,191,仮払消費税等,旅費,0,1428,105696
705,0001-20090422-104-134-1-729,0,2009-04-22,733,交際接待費,食事代　お好み焼きやきやき2名,0,3172,102524
706,0001-20090422-104-134-1-729,1,2009-04-22,191,仮払消費税等,食事代　お好み焼きやきやき2名,0,158,102366
709,0001-20090422-105-135-1-731,0,2009-04-22,733,交際接待費,飲食代　会費制2名,0,19048,83318
710,0001-20090422-105-135-1-731,1,2009-04-22,191,仮払消費税等,飲食代　会費制2名,0,952,82366
712,0001-20090422-105-135-1-731,3,2009-04-22,733,交際接待費,飲食代　梅田小路5名,0,21905,60461
713,0001-20090422-105-135-1-731,4,2009-04-22,191,仮払消費税等,飲食代　梅田小路5名,0,1095,59366
714,0001-20090422-105-135-1-731,5,2009-04-22,733,交際接待費,食事代　ホテルジャーマニー2名,0,2858,56508
715,0001-20090422-105-135-1-731,6,2009-04-22,191,仮払消費税等,食事代　ホテルジャーマニー2名,0,142,56366
718,0001-20090422-107-136-1-733,1,2009-04-22,733,交際接待費,お見舞い,0,10000,46366
720,0001-20090422-152-137-1-735,0,2009-04-22,733,交際接待費,飲食代　居酒屋くるみ3名,0,13220,33146
721,0001-20090422-152-137-1-735,1,2009-04-22,191,仮払消費税等,飲食代　居酒屋くるみ3名,0,660,32486
724,0001-20090422-161-138-1-737,0,2009-04-22,726,旅費交通費,旅費,0,10334,22152
725,0001-20090422-161-138-1-737,1,2009-04-22,191,仮払消費税等,旅費,0,516,21636
728,0001-20090422-166-139-1-739,0,2009-04-22,791,雑費,ダスキン代,0,1800,19836
729,0001-20090422-166-139-1-739,1,2009-04-22,191,仮払消費税等,ダスキン代,0,90,19746
732,0001-20090422-245-140-1-741,0,2009-04-22,740,車両費,駐車代,0,572,19174
733,0001-20090422-245-140-1-741,1,2009-04-22,191,仮払消費税等,駐車代,0,28,19146
735,0001-20090422-245-140-1-741,3,2009-04-22,740,車両費,高速代,0,762,18384
736,0001-20090422-245-140-1-741,4,2009-04-22,191,仮払消費税等,高速代,0,38,18346
737,0001-20090422-245-140-1-741,5,2009-04-22,740,車両費,ガソリン代,0,5238,13108
738,0001-20090422-245-140-1-741,6,2009-04-22,191,仮払消費税等,ガソリン代,0,261,12847
748,0001-20090422-90-132-1-725,0,2009-04-22,791,雑費,ダスキン代,0,10000,2847
749,0001-20090422-90-132-1-725,1,2009-04-22,191,仮払消費税等,ダスキン代,0,500,2347
756,0001-20090423-140-146-1-753,0,2009-04-23,726,旅費交通費,旅費,0,9858,-7511
757,0001-20090423-140-146-1-753,1,2009-04-23,191,仮払消費税等,旅費,0,492,-8003
760,0001-20090423-141-147-1-755,0,2009-04-23,726,旅費交通費,JR代,0,66191,-74194
761,0001-20090423-141-147-1-755,1,2009-04-23,191,仮払消費税等,JR代,0,3309,-77503
764,0001-20090423-164-148-1-757,0,2009-04-23,754,事務用消耗品費,事務用品,0,1505,-79008
765,0001-20090423-164-148-1-757,1,2009-04-23,191,仮払消費税等,事務用品,0,75,-79083
768,0001-20090423-26-141-1-743,0,2009-04-23,726,旅費交通費,旅費,0,10477,-89560
769,0001-20090423-26-141-1-743,1,2009-04-23,191,仮払消費税等,旅費,0,523,-90083
780,0001-20090423-54-144-1-749,0,2009-04-23,740,車両費,高速代,0,1810,-91893
781,0001-20090423-54-144-1-749,1,2009-04-23,191,仮払消費税等,高速代,0,90,-91983
783,0001-20090423-54-144-1-749,3,2009-04-23,740,車両費,駐車代,0,810,-92793
784,0001-20090423-54-144-1-749,4,2009-04-23,191,仮払消費税等,駐車代,0,40,-92833
786,0001-20090423-86-145-1-751,0,2009-04-23,727,通信費,切手代,0,66667,-159500
787,0001-20090423-86-145-1-751,1,2009-04-23,191,仮払消費税等,切手代,0,3333,-162833
790,0001-20090424-108-150-1-761,0,2009-04-24,733,交際接待費,コーヒー代,0,1296,-164129
791,0001-20090424-108-150-1-761,1,2009-04-24,191,仮払消費税等,コーヒー代,0,64,-164193
794,0001-20090424-159-151-1-763,0,2009-04-24,726,旅費交通費,タクシー代,0,6143,-170336
795,0001-20090424-159-151-1-763,1,2009-04-24,191,仮払消費税等,タクシー代,0,307,-170643
798,0001-20090424-8-149-1-759,0,2009-04-24,733,交際接待費,親睦会会費,0,28572,-199215
799,0001-20090424-8-149-1-759,1,2009-04-24,191,仮払消費税等,親睦会会費,0,1428,-200643
801,0001-20090424-8-149-1-759,3,2009-04-24,733,交際接待費,差し入れ,0,3010,-203653
802,0001-20090424-8-149-1-759,4,2009-04-24,191,仮払消費税等,差し入れ,0,150,-203803
814,0001-20090425-114-158-1-777,0,2009-04-25,739,新聞図書費,新聞代,0,2540,-206343
815,0001-20090425-114-158-1-777,1,2009-04-25,191,仮払消費税等,新聞代,0,126,-206469
817,0001-20090425-114-158-1-777,3,2009-04-25,739,新聞図書費,新聞代,0,2864,-209333
818,0001-20090425-114-158-1-777,4,2009-04-25,191,仮払消費税等,新聞代,0,143,-209476
820,0001-20090425-121-159-1-779,0,2009-04-25,724,福利厚生費,お茶代,0,9524,-219000
821,0001-20090425-121-159-1-779,1,2009-04-25,191,仮払消費税等,お茶代,0,476,-219476
833,0001-20090425-170-162-1-785,0,2009-04-25,739,新聞図書費,新聞代,0,2864,-222340
834,0001-20090425-170-162-1-785,1,2009-04-25,191,仮払消費税等,新聞代,0,143,-222483
847,0001-20090425-238-165-1-791,0,2009-04-25,733,交際接待費,ゴルフプレー代,0,13524,-236007
848,0001-20090425-238-165-1-791,1,2009-04-25,191,仮払消費税等,ゴルフプレー代,0,676,-236683
991,0001-20090425-35-153-1-767,0,2009-04-25,739,新聞図書費,新聞代,0,3739,-240422
992,0001-20090425-35-153-1-767,1,2009-04-25,191,仮払消費税等,新聞代,0,186,-240608
1013,0001-20090426-148-175-1-811,0,2009-04-26,740,車両費,ガソリン代,0,5500,-246108
1014,0001-20090426-148-175-1-811,1,2009-04-26,191,仮払消費税等,ガソリン代,0,275,-246383
1016,0001-20090426-148-175-1-811,3,2009-04-26,740,車両費,高速代,0,1143,-247526
1017,0001-20090426-148-175-1-811,4,2009-04-26,191,仮払消費税等,高速代,0,57,-247583
1045,0001-20090426-88-172-1-805,0,2009-04-26,739,新聞図書費,新聞代,0,3399,-250982
1046,0001-20090426-88-172-1-805,1,2009-04-26,191,仮払消費税等,新聞代,0,169,-251151
1057,0001-20090427-14-180-1-821,0,2009-04-27,740,車両費,ガソリン代,0,2858,-254009
1058,0001-20090427-14-180-1-821,1,2009-04-27,191,仮払消費税等,ガソリン代,0,142,-254151
1061,0001-20090427-15-181-1-823,0,2009-04-27,740,車両費,車両管理費,0,23810,-277961
1062,0001-20090427-15-181-1-823,1,2009-04-27,191,仮払消費税等,車両管理費,0,1190,-279151
1074,0001-20090427-39-184-1-829,0,2009-04-27,724,福利厚生費,会費,0,8572,-287723
1075,0001-20090427-39-184-1-829,1,2009-04-27,191,仮払消費税等,会費,0,428,-288151
1078,0001-20090427-72-185-1-831,0,2009-04-27,739,新聞図書費,新聞代,0,2864,-291015
1079,0001-20090427-72-185-1-831,1,2009-04-27,191,仮払消費税等,新聞代,0,143,-291158
1081,0001-20090427-72-185-1-831,3,2009-04-27,739,新聞図書費,新聞代,0,2815,-293973
1082,0001-20090427-72-185-1-831,4,2009-04-27,191,仮払消費税等,新聞代,0,140,-294113
1083,0001-20090427-72-185-1-831,5,2009-04-27,739,新聞図書費,新聞代,0,3399,-297512
1084,0001-20090427-72-185-1-831,6,2009-04-27,191,仮払消費税等,新聞代,0,169,-297681
1087,0001-20090427-9-178-1-817,1,2009-04-27,733,交際接待費,香典代,0,10000,-307681
1089,0001-20090428-27-186-1-833,0,2009-04-28,726,旅費交通費,旅費,0,26667,-334348
1090,0001-20090428-27-186-1-833,1,2009-04-28,191,仮払消費税等,旅費,0,1333,-335681
1092,0001-20090428-27-186-1-833,3,2009-04-28,726,旅費交通費,旅費,0,29524,-365205
1093,0001-20090428-27-186-1-833,4,2009-04-28,191,仮払消費税等,旅費,0,1476,-366681
1094,0001-20090428-27-186-1-833,5,2009-04-28,726,旅費交通費,旅費,0,21429,-388110
1095,0001-20090428-27-186-1-833,6,2009-04-28,191,仮払消費税等,旅費,0,1071,-389181
1108,0001-20090430-100-205-1-871,0,2009-04-30,724,福利厚生費,会費,0,5715,-394896
1109,0001-20090430-100-205-1-871,1,2009-04-30,191,仮払消費税等,会費,0,285,-395181
1124,0001-20090430-128-208-1-877,1,2009-04-30,738,租税公課,収入印紙,0,10000,-405181
1140,0001-20090430-138-210-1-881,0,2009-04-30,740,車両費,ガソリン代,0,3410,-408591
1141,0001-20090430-138-210-1-881,1,2009-04-30,191,仮払消費税等,ガソリン代,0,170,-408761
1143,0001-20090430-138-210-1-881,3,2009-04-30,740,車両費,高速代,0,2524,-411285
1144,0001-20090430-138-210-1-881,4,2009-04-30,191,仮払消費税等,高速代,0,126,-411411
1186,0001-20090430-251-217-1-895,0,2009-04-30,726,旅費交通費,旅費,0,9334,-420745
1187,0001-20090430-251-217-1-895,1,2009-04-30,191,仮払消費税等,旅費,0,466,-421211
1503,0001-20090430-49-192-1-845,3,2009-04-30,740,車両費,高速代,0,3381,-424592
1504,0001-20090430-49-192-1-845,4,2009-04-30,191,仮払消費税等,高速代,0,169,-424761
1506,0001-20090430-49-192-1-845,6,2009-04-30,740,車両費,駐車代,0,762,-425523
1507,0001-20090430-49-192-1-845,7,2009-04-30,191,仮払消費税等,駐車代,0,38,-425561
1515,0001-20090430-55-193-1-847,0,2009-04-30,740,車両費,車両管理費,0,23810,-449371
1516,0001-20090430-55-193-1-847,1,2009-04-30,191,仮払消費税等,車両管理費,0,1190,-450561
1518,0001-20090430-55-193-1-847,3,2009-04-30,740,車両費,車両管理費,0,26667,-477228
1519,0001-20090430-55-193-1-847,4,2009-04-30,191,仮払消費税等,車両管理費,0,1333,-478561
1521,0001-20090430-55-193-1-847,6,2009-04-30,740,車両費,高速代,0,7667,-486228
1522,0001-20090430-55-193-1-847,7,2009-04-30,191,仮払消費税等,高速代,0,383,-486611
1525,0001-20090430-60-194-1-849,0,2009-04-30,726,旅費交通費,旅費,0,9286,-495897
1526,0001-20090430-60-194-1-849,1,2009-04-30,191,仮払消費税等,旅費,0,464,-496361
1541,0001-20090430-67-197-1-855,1,2009-04-30,742,諸会費,会費支払い,0,30000,-526361
1564,0001-20090430-83-202-1-865,0,2009-04-30,740,車両費,車両管理費,0,47620,-573981
1565,0001-20090430-83-202-1-865,1,2009-04-30,191,仮払消費税等,車両管理費,0,2380,-576361
,,,2009-04,,※※月計※※,,2000000,2576361,
1582,0001-20090501-18-246-1-953,0,2009-05-01,726,旅費交通費,旅費,0,23620,-599981
1583,0001-20090501-18-246-1-953,1,2009-05-01,191,仮払消費税等,旅費,0,1180,-601161
1586,0001-20090502-122-248-1-957,0,2009-05-02,727,通信費,証明書発行手数料,0,1000,-602161
1587,0001-20090502-122-248-1-957,1,2009-05-02,191,仮払消費税等,証明書発行手数料,0,50,-602211
1591,0001-20090502-124-249-1-959,1,2009-05-02,738,租税公課,収入印紙,0,6000,-608211
1597,0001-20090503-10-251-1-963,0,2009-05-03,740,車両費,ガソリン代,0,3469,-611680
1598,0001-20090503-10-251-1-963,1,2009-05-03,191,仮払消費税等,ガソリン代,0,173,-611853
1601,0001-20090503-19-252-1-965,0,2009-05-03,726,旅費交通費,旅費,0,14286,-626139
1602,0001-20090503-19-252-1-965,1,2009-05-03,191,仮払消費税等,旅費,0,714,-626853
1609,0001-20090505-56-253-1-967,0,2009-05-05,726,旅費交通費,旅費,0,39524,-666377
1610,0001-20090505-56-253-1-967,1,2009-05-05,191,仮払消費税等,旅費,0,1976,-668353
1613,0001-20090505-80-254-1-969,0,2009-05-05,726,旅費交通費,タクシー代,0,9048,-677401
1614,0001-20090505-80-254-1-969,1,2009-05-05,191,仮払消費税等,タクシー代,0,452,-677853
1638,0001-20090506-106-261-1-983,0,2009-05-06,733,交際接待費,食事代,0,13669,-691522
1639,0001-20090506-106-261-1-983,1,2009-05-06,191,仮払消費税等,食事代,0,683,-692205
1642,0001-20090506-110-262-1-985,0,2009-05-06,726,旅費交通費,タクシー代,0,3134,-695339
1643,0001-20090506-110-262-1-985,1,2009-05-06,191,仮払消費税等,タクシー代,0,156,-695495
1652,0001-20090506-20-259-1-979,0,2009-05-06,726,旅費交通費,旅費,0,39048,-734543
1653,0001-20090506-20-259-1-979,1,2009-05-06,191,仮払消費税等,旅費,0,1952,-736495
1656,0001-20090506-42-260-1-981,0,2009-05-06,733,交際接待費,食事代　今井百貨店2名,0,15858,-752353
1657,0001-20090506-42-260-1-981,1,2009-05-06,191,仮払消費税等,食事代　今井百貨店2名,0,792,-753145
1660,0001-20090507-102-269-1-999,0,2009-05-07,733,交際接待費,差し入れ,0,1000,-754145
1661,0001-20090507-102-269-1-999,1,2009-05-07,191,仮払消費税等,差し入れ,0,50,-754195
1664,0001-20090507-158-270-1-1001,0,2009-05-07,726,旅費交通費,出張旅費,0,9810,-764005
1665,0001-20090507-158-270-1-1001,1,2009-05-07,191,仮払消費税等,出張旅費,0,490,-764495
1668,0001-20090507-22-264-1-989,0,2009-05-07,726,旅費交通費,旅費,0,47620,-812115
1669,0001-20090507-22-264-1-989,1,2009-05-07,191,仮払消費税等,旅費,0,2380,-814495
1672,0001-20090507-57-265-1-991,0,2009-05-07,726,旅費交通費,JR代,0,93143,-907638
1673,0001-20090507-57-265-1-991,1,2009-05-07,191,仮払消費税等,JR代,0,4657,-912295
1676,0001-20090507-58-266-1-993,0,2009-05-07,726,旅費交通費,旅費,0,66667,-978962
1677,0001-20090507-58-266-1-993,1,2009-05-07,191,仮払消費税等,旅費,0,3333,-982295
1680,0001-20090507-69-267-1-995,0,2009-05-07,791,雑費,洗剤代他,0,2284,-984579
1681,0001-20090507-69-267-1-995,1,2009-05-07,191,仮払消費税等,洗剤代他,0,114,-984693
1684,0001-20090507-81-268-1-997,0,2009-05-07,726,旅費交通費,旅費,0,9524,-994217
1685,0001-20090507-81-268-1-997,1,2009-05-07,191,仮払消費税等,旅費,0,476,-994693
1688,0001-20090508-142-274-1-1009,0,2009-05-08,740,車両費,駐車代,0,762,-995455
1689,0001-20090508-142-274-1-1009,1,2009-05-08,191,仮払消費税等,駐車代,0,38,-995493
1691,0001-20090508-142-274-1-1009,3,2009-05-08,740,車両費,ガソリン代,0,6810,-1002303
1692,0001-20090508-142-274-1-1009,4,2009-05-08,191,仮払消費税等,ガソリン代,0,340,-1002643
1699,0001-20090508-154-276-1-1013,1,2009-05-08,131,普通預金,引き出し,1000000,0,-2643
1703,0001-20090508-17-271-1-1003,0,2009-05-08,740,車両費,夏用ワイパー代,0,7560,-10203
1704,0001-20090508-17-271-1-1003,1,2009-05-08,191,仮払消費税等,夏用ワイパー代,0,378,-10581
1706,0001-20090508-17-271-1-1003,3,2009-05-08,740,車両費,ウォッシャー液,0,340,-10921
1707,0001-20090508-17-271-1-1003,4,2009-05-08,191,仮払消費税等,ウォッシャー液,0,17,-10938
1710,0001-20090508-41-272-1-1005,1,2009-05-08,733,交際接待費,出産祝い,0,10000,-20938
1712,0001-20090508-43-273-1-1007,0,2009-05-08,733,交際接待費,コーヒー代2名,0,1143,-22081
1713,0001-20090508-43-273-1-1007,1,2009-05-08,191,仮払消費税等,コーヒー代2名,0,57,-22138
1716,0001-20090509-84-277-1-1015,0,2009-05-09,727,通信費,切手代,0,45410,-67548
1717,0001-20090509-84-277-1-1015,1,2009-05-09,191,仮払消費税等,切手代,0,2270,-69818
1725,0001-20090510-141-290-1-1041,0,2009-05-10,726,旅費交通費,JR代,0,42858,-112676
1726,0001-20090510-141-290-1-1041,1,2009-05-10,191,仮払消費税等,JR代,0,2142,-114818
1729,0001-20090510-150-291-1-1043,0,2009-05-10,733,交際接待費,飲食代　博多亭4名,0,22919,-137737
1730,0001-20090510-150-291-1-1043,1,2009-05-10,191,仮払消費税等,飲食代　博多亭4名,0,1145,-138882
1733,0001-20090510-150-291-1-1043,4,2009-05-10,738,租税公課,収入印紙,0,20000,-158882
1735,0001-20090510-162-292-1-1045,0,2009-05-10,734,会議費,会議　食事代,0,30020,-188902
1736,0001-20090510-162-292-1-1045,1,2009-05-10,191,仮払消費税等,会議　食事代,0,1500,-190402
1745,0001-20090510-21-278-1-1017,0,2009-05-10,726,旅費交通費,JR代,0,78477,-268879
1746,0001-20090510-21-278-1-1017,1,2009-05-10,191,仮払消費税等,JR代,0,3923,-272802
1749,0001-20090510-46-279-1-1019,0,2009-05-10,740,車両費,ガソリン代,0,2858,-275660
1750,0001-20090510-46-279-1-1019,1,2009-05-10,191,仮払消費税等,ガソリン代,0,142,-275802
1752,0001-20090510-46-279-1-1019,3,2009-05-10,740,車両費,駐車代,0,1429,-277231
1753,0001-20090510-46-279-1-1019,4,2009-05-10,191,仮払消費税等,駐車代,0,71,-277302
1754,0001-20090510-46-279-1-1019,5,2009-05-10,740,車両費,高速代,0,6448,-283750
1755,0001-20090510-46-279-1-1019,6,2009-05-10,191,仮払消費税等,高速代,0,322,-284072
1773,0001-20090510-69-282-1-1025,0,2009-05-10,791,雑費,ティッシュ他,0,930,-285002
1774,0001-20090510-69-282-1-1025,1,2009-05-10,191,仮払消費税等,ティッシュ他,0,46,-285048
1819,0001-20090511-149-303-1-1067,0,2009-05-11,733,交際接待費,コーヒー代2名,0,1200,-286248
1820,0001-20090511-149-303-1-1067,1,2009-05-11,191,仮払消費税等,コーヒー代2名,0,60,-286308
1852,0001-20090511-64-296-1-1053,1,2009-05-11,131,普通預金,引き出し,1000000,0,713692
1868,0001-20090511-73-299-1-1059,0,2009-05-11,733,交際接待費,食事代,0,25267,688425
1869,0001-20090511-73-299-1-1059,1,2009-05-11,191,仮払消費税等,食事代,0,1263,687162
1879,0001-20090512-125-306-1-1073,1,2009-05-12,738,租税公課,収入印紙,0,40000,647162
1881,0001-20090512-143-307-1-1075,0,2009-05-12,740,車両費,点検作業料,0,23258,623904
1882,0001-20090512-143-307-1-1075,1,2009-05-12,191,仮払消費税等,点検作業料,0,1162,622742
1885,0001-20090512-151-308-1-1077,0,2009-05-12,733,交際接待費,飲食代　串揚げ千本2名,0,8991,613751
1886,0001-20090512-151-308-1-1077,1,2009-05-12,191,仮払消費税等,飲食代　串揚げ千本2名,0,449,613302
1888,0001-20090512-151-308-1-1077,3,2009-05-12,733,交際接待費,飲食代　スナック北新地,0,21000,592302
1889,0001-20090512-151-308-1-1077,4,2009-05-12,191,仮払消費税等,飲食代　スナック北新地,0,1050,591252
1891,0001-20090512-23-305-1-1071,0,2009-05-12,726,旅費交通費,旅費,0,15715,575537
1892,0001-20090512-23-305-1-1071,1,2009-05-12,191,仮払消費税等,旅費,0,785,574752
1894,0001-20090512-23-305-1-1071,3,2009-05-12,726,旅費交通費,旅費,0,67715,507037
1895,0001-20090512-23-305-1-1071,4,2009-05-12,191,仮払消費税等,旅費,0,3385,503652
1896,0001-20090512-23-305-1-1071,5,2009-05-12,726,旅費交通費,旅費,0,37905,465747
1897,0001-20090512-23-305-1-1071,6,2009-05-12,191,仮払消費税等,旅費,0,1895,463852
1899,0001-20090513-103-310-1-1081,0,2009-05-13,733,交際接待費,コーヒー代他3名,0,3000,460852
1900,0001-20090513-103-310-1-1081,1,2009-05-13,191,仮払消費税等,コーヒー代他3名,0,150,460702
1903,0001-20090513-144-311-1-1083,0,2009-05-13,740,車両費,ガソリン代,0,6400,454302
1904,0001-20090513-144-311-1-1083,1,2009-05-13,191,仮払消費税等,ガソリン代,0,320,453982
1907,0001-20090513-82-309-1-1079,0,2009-05-13,726,旅費交通費,旅費,0,7810,446172
1908,0001-20090513-82-309-1-1079,1,2009-05-13,191,仮払消費税等,旅費,0,390,445782
1911,0001-20090514-156-312-1-1085,0,2009-05-14,726,旅費交通費,出張旅費,0,9524,436258
1912,0001-20090514-156-312-1-1085,1,2009-05-14,191,仮払消費税等,出張旅費,0,476,435782
1941,0001-20090515-11-314-1-1089,0,2009-05-15,740,車両費,ガソリン代,0,3058,432724
1942,0001-20090515-11-314-1-1089,1,2009-05-15,191,仮払消費税等,ガソリン代,0,152,432572
1946,0001-20090515-117-327-1-1115,1,2009-05-15,742,諸会費,会費,0,20000,412572
1961,0001-20090515-52-315-1-1091,0,2009-05-15,740,車両費,駐車代,0,762,411810
1962,0001-20090515-52-315-1-1091,1,2009-05-15,191,仮払消費税等,駐車代,0,38,411772
1964,0001-20090515-52-315-1-1091,3,2009-05-15,740,車両費,高速代,0,2191,409581
1965,0001-20090515-52-315-1-1091,4,2009-05-15,191,仮払消費税等,高速代,0,109,409472
1966,0001-20090515-52-315-1-1091,5,2009-05-15,740,車両費,ガソリン代,0,6126,403346
1967,0001-20090515-52-315-1-1091,6,2009-05-15,191,仮払消費税等,ガソリン代,0,306,403040
1973,0001-20090515-72-317-1-1095,0,2009-05-15,733,交際接待費,ゴルフプレー代3名,0,30858,372182
1974,0001-20090515-72-317-1-1095,1,2009-05-15,191,仮払消費税等,ゴルフプレー代3名,0,1542,370640
1977,0001-20090515-79-318-1-1097,0,2009-05-15,724,福利厚生費,景品代,0,43312,327328
1978,0001-20090515-79-318-1-1097,1,2009-05-15,191,仮払消費税等,景品代,0,2165,325163
1982,0001-20090515-85-319-1-1099,1,2009-05-15,721,雑給,5月給与その他 0060 パート･アルバイト,0,224883,100280
1995,0001-20090515-9-313-1-1087,0,2009-05-15,733,交際接待費,手土産代　チェック,0,6000,94280
1996,0001-20090515-9-313-1-1087,1,2009-05-15,191,仮払消費税等,手土産代　チェック,0,300,93980
1998,0001-20090515-9-313-1-1087,3,2009-05-15,733,交際接待費,お米券　チェック,0,28572,65408
1999,0001-20090515-9-313-1-1087,4,2009-05-15,191,仮払消費税等,お米券　チェック,0,1428,63980
2017,0001-20090516-136-331-1-1123,0,2009-05-16,791,雑費,ダスキン代,0,15715,48265
2018,0001-20090516-136-331-1-1123,1,2009-05-16,191,仮払消費税等,ダスキン代,0,785,47480
2021,0001-20090516-44-330-1-1121,0,2009-05-16,733,交際接待費,食事代　ホテルサンフラワー,0,5610,41870
2022,0001-20090516-44-330-1-1121,1,2009-05-16,191,仮払消費税等,食事代　ホテルサンフラワー,0,280,41590
2029,0001-20090518-105-334-1-1129,0,2009-05-18,733,交際接待費,飲食代　居酒屋ラオス,0,15724,25866
2030,0001-20090518-105-334-1-1129,1,2009-05-18,191,仮払消費税等,飲食代　居酒屋ラオス,0,786,25080
2037,0001-20090518-153-336-1-1133,0,2009-05-18,733,交際接待費,飲食代　居酒屋マーク,0,12048,13032
2038,0001-20090518-153-336-1-1133,1,2009-05-18,191,仮払消費税等,飲食代　居酒屋マーク,0,602,12430
2041,0001-20090518-47-333-1-1127,0,2009-05-18,740,車両費,高速代,0,2420,10010
2042,0001-20090518-47-333-1-1127,1,2009-05-18,191,仮払消費税等,高速代,0,120,9890
2044,0001-20090518-47-333-1-1127,3,2009-05-18,740,車両費,ガソリン代,0,4762,5128
2045,0001-20090518-47-333-1-1127,4,2009-05-18,191,仮払消費税等,ガソリン代,0,238,4890
2047,0001-20090519-6-337-1-1135,0,2009-05-19,732,広告宣伝費,広告料,0,41143,-36253
2048,0001-20090519-6-337-1-1135,1,2009-05-19,191,仮払消費税等,広告料,0,2057,-38310
2056,0001-20090520-104-350-1-1161,1,2009-05-20,152,売掛金,09年5月20日伝票No218株式会社　斉藤,651498,0,613188
2097,0001-20090520-13-338-1-1137,0,2009-05-20,740,車両費,ガソリン代,0,7648,605540
2098,0001-20090520-13-338-1-1137,1,2009-05-20,191,仮払消費税等,ガソリン代,0,382,605158
2114,0001-20090520-24-339-1-1139,0,2009-05-20,726,旅費交通費,JR回数券,0,78686,526472
2115,0001-20090520-24-339-1-1139,1,2009-05-20,191,仮払消費税等,JR回数券,0,3934,522538
2122,0001-20090520-53-341-1-1143,0,2009-05-20,740,車両費,高速代,0,1286,521252
2123,0001-20090520-53-341-1-1143,1,2009-05-20,191,仮払消費税等,高速代,0,64,521188
2153,0001-20090520-83-346-1-1153,0,2009-05-20,726,旅費交通費,旅費,0,6286,514902
2154,0001-20090520-83-346-1-1153,1,2009-05-20,191,仮払消費税等,旅費,0,314,514588
2173,0001-20090521-152-366-1-1193,0,2009-05-21,733,交際接待費,食事代,0,16000,498588
2174,0001-20090521-152-366-1-1193,1,2009-05-21,191,仮払消費税等,食事代,0,800,497788
2177,0001-20090521-160-367-1-1195,0,2009-05-21,726,旅費交通費,出張旅費,0,66667,431121
2178,0001-20090521-160-367-1-1195,1,2009-05-21,191,仮払消費税等,出張旅費,0,3333,427788
2182,0001-20090521-163-368-1-1197,1,2009-05-21,742,諸会費,会費,0,18000,409788
2192,0001-20090521-25-360-1-1181,0,2009-05-21,726,旅費交通費,旅費,0,53334,356454
2193,0001-20090521-25-360-1-1181,1,2009-05-21,191,仮払消費税等,旅費,0,2666,353788
2204,0001-20090521-59-362-1-1185,0,2009-05-21,726,旅費交通費,旅費,0,38096,315692
2205,0001-20090521-59-362-1-1185,1,2009-05-21,191,仮払消費税等,旅費,0,1904,313788
2226,0001-20090522-104-376-1-1213,0,2009-05-22,733,交際接待費,手土産代　五越百貨店,0,2524,311264
2227,0001-20090522-104-376-1-1213,1,2009-05-22,191,仮払消費税等,手土産代　五越百貨店,0,126,311138
2230,0001-20090522-138-377-1-1215,0,2009-05-22,740,車両費,ガソリン代,0,5650,305488
2231,0001-20090522-138-377-1-1215,1,2009-05-22,191,仮払消費税等,ガソリン代,0,282,305206
2233,0001-20090522-138-377-1-1215,3,2009-05-22,740,車両費,高速代,0,4896,300310
2234,0001-20090522-138-377-1-1215,4,2009-05-22,191,仮払消費税等,高速代,0,244,300066
2236,0001-20090522-165-378-1-1217,0,2009-05-22,791,雑費,トイレットペーパー代,0,2000,298066
2237,0001-20090522-165-378-1-1217,1,2009-05-22,191,仮払消費税等,トイレットペーパー代,0,100,297966
2240,0001-20090522-166-379-1-1219,0,2009-05-22,791,雑費,ダスキン代,0,1800,296166
2241,0001-20090522-166-379-1-1219,1,2009-05-22,191,仮払消費税等,ダスキン代,0,90,296076
2248,0001-20090522-7-370-1-1201,0,2009-05-22,733,交際接待費,食事代　打合せ昼食　2名,0,5239,290837
2249,0001-20090522-7-370-1-1201,1,2009-05-22,191,仮払消費税等,食事代　打合せ昼食　2名,0,261,290576
2251,0001-20090522-7-370-1-1201,3,2009-05-22,733,交際接待費,食事代　喫茶コーヒー代　4名,0,2096,288480
2252,0001-20090522-7-370-1-1201,4,2009-05-22,191,仮払消費税等,食事代　喫茶コーヒー代　4名,0,104,288376
2254,0001-20090522-73-372-1-1205,0,2009-05-22,733,交際接待費,ゴルフプレー代,0,9143,279233
2255,0001-20090522-73-372-1-1205,1,2009-05-22,191,仮払消費税等,ゴルフプレー代,0,457,278776
2258,0001-20090522-74-373-1-1207,0,2009-05-22,733,交際接待費,食事代　カナッシュ2名,0,5543,273233
2259,0001-20090522-74-373-1-1207,1,2009-05-22,191,仮払消費税等,食事代　カナッシュ2名,0,277,272956
2262,0001-20090522-90-374-1-1209,0,2009-05-22,791,雑費,ダスキン代,0,10000,262956
2263,0001-20090522-90-374-1-1209,1,2009-05-22,191,仮払消費税等,ダスキン代,0,500,262456
2270,0001-20090523-121-384-1-1229,0,2009-05-23,724,福利厚生費,お茶代,0,11429,251027
2271,0001-20090523-121-384-1-1229,1,2009-05-23,191,仮払消費税等,お茶代,0,571,250456
2274,0001-20090523-140-385-1-1231,0,2009-05-23,726,旅費交通費,旅費,0,3134,247322
2275,0001-20090523-140-385-1-1231,1,2009-05-23,191,仮払消費税等,旅費,0,156,247166
2278,0001-20090523-161-386-1-1233,0,2009-05-23,726,旅費交通費,旅費,0,17191,229975
2279,0001-20090523-161-386-1-1233,1,2009-05-23,191,仮払消費税等,旅費,0,859,229116
2282,0001-20090523-26-380-1-1221,0,2009-05-23,726,旅費交通費,旅費,0,10477,218639
2283,0001-20090523-26-380-1-1221,1,2009-05-23,191,仮払消費税等,旅費,0,523,218116
2290,0001-20090523-75-382-1-1225,0,2009-05-23,733,交際接待費,飲食代　ダイニング旬6名,0,20515,197601
2291,0001-20090523-75-382-1-1225,1,2009-05-23,191,仮払消費税等,飲食代　ダイニング旬6名,0,1025,196576
2293,0001-20090523-75-382-1-1225,3,2009-05-23,733,交際接待費,バーレジェンド6名,0,44581,151995
2294,0001-20090523-75-382-1-1225,4,2009-05-23,191,仮払消費税等,バーレジェンド6名,0,2229,149766
2296,0001-20090523-78-383-1-1227,0,2009-05-23,740,車両費,ガソリン代,0,6115,143651
2297,0001-20090523-78-383-1-1227,1,2009-05-23,191,仮払消費税等,ガソリン代,0,305,143346
2300,0001-20090524-108-388-1-1237,0,2009-05-24,733,交際接待費,ゴルフプレー代2名,0,22420,120926
2301,0001-20090524-108-388-1-1237,1,2009-05-24,191,仮払消費税等,ゴルフプレー代2名,0,1120,119806
2313,0001-20090525-107-396-1-1253,1,2009-05-25,733,交際接待費,結婚祝い金,0,10000,109806
2364,0001-20090525-8-391-1-1243,0,2009-05-25,733,交際接待費,飲食代,0,4048,105758
2365,0001-20090525-8-391-1-1243,1,2009-05-25,191,仮払消費税等,飲食代,0,202,105556
2368,0001-20090525-84-393-1-1247,0,2009-05-25,726,旅費交通費,旅費,0,10286,95270
2369,0001-20090525-84-393-1-1247,1,2009-05-25,191,仮払消費税等,旅費,0,514,94756
2372,0001-20090525-86-394-1-1249,0,2009-05-25,727,通信費,切手代,0,7620,87136
2373,0001-20090525-86-394-1-1249,1,2009-05-25,191,仮払消費税等,切手代,0,380,86756
2500,0001-20090526-14-403-1-1267,0,2009-05-26,740,車両費,ガソリン代,0,4000,82756
2501,0001-20090526-14-403-1-1267,1,2009-05-26,191,仮払消費税等,ガソリン代,0,200,82556
2508,0001-20090526-170-412-1-1285,0,2009-05-26,739,新聞図書費,新聞代,0,2864,79692
2509,0001-20090526-170-412-1-1285,1,2009-05-26,191,仮払消費税等,新聞代,0,143,79549
2518,0001-20090526-27-404-1-1269,0,2009-05-26,726,旅費交通費,旅費,0,27239,52310
2519,0001-20090526-27-404-1-1269,1,2009-05-26,191,仮払消費税等,旅費,0,1361,50949
2521,0001-20090526-27-404-1-1269,3,2009-05-26,726,旅費交通費,旅費,0,31429,19520
2522,0001-20090526-27-404-1-1269,4,2009-05-26,191,仮払消費税等,旅費,0,1571,17949
2523,0001-20090526-27-404-1-1269,5,2009-05-26,726,旅費交通費,旅費,0,21429,-3480
2524,0001-20090526-27-404-1-1269,6,2009-05-26,191,仮払消費税等,旅費,0,1071,-4551
2526,0001-20090526-35-405-1-1271,0,2009-05-26,739,新聞図書費,新聞代,0,3739,-8290
2527,0001-20090526-35-405-1-1271,1,2009-05-26,191,仮払消費税等,新聞代,0,186,-8476
2530,0001-20090526-72-406-1-1273,0,2009-05-26,739,新聞図書費,新聞代,0,2864,-11340
2531,0001-20090526-72-406-1-1273,1,2009-05-26,191,仮払消費税等,新聞代,0,143,-11483
2533,0001-20090526-72-406-1-1273,3,2009-05-26,739,新聞図書費,新聞代,0,2815,-14298
2534,0001-20090526-72-406-1-1273,4,2009-05-26,191,仮払消費税等,新聞代,0,140,-14438
2535,0001-20090526-72-406-1-1273,5,2009-05-26,739,新聞図書費,新聞代,0,3399,-17837
2536,0001-20090526-72-406-1-1273,6,2009-05-26,191,仮払消費税等,新聞代,0,169,-18006
2542,0001-20090526-83-408-1-1277,0,2009-05-26,740,車両費,車両管理費,0,42858,-60864
2543,0001-20090526-83-408-1-1277,1,2009-05-26,191,仮払消費税等,車両管理費,0,2142,-63006
2552,0001-20090527-114-421-1-1303,0,2009-05-27,739,新聞図書費,新聞代,0,2540,-65546
2553,0001-20090527-114-421-1-1303,1,2009-05-27,191,仮払消費税等,新聞代,0,126,-65672
2555,0001-20090527-114-421-1-1303,3,2009-05-27,739,新聞図書費,新聞代,0,2864,-68536
2556,0001-20090527-114-421-1-1303,4,2009-05-27,191,仮払消費税等,新聞代,0,143,-68679
2558,0001-20090527-15-414-1-1289,0,2009-05-27,740,車両費,タイヤ交換,0,71429,-140108
2559,0001-20090527-15-414-1-1289,1,2009-05-27,191,仮払消費税等,タイヤ交換,0,3571,-143679
2567,0001-20090527-39-416-1-1293,0,2009-05-27,724,福利厚生費,会費,0,12381,-156060
2568,0001-20090527-39-416-1-1293,1,2009-05-27,191,仮払消費税等,会費,0,619,-156679
2571,0001-20090527-49-417-1-1295,0,2009-05-27,740,車両費,ガソリン代,0,142858,-299537
2572,0001-20090527-49-417-1-1295,1,2009-05-27,191,仮払消費税等,ガソリン代,0,7142,-306679
2586,0001-20090527-79-419-1-1299,0,2009-05-27,740,車両費,ガソリン代,0,3538,-310217
2587,0001-20090527-79-419-1-1299,1,2009-05-27,191,仮払消費税等,ガソリン代,0,176,-310393
2590,0001-20090527-88-420-1-1301,0,2009-05-27,739,新聞図書費,新聞代,0,3399,-313792
2591,0001-20090527-88-420-1-1301,1,2009-05-27,191,仮払消費税等,新聞代,0,169,-313961
2594,0001-20090528-159-424-1-1309,0,2009-05-28,726,旅費交通費,ＪＲ代,0,15639,-329600
2595,0001-20090528-159-424-1-1309,1,2009-05-28,191,仮払消費税等,ＪＲ代,0,781,-330381
2622,0001-20090529-155-428-1-1317,0,2009-05-29,740,車両費,車両管理費,0,6486,-336867
2623,0001-20090529-155-428-1-1317,1,2009-05-29,191,仮払消費税等,車両管理費,0,324,-337191
2625,0001-20090529-155-428-1-1317,3,2009-05-29,740,車両費,高速代,0,9715,-346906
2626,0001-20090529-155-428-1-1317,4,2009-05-29,191,仮払消費税等,高速代,0,485,-347391
2627,0001-20090529-155-428-1-1317,5,2009-05-29,740,車両費,駐車代,0,1200,-348591
2628,0001-20090529-155-428-1-1317,6,2009-05-29,191,仮払消費税等,駐車代,0,60,-348651
2634,0001-20090529-63-426-1-1313,0,2009-05-29,734,会議費,会議　飲食代,0,22814,-371465
2635,0001-20090529-63-426-1-1313,1,2009-05-29,191,仮払消費税等,会議　飲食代,0,1140,-372605
2638,0001-20090530-100-431-1-1323,0,2009-05-30,724,福利厚生費,会費,0,13334,-385939
2639,0001-20090530-100-431-1-1323,1,2009-05-30,191,仮払消費税等,会費,0,666,-386605
2661,0001-20090530-148-434-1-1329,0,2009-05-30,740,車両費,ウォッシャー液他,0,600,-387205
2662,0001-20090530-148-434-1-1329,1,2009-05-30,191,仮払消費税等,ウォッシャー液他,0,30,-387235
2665,0001-20090530-164-435-1-1331,0,2009-05-30,754,事務用消耗品費,事務用品,0,5067,-392302
2666,0001-20090530-164-435-1-1331,1,2009-05-30,191,仮払消費税等,事務用品,0,253,-392555
2674,0001-20090530-70-429-1-1319,5,2009-05-30,740,車両費,高速料,0,69824,-462379
2675,0001-20090530-70-429-1-1319,6,2009-05-30,191,仮払消費税等,高速料,0,3491,-465870
2863,0001-20090531-124-461-1-1383,1,2009-05-31,152,売掛金,09年5月31日伝票No451合同会社　エイム商事,641884,0,176014
3081,0001-20090531-55-439-1-1339,0,2009-05-31,740,車両費,高速代,0,9239,166775
3082,0001-20090531-55-439-1-1339,1,2009-05-31,191,仮払消費税等,高速代,0,461,166314
3085,0001-20090531-60-440-1-1341,0,2009-05-31,726,旅費交通費,旅費,0,17858,148456
3086,0001-20090531-60-440-1-1341,1,2009-05-31,191,仮払消費税等,旅費,0,892,147564
3101,0001-20090531-67-443-1-1347,1,2009-05-31,742,諸会費,会費支払い,0,30000,117564
,,,2009-05,,※※月計※※,,3293382,2599457,
3137,0001-20090601-106-487-1-1435,0,2009-06-01,733,交際接待費,食事代　やまびこ4名,0,7267,110297
3138,0001-20090601-106-487-1-1435,1,2009-06-01,191,仮払消費税等,食事代　やまびこ4名,0,363,109934
3140,0001-20090601-106-487-1-1435,3,2009-06-01,733,交際接待費,飲食代　スナック北新地,0,20629,89305
3141,0001-20090601-106-487-1-1435,4,2009-06-01,191,仮払消費税等,飲食代　スナック北新地,0,1031,88274
3149,0001-20090601-94-486-1-1433,0,2009-06-01,791,雑費,お茶代,0,3000,85274
3150,0001-20090601-94-486-1-1433,1,2009-06-01,191,仮払消費税等,お茶代,0,150,85124
3153,0001-20090602-10-489-1-1439,0,2009-06-02,740,車両費,ガソリン代,0,4023,81101
3154,0001-20090602-10-489-1-1439,1,2009-06-02,191,仮払消費税等,ガソリン代,0,201,80900
3157,0001-20090602-18-490-1-1441,0,2009-06-02,726,旅費交通費,旅費,0,20667,60233
3158,0001-20090602-18-490-1-1441,1,2009-06-02,191,仮払消費税等,旅費,0,1033,59200
3161,0001-20090602-42-491-1-1443,0,2009-06-02,733,交際接待費,昼食代　喫茶エンゼル3名,0,3258,55942
3162,0001-20090602-42-491-1-1443,1,2009-06-02,191,仮払消費税等,昼食代　喫茶エンゼル3名,0,162,55780
3165,0001-20090602-56-492-1-1445,0,2009-06-02,726,旅費交通費,旅費,0,31048,24732
3166,0001-20090602-56-492-1-1445,1,2009-06-02,191,仮払消費税等,旅費,0,1552,23180
3169,0001-20090602-77-493-1-1447,0,2009-06-02,733,交際接待費,ゴルフプレー代,0,6477,16703
3170,0001-20090602-77-493-1-1447,1,2009-06-02,191,仮払消費税等,ゴルフプレー代,0,323,16380
3173,0001-20090604-161-495-1-1451,0,2009-06-04,726,旅費交通費,旅費,0,7143,9237
3174,0001-20090604-161-495-1-1451,1,2009-06-04,191,仮払消費税等,旅費,0,357,8880
3177,0001-20090604-19-494-1-1449,0,2009-06-04,726,旅費交通費,旅費,0,14286,-5406
3178,0001-20090604-19-494-1-1449,1,2009-06-04,191,仮払消費税等,旅費,0,714,-6120
3208,0001-20090606-110-502-1-1465,0,2009-06-06,726,旅費交通費,タクシー代,0,2181,-8301
3209,0001-20090606-110-502-1-1465,1,2009-06-06,191,仮払消費税等,タクシー代,0,109,-8410
3212,0001-20090606-122-503-1-1467,0,2009-06-06,727,通信費,証明書発行手数料,0,1000,-9410
3213,0001-20090606-122-503-1-1467,1,2009-06-06,191,仮払消費税等,証明書発行手数料,0,50,-9460
3216,0001-20090606-142-504-1-1469,0,2009-06-06,740,車両費,ガソリン代,0,6267,-15727
3217,0001-20090606-142-504-1-1469,1,2009-06-06,191,仮払消費税等,ガソリン代,0,313,-16040
3219,0001-20090606-142-504-1-1469,3,2009-06-06,740,車両費,高速代,0,1572,-17612
3220,0001-20090606-142-504-1-1469,4,2009-06-06,191,仮払消費税等,高速代,0,78,-17690
3221,0001-20090606-142-504-1-1469,5,2009-06-06,740,車両費,駐車代,0,620,-18310
3222,0001-20090606-142-504-1-1469,6,2009-06-06,191,仮払消費税等,駐車代,0,30,-18340
3223,0001-20090606-142-504-1-1469,7,2009-06-06,740,車両費,洗車代,0,1000,-19340
3224,0001-20090606-142-504-1-1469,8,2009-06-06,191,仮払消費税等,洗車代,0,50,-19390
3226,0001-20090606-20-500-1-1461,0,2009-06-06,726,旅費交通費,航空券代,0,39048,-58438
3227,0001-20090606-20-500-1-1461,1,2009-06-06,191,仮払消費税等,航空券代,0,1952,-60390
3230,0001-20090606-84-501-1-1463,0,2009-06-06,727,通信費,切手代,0,3810,-64200
3231,0001-20090606-84-501-1-1463,1,2009-06-06,191,仮払消費税等,切手代,0,190,-64390
3234,0001-20090607-141-509-1-1479,0,2009-06-07,726,旅費交通費,JR代,0,15239,-79629
3235,0001-20090607-141-509-1-1479,1,2009-06-07,191,仮払消費税等,JR代,0,761,-80390
3238,0001-20090607-22-505-1-1471,0,2009-06-07,726,旅費交通費,旅費,0,47620,-128010
3239,0001-20090607-22-505-1-1471,1,2009-06-07,191,仮払消費税等,旅費,0,2380,-130390
3242,0001-20090607-58-506-1-1473,0,2009-06-07,726,旅費交通費,旅費,0,66667,-197057
3243,0001-20090607-58-506-1-1473,1,2009-06-07,191,仮払消費税等,旅費,0,3333,-200390
3246,0001-20090607-69-507-1-1475,0,2009-06-07,791,雑費,電池代,0,1332,-201722
3247,0001-20090607-69-507-1-1475,1,2009-06-07,191,仮払消費税等,電池代,0,66,-201788
3249,0001-20090607-69-507-1-1475,3,2009-06-07,791,雑費,洗剤等,0,1758,-203546
3250,0001-20090607-69-507-1-1475,4,2009-06-07,191,仮払消費税等,洗剤等,0,87,-203633
3252,0001-20090607-78-508-1-1477,0,2009-06-07,733,交際接待費,ゴルフプレー代,0,12000,-215633
3253,0001-20090607-78-508-1-1477,1,2009-06-07,191,仮払消費税等,ゴルフプレー代,0,600,-216233
3256,0001-20090608-149-512-1-1485,0,2009-06-08,733,交際接待費,コーヒー代,0,1200,-217433
3257,0001-20090608-149-512-1-1485,1,2009-06-08,191,仮払消費税等,コーヒー代,0,60,-217493
3260,0001-20090608-50-510-1-1481,0,2009-06-08,740,車両費,高速代,0,1143,-218636
3261,0001-20090608-50-510-1-1481,1,2009-06-08,191,仮払消費税等,高速代,0,57,-218693
3264,0001-20090608-85-511-1-1483,0,2009-06-08,726,旅費交通費,旅費,0,7810,-226503
3265,0001-20090608-85-511-1-1483,1,2009-06-08,191,仮払消費税等,旅費,0,390,-226893
3335,0001-20090610-162-535-1-1531,0,2009-06-10,734,会議費,会議　食事代,0,23805,-250698
3336,0001-20090610-162-535-1-1531,1,2009-06-10,191,仮払消費税等,会議　食事代,0,1190,-251888
3345,0001-20090610-21-519-1-1499,0,2009-06-10,726,旅費交通費,JR代,0,61505,-313393
3346,0001-20090610-21-519-1-1499,1,2009-06-10,191,仮払消費税等,JR代,0,3075,-316468
3349,0001-20090610-44-520-1-1501,0,2009-06-10,733,交際接待費,コーヒー代2名,0,1200,-317668
3350,0001-20090610-44-520-1-1501,1,2009-06-10,191,仮払消費税等,コーヒー代2名,0,60,-317728
3353,0001-20090610-57-521-1-1503,0,2009-06-10,726,旅費交通費,JR代,0,62734,-380462
3354,0001-20090610-57-521-1-1503,1,2009-06-10,191,仮払消費税等,JR代,0,3136,-383598
3358,0001-20090610-64-522-1-1505,1,2009-06-10,121,当座預金,引き出し,1000000,0,616402
3388,0001-20090610-86-527-1-1515,0,2009-06-10,726,旅費交通費,タクシー代,0,4810,611592
3389,0001-20090610-86-527-1-1515,1,2009-06-10,191,仮払消費税等,タクシー代,0,240,611352
3406,0001-20090611-158-541-1-1543,0,2009-06-11,726,旅費交通費,出張旅費,0,20953,590399
3407,0001-20090611-158-541-1-1543,1,2009-06-11,191,仮払消費税等,出張旅費,0,1047,589352
3410,0001-20090611-23-538-1-1537,0,2009-06-11,726,旅費交通費,旅費,0,30000,559352
3411,0001-20090611-23-538-1-1537,1,2009-06-11,191,仮払消費税等,旅費,0,1500,557852
3413,0001-20090611-23-538-1-1537,3,2009-06-11,726,旅費交通費,旅費,0,28381,529471
3414,0001-20090611-23-538-1-1537,4,2009-06-11,191,仮払消費税等,旅費,0,1419,528052
3415,0001-20090611-23-538-1-1537,5,2009-06-11,726,旅費交通費,旅費,0,39620,488432
3416,0001-20090611-23-538-1-1537,6,2009-06-11,191,仮払消費税等,旅費,0,1980,486452
3418,0001-20090611-8-537-1-1535,0,2009-06-11,733,交際接待費,食事代　昼食3名,0,6258,480194
3419,0001-20090611-8-537-1-1535,1,2009-06-11,191,仮払消費税等,食事代　昼食3名,0,312,479882
3422,0001-20090611-87-539-1-1539,0,2009-06-11,726,旅費交通費,旅費,0,10000,469882
3423,0001-20090611-87-539-1-1539,1,2009-06-11,191,仮払消費税等,旅費,0,500,469382
3426,0001-20090611-88-540-1-1541,0,2009-06-11,726,旅費交通費,ＪＲ代,0,10477,458905
3427,0001-20090611-88-540-1-1541,1,2009-06-11,191,仮払消費税等,ＪＲ代,0,523,458382
3430,0001-20090612-159-543-1-1547,0,2009-06-12,726,旅費交通費,タクシー代,0,7067,451315
3431,0001-20090612-159-543-1-1547,1,2009-06-12,191,仮払消費税等,タクシー代,0,353,450962
3434,0001-20090612-7-542-1-1545,0,2009-06-12,733,交際接待費,食事代　居酒屋おたわ,0,7562,443400
3435,0001-20090612-7-542-1-1545,1,2009-06-12,191,仮払消費税等,食事代　居酒屋おたわ,0,378,443022
3437,0001-20090612-7-542-1-1545,3,2009-06-12,733,交際接待費,飲食代　スナックりんりん,0,25704,417318
3438,0001-20090612-7-542-1-1545,4,2009-06-12,191,仮払消費税等,飲食代　スナックりんりん,0,1285,416033
3440,0001-20090613-143-545-1-1551,0,2009-06-13,740,車両費,ガソリン代,0,6903,409130
3441,0001-20090613-143-545-1-1551,1,2009-06-13,191,仮払消費税等,ガソリン代,0,345,408785
3444,0001-20090613-150-546-1-1553,0,2009-06-13,733,交際接待費,手土産代,0,13929,394856
3445,0001-20090613-150-546-1-1553,1,2009-06-13,191,仮払消費税等,手土産代,0,696,394160
3448,0001-20090613-151-547-1-1555,0,2009-06-13,733,交際接待費,食事代　お好み焼きやきやき4名,0,6496,387664
3449,0001-20090613-151-547-1-1555,1,2009-06-13,191,仮払消費税等,食事代　お好み焼きやきやき4名,0,324,387340
3451,0001-20090613-151-547-1-1555,3,2009-06-13,733,交際接待費,飲食代　ハブバージョイ4名,0,23477,363863
3452,0001-20090613-151-547-1-1555,4,2009-06-13,191,仮払消費税等,飲食代　ハブバージョイ4名,0,1173,362690
3454,0001-20090613-152-548-1-1557,0,2009-06-13,733,交際接待費,食事代,0,6960,355730
3455,0001-20090613-152-548-1-1557,1,2009-06-13,191,仮払消費税等,食事代,0,348,355382
3458,0001-20090613-73-544-1-1549,0,2009-06-13,733,交際接待費,飲食代　華3名,0,10886,344496
3459,0001-20090613-73-544-1-1549,1,2009-06-13,191,仮払消費税等,飲食代　華3名,0,544,343952
3461,0001-20090613-73-544-1-1549,3,2009-06-13,791,雑費,電池代,0,441,343511
3462,0001-20090613-73-544-1-1549,4,2009-06-13,191,仮払消費税等,電池代,0,22,343489
3465,0001-20090614-51-549-1-1559,0,2009-06-14,740,車両費,ガソリン代,0,10929,332560
3466,0001-20090614-51-549-1-1559,1,2009-06-14,191,仮払消費税等,ガソリン代,0,546,332014
3468,0001-20090614-51-549-1-1559,3,2009-06-14,740,車両費,駐車代,0,762,331252
3469,0001-20090614-51-549-1-1559,4,2009-06-14,191,仮払消費税等,駐車代,0,38,331214
3470,0001-20090614-51-549-1-1559,5,2009-06-14,740,車両費,高速代,0,3143,328071
3471,0001-20090614-51-549-1-1559,6,2009-06-14,191,仮払消費税等,高速代,0,157,327914
3523,0001-20090615-11-550-1-1561,0,2009-06-15,740,車両費,高速代,0,3058,324856
3524,0001-20090615-11-550-1-1561,1,2009-06-15,191,仮払消費税等,高速代,0,152,324704
3528,0001-20090615-117-561-1-1583,1,2009-06-15,742,諸会費,会費,0,20000,304704
3535,0001-20090615-164-563-1-1587,0,2009-06-15,754,事務用消耗品費,事務用品,0,2864,301840
3536,0001-20090615-164-563-1-1587,1,2009-06-15,191,仮払消費税等,事務用品,0,143,301697
3539,0001-20090615-52-551-1-1563,0,2009-06-15,740,車両費,高速代,0,715,300982
3540,0001-20090615-52-551-1-1563,1,2009-06-15,191,仮払消費税等,高速代,0,35,300947
3550,0001-20090615-90-553-1-1567,1,2009-06-15,721,雑給,6月給与その他 0060 パート･アルバイト,0,272337,28610
3555,0001-20090616-136-565-1-1591,0,2009-06-16,791,雑費,ダスキン代,0,15715,12895
3556,0001-20090616-136-565-1-1591,1,2009-06-16,191,仮払消費税等,ダスキン代,0,785,12110
3563,0001-20090617-144-568-1-1597,0,2009-06-17,740,車両費,ガソリン代,0,5528,6582
3564,0001-20090617-144-568-1-1597,1,2009-06-17,191,仮払消費税等,ガソリン代,0,276,6306
3566,0001-20090617-144-568-1-1597,3,2009-06-17,740,車両費,高速代,0,762,5544
3567,0001-20090617-144-568-1-1597,4,2009-06-17,191,仮払消費税等,高速代,0,38,5506
3568,0001-20090617-144-568-1-1597,5,2009-06-17,740,車両費,駐車代,0,1429,4077
3569,0001-20090617-144-568-1-1597,6,2009-06-17,191,仮払消費税等,駐車代,0,71,4006
3575,0001-20090617-86-567-1-1595,0,2009-06-17,727,通信費,切手代,0,7620,-3614
3576,0001-20090617-86-567-1-1595,1,2009-06-17,191,仮払消費税等,切手代,0,380,-3994
3579,0001-20090618-103-570-1-1601,0,2009-06-18,733,交際接待費,ゴルフプレー代,0,11972,-15966
3580,0001-20090618-103-570-1-1601,1,2009-06-18,191,仮払消費税等,ゴルフプレー代,0,598,-16564
3587,0001-20090619-46-571-1-1603,0,2009-06-19,740,車両費,ガソリン代,0,11988,-28552
3588,0001-20090619-46-571-1-1603,1,2009-06-19,191,仮払消費税等,ガソリン代,0,599,-29151
3591,0001-20090619-74-572-1-1605,0,2009-06-19,733,交際接待費,飲食代　スナックライラ4名,0,30858,-60009
3592,0001-20090619-74-572-1-1605,1,2009-06-19,191,仮払消費税等,飲食代　スナックライラ4名,0,1542,-61551
3600,0001-20090620-110-591-1-1643,1,2009-06-20,152,売掛金,09年6月20日伝票No241株式会社　斉藤,943323,0,881772
3696,0001-20090620-53-577-1-1615,0,2009-06-20,740,車両費,高速代,0,2381,879391
3697,0001-20090620-53-577-1-1615,1,2009-06-20,191,仮払消費税等,高速代,0,119,879272
3700,0001-20090620-6-574-1-1609,0,2009-06-20,732,広告宣伝費,広告料,0,4762,874510
3701,0001-20090620-6-574-1-1609,1,2009-06-20,191,仮払消費税等,広告料,0,238,874272
3733,0001-20090620-75-583-1-1627,0,2009-06-20,791,雑費,トイレットペーパー他,0,1028,873244
3734,0001-20090620-75-583-1-1627,1,2009-06-20,191,仮払消費税等,トイレットペーパー他,0,51,873193
3771,0001-20090621-12-605-1-1671,0,2009-06-21,740,車両費,ガソリン代,0,4456,868737
3772,0001-20090621-12-605-1-1671,1,2009-06-21,191,仮払消費税等,ガソリン代,0,222,868515
3774,0001-20090621-12-605-1-1671,3,2009-06-21,740,車両費,ガソリン添加剤代,0,2313,866202
3775,0001-20090621-12-605-1-1671,4,2009-06-21,191,仮払消費税等,ガソリン添加剤代,0,115,866087
3776,0001-20090621-12-605-1-1671,5,2009-06-21,740,車両費,高速代,0,1048,865039
3777,0001-20090621-12-605-1-1671,6,2009-06-21,191,仮払消費税等,高速代,0,52,864987
3779,0001-20090621-160-608-1-1677,0,2009-06-21,726,旅費交通費,出張旅費,0,66667,798320
3780,0001-20090621-160-608-1-1677,1,2009-06-21,191,仮払消費税等,出張旅費,0,3333,794987
3783,0001-20090621-24-606-1-1673,0,2009-06-21,726,旅費交通費,JR回数券,0,78686,716301
3784,0001-20090621-24-606-1-1673,1,2009-06-21,191,仮払消費税等,JR回数券,0,3934,712367
3787,0001-20090621-89-607-1-1675,0,2009-06-21,726,旅費交通費,旅費,0,9334,703033
3788,0001-20090621-89-607-1-1675,1,2009-06-21,191,仮払消費税等,旅費,0,466,702567
3795,0001-20090622-153-613-1-1687,0,2009-06-22,733,交際接待費,飲食代　居酒屋田舎,0,15753,686814
3796,0001-20090622-153-613-1-1687,1,2009-06-22,191,仮払消費税等,飲食代　居酒屋田舎,0,787,686027
3799,0001-20090622-155-614-1-1689,0,2009-06-22,740,車両費,ガソリン代,0,5713,680314
3800,0001-20090622-155-614-1-1689,1,2009-06-22,191,仮払消費税等,ガソリン代,0,285,680029
3802,0001-20090622-155-614-1-1689,3,2009-06-22,740,車両費,高速代,0,762,679267
3803,0001-20090622-155-614-1-1689,4,2009-06-22,191,仮払消費税等,高速代,0,38,679229
3804,0001-20090622-155-614-1-1689,5,2009-06-22,740,車両費,駐車代,0,381,678848
3805,0001-20090622-155-614-1-1689,6,2009-06-22,191,仮払消費税等,駐車代,0,19,678829
3808,0001-20090622-163-615-1-1691,1,2009-06-22,742,諸会費,会費,0,18000,660829
3810,0001-20090622-166-616-1-1693,0,2009-06-22,791,雑費,ダスキン代,0,1800,659029
3811,0001-20090622-166-616-1-1693,1,2009-06-22,191,仮払消費税等,ダスキン代,0,90,658939
3814,0001-20090622-9-609-1-1679,0,2009-06-22,733,交際接待費,お菓子詰め合わせ　タワー,0,3239,655700
3815,0001-20090622-9-609-1-1679,1,2009-06-22,191,仮払消費税等,お菓子詰め合わせ　タワー,0,161,655539
3817,0001-20090622-9-609-1-1679,3,2009-06-22,733,交際接待費,商品券　タワー,0,4762,650777
3818,0001-20090622-9-609-1-1679,4,2009-06-22,191,仮払消費税等,商品券　タワー,0,238,650539
3820,0001-20090622-90-610-1-1681,0,2009-06-22,791,雑費,ダスキン代,0,10000,640539
3821,0001-20090622-90-610-1-1681,1,2009-06-22,191,仮払消費税等,ダスキン代,0,500,640039
3828,0001-20090623-140-621-1-1703,0,2009-06-23,726,旅費交通費,旅費,0,7096,632943
3829,0001-20090623-140-621-1-1703,1,2009-06-23,191,仮払消費税等,旅費,0,354,632589
3832,0001-20090623-25-617-1-1695,0,2009-06-23,726,旅費交通費,旅費,0,58096,574493
3833,0001-20090623-25-617-1-1695,1,2009-06-23,191,仮払消費税等,旅費,0,2904,571589
3844,0001-20090623-59-620-1-1701,0,2009-06-23,726,旅費交通費,旅費,0,61905,509684
3845,0001-20090623-59-620-1-1701,1,2009-06-23,191,仮払消費税等,旅費,0,3095,506589
3857,0001-20090624-26-622-1-1705,0,2009-06-24,726,旅費交通費,旅費,0,11429,495160
3858,0001-20090624-26-622-1-1705,1,2009-06-24,191,仮払消費税等,旅費,0,571,494589
3902,0001-20090625-121-637-1-1735,0,2009-06-25,724,福利厚生費,お茶代,0,10953,483636
3903,0001-20090625-121-637-1-1735,1,2009-06-25,191,仮払消費税等,お茶代,0,547,483089
3906,0001-20090625-170-638-1-1737,0,2009-06-25,739,新聞図書費,新聞代,0,2864,480225
3907,0001-20090625-170-638-1-1737,1,2009-06-25,191,仮払消費税等,新聞代,0,143,480082
3916,0001-20090625-27-627-1-1715,0,2009-06-25,726,旅費交通費,旅費,0,23810,456272
3917,0001-20090625-27-627-1-1715,1,2009-06-25,191,仮払消費税等,旅費,0,1190,455082
3919,0001-20090625-27-627-1-1715,3,2009-06-25,726,旅費交通費,旅費,0,32381,422701
3920,0001-20090625-27-627-1-1715,4,2009-06-25,191,仮払消費税等,旅費,0,1619,421082
3921,0001-20090625-27-627-1-1715,5,2009-06-25,726,旅費交通費,旅費,0,23905,397177
3922,0001-20090625-27-627-1-1715,6,2009-06-25,191,仮払消費税等,旅費,0,1195,395982
3924,0001-20090625-54-628-1-1717,0,2009-06-25,740,車両費,駐車代,0,1905,394077
3925,0001-20090625-54-628-1-1717,1,2009-06-25,191,仮払消費税等,駐車代,0,95,393982
3934,0001-20090625-72-630-1-1721,0,2009-06-25,739,新聞図書費,新聞代,0,2864,391118
3935,0001-20090625-72-630-1-1721,1,2009-06-25,191,仮払消費税等,新聞代,0,143,390975
3937,0001-20090625-72-630-1-1721,3,2009-06-25,739,新聞図書費,新聞代,0,2815,388160
3938,0001-20090625-72-630-1-1721,4,2009-06-25,191,仮払消費税等,新聞代,0,140,388020
3939,0001-20090625-72-630-1-1721,5,2009-06-25,739,新聞図書費,新聞代,0,3399,384621
3940,0001-20090625-72-630-1-1721,6,2009-06-25,191,仮払消費税等,新聞代,0,169,384452
4063,0001-20090626-114-647-1-1755,0,2009-06-26,739,新聞図書費,新聞代,0,2540,381912
4064,0001-20090626-114-647-1-1755,1,2009-06-26,191,仮払消費税等,新聞代,0,126,381786
4066,0001-20090626-114-647-1-1755,3,2009-06-26,739,新聞図書費,新聞代,0,2864,378922
4067,0001-20090626-114-647-1-1755,4,2009-06-26,191,仮払消費税等,新聞代,0,143,378779
4073,0001-20090626-13-640-1-1741,0,2009-06-26,740,車両費,ガソリン代,0,3298,375481
4074,0001-20090626-13-640-1-1741,1,2009-06-26,191,仮払消費税等,ガソリン代,0,164,375317
4077,0001-20090626-138-649-1-1759,0,2009-06-26,740,車両費,高速代,0,6756,368561
4078,0001-20090626-138-649-1-1759,1,2009-06-26,191,仮払消費税等,高速代,0,337,368224
4081,0001-20090626-14-641-1-1743,0,2009-06-26,740,車両費,洗車代,0,2858,365366
4082,0001-20090626-14-641-1-1743,1,2009-06-26,191,仮払消費税等,洗車代,0,142,365224
4098,0001-20090626-75-643-1-1747,1,2009-06-26,733,交際接待費,香典代,0,10000,355224
4106,0001-20090626-88-645-1-1751,0,2009-06-26,739,新聞図書費,新聞代,0,3399,351825
4107,0001-20090626-88-645-1-1751,1,2009-06-26,191,仮払消費税等,新聞代,0,169,351656
4111,0001-20090627-127-656-1-1773,1,2009-06-27,738,租税公課,収入印紙,0,9000,342656
4118,0001-20090627-35-653-1-1767,0,2009-06-27,739,新聞図書費,新聞代,0,3739,338917
4119,0001-20090627-35-653-1-1767,1,2009-06-27,191,仮払消費税等,新聞代,0,186,338731
4122,0001-20090627-39-654-1-1769,0,2009-06-27,724,福利厚生費,会費,0,8572,330159
4123,0001-20090627-39-654-1-1769,1,2009-06-27,191,仮払消費税等,会費,0,428,329731
4130,0001-20090628-108-659-1-1779,0,2009-06-28,733,交際接待費,コーヒー代2名,0,1067,328664
4131,0001-20090628-108-659-1-1779,1,2009-06-28,191,仮払消費税等,コーヒー代2名,0,53,328611
4150,0001-20090628-60-657-1-1775,0,2009-06-28,726,旅費交通費,旅費,0,13810,314801
4151,0001-20090628-60-657-1-1775,1,2009-06-28,191,仮払消費税等,旅費,0,690,314111
4158,0001-20090629-83-661-1-1783,0,2009-06-29,740,車両費,車両管理費,0,49048,265063
4159,0001-20090629-83-661-1-1783,1,2009-06-29,191,仮払消費税等,車両管理費,0,2452,262611
4166,0001-20090630-100-678-1-1817,0,2009-06-30,724,福利厚生費,会費,0,5715,256896
4167,0001-20090630-100-678-1-1817,1,2009-06-30,191,仮払消費税等,会費,0,285,256611
4324,0001-20090630-128-688-1-1837,1,2009-06-30,738,租税公課,収入印紙,0,4000,252611
4342,0001-20090630-130-690-1-1841,1,2009-06-30,152,売掛金,09年6月30日伝票No452合同会社　エイム商事,365220,0,617831
4555,0001-20090630-67-667-1-1795,1,2009-06-30,742,諸会費,会費支払い,0,30000,587831
4592,0001-20090630-84-673-1-1807,0,2009-06-30,740,車両費,ガソリン代,0,3249,584582
4593,0001-20090630-84-673-1-1807,1,2009-06-30,191,仮払消費税等,ガソリン代,0,162,584420
,,,2009-06,,※※月計※※,,2308543,1841687,
4683,0001-20090701-56-710-1-1881,0,2009-07-01,726,旅費交通費,旅費,0,18858,565562
4684,0001-20090701-56-710-1-1881,1,2009-07-01,191,仮払消費税等,旅費,0,942,564620
4693,0001-20090701-70-712-1-1885,0,2009-07-01,791,雑費,電池代,0,437,564183
4694,0001-20090701-70-712-1-1885,1,2009-07-01,191,仮払消費税等,電池代,0,21,564162
4697,0001-20090701-79-713-1-1887,0,2009-07-01,724,福利厚生費,景品代,0,33407,530755
4698,0001-20090701-79-713-1-1887,1,2009-07-01,191,仮払消費税等,景品代,0,1670,529085
4701,0001-20090702-142-716-1-1893,0,2009-07-02,740,車両費,洗車代,0,2458,526627
4702,0001-20090702-142-716-1-1893,1,2009-07-02,191,仮払消費税等,洗車代,0,122,526505
4704,0001-20090702-142-716-1-1893,3,2009-07-02,740,車両費,ガソリン代,0,6229,520276
4705,0001-20090702-142-716-1-1893,4,2009-07-02,191,仮払消費税等,ガソリン代,0,311,519965
4706,0001-20090702-142-716-1-1893,5,2009-07-02,740,車両費,高速代,0,3086,516879
4707,0001-20090702-142-716-1-1893,6,2009-07-02,191,仮払消費税等,高速代,0,154,516725
4708,0001-20090702-142-716-1-1893,7,2009-07-02,740,車両費,高速代,0,477,516248
4709,0001-20090702-142-716-1-1893,8,2009-07-02,191,仮払消費税等,高速代,0,23,516225
4710,0001-20090702-142-716-1-1893,9,2009-07-02,740,車両費,高速代,0,8097,508128
4711,0001-20090702-142-716-1-1893,10,2009-07-02,191,仮払消費税等,高速代,0,404,507724
4712,0001-20090702-142-716-1-1893,11,2009-07-02,740,車両費,ガソリン代,0,3858,503866
4713,0001-20090702-142-716-1-1893,12,2009-07-02,191,仮払消費税等,ガソリン代,0,192,503674
4715,0001-20090702-151-717-1-1895,0,2009-07-02,733,交際接待費,食事代　ダイニング彩2名,0,6143,497531
4716,0001-20090702-151-717-1-1895,1,2009-07-02,191,仮払消費税等,食事代　ダイニング彩2名,0,307,497224
4718,0001-20090702-151-717-1-1895,3,2009-07-02,733,交際接待費,食事代　イタリアンレストランペンネ4名,0,8912,488312
4719,0001-20090702-151-717-1-1895,4,2009-07-02,191,仮払消費税等,食事代　イタリアンレストランペンネ4名,0,445,487867
4725,0001-20090703-134-720-1-1901,0,2009-07-03,754,事務用消耗品費,用紙,0,13124,474743
4726,0001-20090703-134-720-1-1901,1,2009-07-03,191,仮払消費税等,用紙,0,656,474087
4729,0001-20090703-19-718-1-1897,0,2009-07-03,726,旅費交通費,旅費,0,9953,464134
4730,0001-20090703-19-718-1-1897,1,2009-07-03,191,仮払消費税等,旅費,0,497,463637
4733,0001-20090703-80-719-1-1899,0,2009-07-03,726,旅費交通費,タクシー代,0,6191,457446
4734,0001-20090703-80-719-1-1899,1,2009-07-03,191,仮払消費税等,タクシー代,0,309,457137
4737,0001-20090704-10-721-1-1903,0,2009-07-04,740,車両費,ガソリン代,0,6972,450165
4738,0001-20090704-10-721-1-1903,1,2009-07-04,191,仮払消費税等,ガソリン代,0,348,449817
4742,0001-20090704-41-722-1-1905,1,2009-07-04,733,交際接待費,結婚式会費,0,12000,437817
4744,0001-20090704-73-723-1-1907,0,2009-07-04,733,交際接待費,飲食代　カフェモントレ,0,13934,423883
4745,0001-20090704-73-723-1-1907,1,2009-07-04,191,仮払消費税等,飲食代　カフェモントレ,0,696,423187
4758,0001-20090705-18-725-1-1911,0,2009-07-05,726,旅費交通費,航空券,0,23334,399853
4759,0001-20090705-18-725-1-1911,1,2009-07-05,191,仮払消費税等,航空券,0,1166,398687
4762,0001-20090705-42-726-1-1913,0,2009-07-05,733,交際接待費,コーヒー代3名,0,1500,397187
4763,0001-20090705-42-726-1-1913,1,2009-07-05,191,仮払消費税等,コーヒー代3名,0,75,397112
4790,0001-20090706-110-734-1-1929,0,2009-07-06,726,旅費交通費,タクシー代,0,2181,394931
4791,0001-20090706-110-734-1-1929,1,2009-07-06,191,仮払消費税等,タクシー代,0,109,394822
4794,0001-20090706-156-735-1-1931,0,2009-07-06,726,旅費交通費,出張旅費,0,11429,383393
4795,0001-20090706-156-735-1-1931,1,2009-07-06,191,仮払消費税等,出張旅費,0,571,382822
4798,0001-20090706-43-732-1-1925,0,2009-07-06,733,交際接待費,昼食代　レストラン桜花3名,0,6800,376022
4799,0001-20090706-43-732-1-1925,1,2009-07-06,191,仮払消費税等,昼食代　レストラン桜花3名,0,340,375682
4802,0001-20090706-7-731-1-1923,0,2009-07-06,733,交際接待費,食事代　ホテルランチ2名,0,5543,370139
4803,0001-20090706-7-731-1-1923,1,2009-07-06,191,仮払消費税等,食事代　ホテルランチ2名,0,277,369862
4805,0001-20090706-7-731-1-1923,3,2009-07-06,733,交際接待費,コーヒー代2名,0,1048,368814
4806,0001-20090706-7-731-1-1923,4,2009-07-06,191,仮払消費税等,コーヒー代2名,0,52,368762
4808,0001-20090706-94-733-1-1927,0,2009-07-06,791,雑費,トイレットペーパー代,0,2955,365807
4809,0001-20090706-94-733-1-1927,1,2009-07-06,191,仮払消費税等,トイレットペーパー代,0,147,365660
4812,0001-20090707-21-736-1-1933,0,2009-07-07,726,旅費交通費,JR代,0,66191,299469
4813,0001-20090707-21-736-1-1933,1,2009-07-07,191,仮払消費税等,JR代,0,3309,296160
4816,0001-20090707-22-737-1-1935,0,2009-07-07,726,旅費交通費,旅費,0,47620,248540
4817,0001-20090707-22-737-1-1935,1,2009-07-07,191,仮払消費税等,旅費,0,2380,246160
4820,0001-20090707-50-738-1-1937,0,2009-07-07,740,車両費,ガソリン代,0,11429,234731
4821,0001-20090707-50-738-1-1937,1,2009-07-07,191,仮払消費税等,ガソリン代,0,571,234160
4824,0001-20090708-103-742-1-1945,0,2009-07-08,733,交際接待費,コーヒー代4名,0,2105,232055
4825,0001-20090708-103-742-1-1945,1,2009-07-08,191,仮払消費税等,コーヒー代4名,0,105,231950
4836,0001-20090708-150-744-1-1949,0,2009-07-08,733,交際接待費,ゴルフプレー代2名,0,17372,214578
4837,0001-20090708-150-744-1-1949,1,2009-07-08,191,仮払消費税等,ゴルフプレー代2名,0,868,213710
4846,0001-20090708-20-739-1-1939,0,2009-07-08,726,旅費交通費,旅費,0,40000,173710
4847,0001-20090708-20-739-1-1939,1,2009-07-08,191,仮払消費税等,旅費,0,2000,171710
4850,0001-20090708-68-740-1-1941,0,2009-07-08,791,雑費,トイレットペーパー他,0,2249,169461
4851,0001-20090708-68-740-1-1941,1,2009-07-08,191,仮払消費税等,トイレットペーパー他,0,112,169349
4858,0001-20090709-143-747-1-1955,0,2009-07-09,740,車両費,点検作業料,0,38096,131253
4859,0001-20090709-143-747-1-1955,1,2009-07-09,191,仮払消費税等,点検作業料,0,1904,129349
4862,0001-20090709-79-746-1-1953,0,2009-07-09,740,車両費,ガソリン代,0,3352,125997
4863,0001-20090709-79-746-1-1953,1,2009-07-09,191,仮払消費税等,ガソリン代,0,167,125830
4883,0001-20090710-152-764-1-1989,0,2009-07-10,733,交際接待費,コーヒー代2名,0,1496,124334
4884,0001-20090710-152-764-1-1989,1,2009-07-10,191,仮払消費税等,コーヒー代2名,0,74,124260
4887,0001-20090710-162-765-1-1991,0,2009-07-10,734,会議費,会議　食事代,0,23805,100455
4888,0001-20090710-162-765-1-1991,1,2009-07-10,191,仮払消費税等,会議　食事代,0,1190,99265
4916,0001-20090710-57-749-1-1959,0,2009-07-10,726,旅費交通費,JR代,0,74357,24908
4917,0001-20090710-57-749-1-1959,1,2009-07-10,191,仮払消費税等,JR代,0,3717,21191
4984,0001-20090711-23-768-1-1997,0,2009-07-11,726,旅費交通費,旅費,0,34953,-13762
4985,0001-20090711-23-768-1-1997,1,2009-07-11,191,仮払消費税等,旅費,0,1747,-15509
4987,0001-20090711-23-768-1-1997,3,2009-07-11,726,旅費交通費,旅費,0,27334,-42843
4988,0001-20090711-23-768-1-1997,4,2009-07-11,191,仮払消費税等,旅費,0,1366,-44209
4989,0001-20090711-23-768-1-1997,5,2009-07-11,726,旅費交通費,旅費,0,55912,-100121
4990,0001-20090711-23-768-1-1997,6,2009-07-11,191,仮払消費税等,旅費,0,2795,-102916
4993,0001-20090711-61-769-1-1999,1,2009-07-11,121,当座預金,引き出し,2000000,0,1897084
4997,0001-20090711-69-770-1-2001,0,2009-07-11,791,雑費,トイレットペーパー代,0,760,1896324
4998,0001-20090711-69-770-1-2001,1,2009-07-11,191,仮払消費税等,トイレットペーパー代,0,38,1896286
5000,0001-20090711-69-770-1-2001,3,2009-07-11,791,雑費,洗剤代,0,805,1895481
5001,0001-20090711-69-770-1-2001,4,2009-07-11,191,仮払消費税等,洗剤代,0,40,1895441
5004,0001-20090712-149-774-1-2009,1,2009-07-12,733,交際接待費,香典代,0,10000,1885441
5006,0001-20090712-58-771-1-2003,0,2009-07-12,726,旅費交通費,旅費,0,57020,1828421
5007,0001-20090712-58-771-1-2003,1,2009-07-12,191,仮払消費税等,旅費,0,2850,1825571
5010,0001-20090712-74-772-1-2005,0,2009-07-12,733,交際接待費,食事代　トン吉4名,0,8277,1817294
5011,0001-20090712-74-772-1-2005,1,2009-07-12,191,仮払消費税等,食事代　トン吉4名,0,413,1816881
5014,0001-20090712-81-773-1-2007,0,2009-07-12,726,旅費交通費,旅費,0,19524,1797357
5015,0001-20090712-81-773-1-2007,1,2009-07-12,191,仮払消費税等,旅費,0,976,1796381
5018,0001-20090714-104-777-1-2015,0,2009-07-14,733,交際接待費,手土産代　阿部商店,0,1500,1794881
5019,0001-20090714-104-777-1-2015,1,2009-07-14,191,仮払消費税等,手土産代　阿部商店,0,75,1794806
5022,0001-20090714-51-775-1-2011,0,2009-07-14,740,車両費,高速代,0,7172,1787634
5023,0001-20090714-51-775-1-2011,1,2009-07-14,191,仮払消費税等,高速代,0,358,1787276
5025,0001-20090714-51-775-1-2011,3,2009-07-14,740,車両費,駐車代,0,3286,1783990
5026,0001-20090714-51-775-1-2011,4,2009-07-14,191,仮払消費税等,駐車代,0,164,1783826
5028,0001-20090714-74-776-1-2013,0,2009-07-14,733,交際接待費,ゴルフプレー代,0,7524,1776302
5029,0001-20090714-74-776-1-2013,1,2009-07-14,191,仮払消費税等,ゴルフプレー代,0,376,1775926
5051,0001-20090715-117-787-1-2035,1,2009-07-15,742,諸会費,会費,0,20000,1755926
5058,0001-20090715-141-789-1-2039,0,2009-07-15,726,旅費交通費,JR代,0,7143,1748783
5059,0001-20090715-141-789-1-2039,1,2009-07-15,191,仮払消費税等,JR代,0,357,1748426
5062,0001-20090715-46-778-1-2017,0,2009-07-15,740,車両費,ガソリン代,0,13334,1735092
5063,0001-20090715-46-778-1-2017,1,2009-07-15,191,仮払消費税等,ガソリン代,0,666,1734426
5067,0001-20090715-84-779-1-2019,1,2009-07-15,721,雑給,7月給与その他 0060 パート･アルバイト,0,351930,1382496
5107,0001-20090716-105-793-1-2047,0,2009-07-16,733,交際接待費,飲食代　ダイニング彩4名,0,17461,1365035
5108,0001-20090716-105-793-1-2047,1,2009-07-16,191,仮払消費税等,飲食代　ダイニング彩4名,0,873,1364162
5110,0001-20090716-105-793-1-2047,3,2009-07-16,733,交際接待費,飲食代　スナック箱船4名,0,31305,1332857
5111,0001-20090716-105-793-1-2047,4,2009-07-16,191,仮払消費税等,飲食代　スナック箱船4名,0,1565,1331292
5113,0001-20090716-11-790-1-2041,0,2009-07-16,740,車両費,ガソリン代,0,3058,1328234
5114,0001-20090716-11-790-1-2041,1,2009-07-16,191,仮払消費税等,ガソリン代,0,152,1328082
5117,0001-20090716-136-794-1-2049,0,2009-07-16,791,雑費,ダスキン代,0,15715,1312367
5118,0001-20090716-136-794-1-2049,1,2009-07-16,191,仮払消費税等,ダスキン代,0,785,1311582
5121,0001-20090716-161-795-1-2051,0,2009-07-16,726,旅費交通費,旅費,0,3334,1308248
5122,0001-20090716-161-795-1-2051,1,2009-07-16,191,仮払消費税等,旅費,0,166,1308082
5125,0001-20090716-52-791-1-2043,0,2009-07-16,740,車両費,高速代,0,3381,1304701
5126,0001-20090716-52-791-1-2043,1,2009-07-16,191,仮払消費税等,高速代,0,169,1304532
5128,0001-20090716-52-791-1-2043,3,2009-07-16,740,車両費,ガソリン代,0,71429,1233103
5129,0001-20090716-52-791-1-2043,4,2009-07-16,191,仮払消費税等,ガソリン代,0,3571,1229532
5137,0001-20090717-12-797-1-2055,0,2009-07-17,740,車両費,駐車代,0,762,1228770
5138,0001-20090717-12-797-1-2055,1,2009-07-17,191,仮払消費税等,駐車代,0,38,1228732
5140,0001-20090717-12-797-1-2055,3,2009-07-17,740,車両費,ガソリン代,0,4456,1224276
5141,0001-20090717-12-797-1-2055,4,2009-07-17,191,仮払消費税等,ガソリン代,0,222,1224054
5143,0001-20090717-12-797-1-2055,6,2009-07-17,740,車両費,ガソリン代,0,4015,1220039
5144,0001-20090717-12-797-1-2055,7,2009-07-17,191,仮払消費税等,ガソリン代,0,200,1219839
5150,0001-20090718-123-800-1-2061,0,2009-07-18,727,通信費,切手代,0,15239,1204600
5151,0001-20090718-123-800-1-2061,1,2009-07-18,191,仮払消費税等,切手代,0,761,1203839
5158,0001-20090718-148-802-1-2065,0,2009-07-18,740,車両費,ガソリン代,0,4486,1199353
5159,0001-20090718-148-802-1-2065,1,2009-07-18,191,仮払消費税等,ガソリン代,0,224,1199129
5161,0001-20090718-148-802-1-2065,3,2009-07-18,740,車両費,ウォッシャー液他,0,1600,1197529
5162,0001-20090718-148-802-1-2065,4,2009-07-18,191,仮払消費税等,ウォッシャー液他,0,80,1197449
5164,0001-20090718-59-798-1-2057,0,2009-07-18,726,旅費交通費,旅費,0,42858,1154591
5165,0001-20090718-59-798-1-2057,1,2009-07-18,191,仮払消費税等,旅費,0,2142,1152449
5168,0001-20090718-82-799-1-2059,0,2009-07-18,726,旅費交通費,旅費,0,9334,1143115
5169,0001-20090718-82-799-1-2059,1,2009-07-18,191,仮払消費税等,旅費,0,466,1142649
5172,0001-20090719-160-805-1-2071,0,2009-07-19,726,旅費交通費,出張旅費,0,82572,1060077
5173,0001-20090719-160-805-1-2071,1,2009-07-19,191,仮払消費税等,出張旅費,0,4128,1055949
5176,0001-20090719-47-804-1-2069,0,2009-07-19,740,車両費,ガソリン代,0,8134,1047815
5177,0001-20090719-47-804-1-2069,1,2009-07-19,191,仮払消費税等,ガソリン代,0,406,1047409
5180,0001-20090719-8-803-1-2067,0,2009-07-19,733,交際接待費,定例ミーティング会費,0,19048,1028361
5181,0001-20090719-8-803-1-2067,1,2009-07-19,191,仮払消費税等,定例ミーティング会費,0,952,1027409
5183,0001-20090719-8-803-1-2067,3,2009-07-19,733,交際接待費,景品,0,3010,1024399
5184,0001-20090719-8-803-1-2067,4,2009-07-19,191,仮払消費税等,景品,0,150,1024249
5191,0001-20090720-103-818-1-2097,1,2009-07-20,152,売掛金,09年7月20日伝票No264株式会社　斉藤,633459,0,1657708
5255,0001-20090720-144-829-1-2119,0,2009-07-20,740,車両費,ガソリン代,0,4324,1653384
5256,0001-20090720-144-829-1-2119,1,2009-07-20,191,仮払消費税等,ガソリン代,0,216,1653168
5258,0001-20090720-144-829-1-2119,3,2009-07-20,740,車両費,高速代,0,3408,1649760
5259,0001-20090720-144-829-1-2119,4,2009-07-20,191,仮払消費税等,高速代,0,170,1649590
5260,0001-20090720-144-829-1-2119,5,2009-07-20,740,車両費,ガソリン代,0,7048,1642542
5261,0001-20090720-144-829-1-2119,6,2009-07-20,191,仮払消費税等,ガソリン代,0,352,1642190
5263,0001-20090720-158-830-1-2121,0,2009-07-20,726,旅費交通費,出張旅費,0,9524,1632666
5264,0001-20090720-158-830-1-2121,1,2009-07-20,191,仮払消費税等,出張旅費,0,476,1632190
5268,0001-20090720-163-831-1-2123,1,2009-07-20,742,諸会費,会費,0,18000,1614190
5270,0001-20090720-164-832-1-2125,0,2009-07-20,754,事務用消耗品費,事務用品,0,5696,1608494
5271,0001-20090720-164-832-1-2125,1,2009-07-20,191,仮払消費税等,事務用品,0,284,1608210
5278,0001-20090720-45-808-1-2077,0,2009-07-20,733,交際接待費,コーヒー代2名,0,1200,1607010
5279,0001-20090720-45-808-1-2077,1,2009-07-20,191,仮払消費税等,コーヒー代2名,0,60,1606950
5282,0001-20090720-48-809-1-2079,0,2009-07-20,740,車両費,ガソリン代,0,4099,1602851
5283,0001-20090720-48-809-1-2079,1,2009-07-20,191,仮払消費税等,ガソリン代,0,204,1602647
5286,0001-20090720-53-810-1-2081,0,2009-07-20,740,車両費,ガソリン代,0,6381,1596266
5287,0001-20090720-53-810-1-2081,1,2009-07-20,191,仮払消費税等,ガソリン代,0,319,1595947
5289,0001-20090720-53-810-1-2081,3,2009-07-20,740,車両費,駐車代,0,1429,1594518
5290,0001-20090720-53-810-1-2081,4,2009-07-20,191,仮払消費税等,駐車代,0,71,1594447
5291,0001-20090720-53-810-1-2081,5,2009-07-20,740,車両費,高速代,0,715,1593732
5292,0001-20090720-53-810-1-2081,6,2009-07-20,191,仮払消費税等,高速代,0,35,1593697
5294,0001-20090720-6-806-1-2073,0,2009-07-20,732,広告宣伝費,広告料,0,4762,1588935
5295,0001-20090720-6-806-1-2073,1,2009-07-20,191,仮払消費税等,広告料,0,238,1588697
5328,0001-20090721-159-835-1-2131,0,2009-07-21,726,旅費交通費,タクシー代,0,9315,1579382
5329,0001-20090721-159-835-1-2131,1,2009-07-21,191,仮払消費税等,タクシー代,0,465,1578917
5332,0001-20090721-25-833-1-2127,0,2009-07-21,726,旅費交通費,旅費,0,53334,1525583
5333,0001-20090721-25-833-1-2127,1,2009-07-21,191,仮払消費税等,旅費,0,2666,1522917
5348,0001-20090722-165-843-1-2147,0,2009-07-22,791,雑費,洗剤他,0,2410,1520507
5349,0001-20090722-165-843-1-2147,1,2009-07-22,191,仮払消費税等,洗剤他,0,120,1520387
5352,0001-20090722-166-844-1-2149,0,2009-07-22,791,雑費,ダスキン代,0,1800,1518587
5353,0001-20090722-166-844-1-2149,1,2009-07-22,191,仮払消費税等,ダスキン代,0,90,1518497
5364,0001-20090722-26-836-1-2133,0,2009-07-22,726,旅費交通費,旅費,0,18143,1500354
5365,0001-20090722-26-836-1-2133,1,2009-07-22,191,仮払消費税等,旅費,0,907,1499447
5394,0001-20090722-90-840-1-2141,0,2009-07-22,791,雑費,ダスキン代,0,10000,1489447
5395,0001-20090722-90-840-1-2141,1,2009-07-22,191,仮払消費税等,ダスキン代,0,500,1488947
5402,0001-20090723-140-847-1-2155,0,2009-07-23,726,旅費交通費,旅費,0,10477,1478470
5403,0001-20090723-140-847-1-2155,1,2009-07-23,191,仮払消費税等,旅費,0,523,1477947
5406,0001-20090723-24-846-1-2153,0,2009-07-23,726,旅費交通費,JR回数券,0,78686,1399261
5407,0001-20090723-24-846-1-2153,1,2009-07-23,191,仮払消費税等,JR回数券,0,3934,1395327
5423,0001-20090724-137-850-1-2161,11,2009-07-24,740,車両費,駐車代,0,3340,1391987
5424,0001-20090724-137-850-1-2161,12,2009-07-24,191,仮払消費税等,駐車代,0,167,1391820
5441,0001-20090724-54-849-1-2159,0,2009-07-24,740,車両費,高速代,0,2858,1388962
5442,0001-20090724-54-849-1-2159,1,2009-07-24,191,仮払消費税等,高速代,0,142,1388820
5444,0001-20090724-54-849-1-2159,3,2009-07-24,740,車両費,ガソリン代,0,4412,1384408
5445,0001-20090724-54-849-1-2159,4,2009-07-24,191,仮払消費税等,ガソリン代,0,220,1384188
5480,0001-20090725-114-867-1-2195,0,2009-07-25,739,新聞図書費,新聞代,0,2540,1381648
5481,0001-20090725-114-867-1-2195,1,2009-07-25,191,仮払消費税等,新聞代,0,126,1381522
5483,0001-20090725-114-867-1-2195,3,2009-07-25,739,新聞図書費,新聞代,0,2864,1378658
5484,0001-20090725-114-867-1-2195,4,2009-07-25,191,仮払消費税等,新聞代,0,143,1378515
5491,0001-20090725-153-869-1-2199,0,2009-07-25,733,交際接待費,食事代　カナッシュ2名,0,3372,1375143
5492,0001-20090725-153-869-1-2199,1,2009-07-25,191,仮払消費税等,食事代　カナッシュ2名,0,168,1374975
5495,0001-20090725-155-870-1-2201,0,2009-07-25,740,車両費,ガソリン代,0,6901,1368074
5496,0001-20090725-155-870-1-2201,1,2009-07-25,191,仮払消費税等,ガソリン代,0,345,1367729
5499,0001-20090725-170-871-1-2203,0,2009-07-25,739,新聞図書費,新聞代,0,2864,1364865
5500,0001-20090725-170-871-1-2203,1,2009-07-25,191,仮払消費税等,新聞代,0,143,1364722
5523,0001-20090725-35-856-1-2173,0,2009-07-25,739,新聞図書費,新聞代,0,3739,1360983
5524,0001-20090725-35-856-1-2173,1,2009-07-25,191,仮払消費税等,新聞代,0,186,1360797
5527,0001-20090725-60-857-1-2175,0,2009-07-25,726,旅費交通費,旅費,0,10667,1350130
5528,0001-20090725-60-857-1-2175,1,2009-07-25,191,仮払消費税等,旅費,0,533,1349597
5656,0001-20090725-88-861-1-2183,0,2009-07-25,739,新聞図書費,新聞代,0,3399,1346198
5657,0001-20090725-88-861-1-2183,1,2009-07-25,191,仮払消費税等,新聞代,0,169,1346029
5678,0001-20090726-27-873-1-2207,0,2009-07-26,726,旅費交通費,旅費,0,14324,1331705
5679,0001-20090726-27-873-1-2207,1,2009-07-26,191,仮払消費税等,旅費,0,716,1330989
5681,0001-20090726-27-873-1-2207,3,2009-07-26,726,旅費交通費,旅費,0,43686,1287303
5682,0001-20090726-27-873-1-2207,4,2009-07-26,191,仮払消費税等,旅費,0,2184,1285119
5683,0001-20090726-27-873-1-2207,5,2009-07-26,726,旅費交通費,旅費,0,30077,1255042
5684,0001-20090726-27-873-1-2207,6,2009-07-26,191,仮払消費税等,旅費,0,1503,1253539
5686,0001-20090726-73-874-1-2209,0,2009-07-26,733,交際接待費,ゴルフプレー代2名,0,30667,1222872
5687,0001-20090726-73-874-1-2209,1,2009-07-26,191,仮払消費税等,ゴルフプレー代2名,0,1533,1221339
5690,0001-20090726-83-875-1-2211,0,2009-07-26,726,旅費交通費,ＪＲ代,0,11429,1209910
5691,0001-20090726-83-875-1-2211,1,2009-07-26,191,仮払消費税等,ＪＲ代,0,571,1209339
5694,0001-20090727-15-879-1-2219,0,2009-07-27,740,車両費,高速代,0,2858,1206481
5695,0001-20090727-15-879-1-2219,1,2009-07-27,191,仮払消費税等,高速代,0,142,1206339
5711,0001-20090727-39-882-1-2225,0,2009-07-27,724,福利厚生費,会費,0,8572,1197767
5712,0001-20090727-39-882-1-2225,1,2009-07-27,191,仮払消費税等,会費,0,428,1197339
5721,0001-20090727-83-884-1-2229,0,2009-07-27,740,車両費,車両管理費,0,42858,1154481
5722,0001-20090727-83-884-1-2229,1,2009-07-27,191,仮払消費税等,車両管理費,0,2142,1152339
5725,0001-20090728-121-889-1-2239,0,2009-07-28,724,福利厚生費,お茶代,0,10000,1142339
5726,0001-20090728-121-889-1-2239,1,2009-07-28,191,仮払消費税等,お茶代,0,500,1141839
5729,0001-20090728-138-890-1-2241,0,2009-07-28,740,車両費,高速代,0,4290,1137549
5730,0001-20090728-138-890-1-2241,1,2009-07-28,191,仮払消費税等,高速代,0,214,1137335
5732,0001-20090728-138-890-1-2241,3,2009-07-28,740,車両費,駐車代,0,3049,1134286
5733,0001-20090728-138-890-1-2241,4,2009-07-28,191,仮払消費税等,駐車代,0,152,1134134
5734,0001-20090728-138-890-1-2241,5,2009-07-28,740,車両費,高速代,0,6229,1127905
5735,0001-20090728-138-890-1-2241,6,2009-07-28,191,仮払消費税等,高速代,0,311,1127594
5736,0001-20090728-138-890-1-2241,7,2009-07-28,740,車両費,高速代,0,477,1127117
5737,0001-20090728-138-890-1-2241,8,2009-07-28,191,仮払消費税等,高速代,0,23,1127094
5738,0001-20090728-138-890-1-2241,9,2009-07-28,740,車両費,高速代,0,2353,1124741
5739,0001-20090728-138-890-1-2241,10,2009-07-28,191,仮払消費税等,高速代,0,117,1124624
5740,0001-20090728-138-890-1-2241,11,2009-07-28,740,車両費,ガソリン代,0,6198,1118426
5741,0001-20090728-138-890-1-2241,12,2009-07-28,191,仮払消費税等,ガソリン代,0,309,1118117
5743,0001-20090728-72-886-1-2233,0,2009-07-28,739,新聞図書費,新聞代,0,2864,1115253
5744,0001-20090728-72-886-1-2233,1,2009-07-28,191,仮払消費税等,新聞代,0,143,1115110
5746,0001-20090728-72-886-1-2233,3,2009-07-28,739,新聞図書費,新聞代,0,2815,1112295
5747,0001-20090728-72-886-1-2233,4,2009-07-28,191,仮払消費税等,新聞代,0,140,1112155
5748,0001-20090728-72-886-1-2233,5,2009-07-28,739,新聞図書費,新聞代,0,3399,1108756
5749,0001-20090728-72-886-1-2233,6,2009-07-28,191,仮払消費税等,新聞代,0,169,1108587
5755,0001-20090728-9-885-1-2231,0,2009-07-28,733,交際接待費,手土産ジュース他　総合経営,0,2400,1106187
5756,0001-20090728-9-885-1-2231,1,2009-07-28,191,仮払消費税等,手土産ジュース他　総合経営,0,120,1106067
5763,0001-20090729-108-892-1-2245,0,2009-07-29,733,交際接待費,コーヒー代他　2名,0,1496,1104571
5764,0001-20090729-108-892-1-2245,1,2009-07-29,191,仮払消費税等,コーヒー代他　2名,0,74,1104497
5767,0001-20090729-14-891-1-2243,0,2009-07-29,740,車両費,ガソリン代,0,2858,1101639
5768,0001-20090729-14-891-1-2243,1,2009-07-29,191,仮払消費税等,ガソリン代,0,142,1101497
5771,0001-20090730-100-900-1-2261,0,2009-07-30,724,福利厚生費,会費,0,5715,1095782
5772,0001-20090730-100-900-1-2261,1,2009-07-30,191,仮払消費税等,会費,0,285,1095497
5780,0001-20090730-49-893-1-2247,0,2009-07-30,740,車両費,ガソリン代,0,161905,933592
5781,0001-20090730-49-893-1-2247,1,2009-07-30,191,仮払消費税等,ガソリン代,0,8095,925497
5783,0001-20090730-49-893-1-2247,3,2009-07-30,740,車両費,車両管理費,0,20000,905497
5784,0001-20090730-49-893-1-2247,4,2009-07-30,191,仮払消費税等,車両管理費,0,1000,904497
5809,0001-20090730-67-896-1-2253,1,2009-07-30,742,諸会費,会費支払い,0,30000,874497
5820,0001-20090730-71-898-1-2257,0,2009-07-30,791,雑費,洗剤代,0,760,873737
5821,0001-20090730-71-898-1-2257,1,2009-07-30,191,仮払消費税等,洗剤代,0,38,873699
5988,0001-20090731-123-923-1-2307,1,2009-07-31,152,売掛金,09年7月31日伝票No453合同会社　エイム商事,350112,0,1223811
,,,2009-07,,※※月計※※,,2983571,2344180,
6214,0001-20090801-102-947-1-2355,0,2009-08-01,733,交際接待費,手土産代　阿部商店,0,2000,1221811
6215,0001-20090801-102-947-1-2355,1,2009-08-01,191,仮払消費税等,手土産代　阿部商店,0,100,1221711
6218,0001-20090801-18-944-1-2349,0,2009-08-01,726,旅費交通費,旅費,0,20000,1201711
6219,0001-20090801-18-944-1-2349,1,2009-08-01,191,仮払消費税等,旅費,0,1000,1200711
6222,0001-20090801-41-945-1-2351,0,2009-08-01,733,交際接待費,食事代　レストランフレンド3名,0,3343,1197368
6223,0001-20090801-41-945-1-2351,1,2009-08-01,191,仮払消費税等,食事代　レストランフレンド3名,0,167,1197201
6226,0001-20090801-50-946-1-2353,0,2009-08-01,740,車両費,高速代,0,572,1196629
6227,0001-20090801-50-946-1-2353,1,2009-08-01,191,仮払消費税等,高速代,0,28,1196601
6245,0001-20090803-142-953-1-2367,0,2009-08-03,740,車両費,高速代,0,2458,1194143
6246,0001-20090803-142-953-1-2367,1,2009-08-03,191,仮払消費税等,高速代,0,122,1194021
6248,0001-20090803-142-953-1-2367,3,2009-08-03,740,車両費,ガソリン代,0,3052,1190969
6249,0001-20090803-142-953-1-2367,4,2009-08-03,191,仮払消費税等,ガソリン代,0,152,1190817
6250,0001-20090803-142-953-1-2367,5,2009-08-03,740,車両費,高速代,0,1191,1189626
6251,0001-20090803-142-953-1-2367,6,2009-08-03,191,仮払消費税等,高速代,0,59,1189567
6252,0001-20090803-142-953-1-2367,7,2009-08-03,740,車両費,高速代,0,8543,1181024
6253,0001-20090803-142-953-1-2367,8,2009-08-03,191,仮払消費税等,高速代,0,427,1180597
6254,0001-20090803-142-953-1-2367,9,2009-08-03,740,車両費,高速代,0,4290,1176307
6255,0001-20090803-142-953-1-2367,10,2009-08-03,191,仮払消費税等,高速代,0,214,1176093
6257,0001-20090803-56-949-1-2359,0,2009-08-03,726,旅費交通費,旅費,0,14953,1161140
6258,0001-20090803-56-949-1-2359,1,2009-08-03,191,仮払消費税等,旅費,0,747,1160393
6265,0001-20090804-141-955-1-2371,0,2009-08-04,726,旅費交通費,JR代,0,8191,1152202
6266,0001-20090804-141-955-1-2371,1,2009-08-04,191,仮払消費税等,JR代,0,409,1151793
6269,0001-20090804-42-954-1-2369,0,2009-08-04,733,交際接待費,昼食代3名　ホテルエルディ,0,4429,1147364
6270,0001-20090804-42-954-1-2369,1,2009-08-04,191,仮払消費税等,昼食代3名　ホテルエルディ,0,221,1147143
6279,0001-20090805-19-956-1-2373,0,2009-08-05,726,旅費交通費,旅費,0,10000,1137143
6280,0001-20090805-19-956-1-2373,1,2009-08-05,191,仮払消費税等,旅費,0,500,1136643
6283,0001-20090805-57-957-1-2375,0,2009-08-05,726,旅費交通費,JR代,0,85429,1051214
6284,0001-20090805-57-957-1-2375,1,2009-08-05,191,仮払消費税等,JR代,0,4271,1046943
6308,0001-20090806-106-963-1-2387,0,2009-08-06,733,交際接待費,お中元　五越百貨店,0,36814,1010129
6309,0001-20090806-106-963-1-2387,1,2009-08-06,191,仮払消費税等,お中元　五越百貨店,0,1840,1008289
6311,0001-20090806-106-963-1-2387,3,2009-08-06,733,交際接待費,お中元　阿部商店,0,9750,998539
6312,0001-20090806-106-963-1-2387,4,2009-08-06,191,仮払消費税等,お中元　阿部商店,0,487,998052
6314,0001-20090806-110-964-1-2389,0,2009-08-06,726,旅費交通費,タクシー代,0,2181,995871
6315,0001-20090806-110-964-1-2389,1,2009-08-06,191,仮払消費税等,タクシー代,0,109,995762
6318,0001-20090806-156-965-1-2391,0,2009-08-06,726,旅費交通費,出張旅費,0,2381,993381
6319,0001-20090806-156-965-1-2391,1,2009-08-06,191,仮払消費税等,出張旅費,0,119,993262
6322,0001-20090806-71-962-1-2385,0,2009-08-06,733,交際接待費,ゴルフプレー代2名,0,23048,970214
6323,0001-20090806-71-962-1-2385,1,2009-08-06,191,仮払消費税等,ゴルフプレー代2名,0,1152,969062
6326,0001-20090807-10-966-1-2393,0,2009-08-07,740,車両費,ガソリン代,0,4023,965039
6327,0001-20090807-10-966-1-2393,1,2009-08-07,191,仮払消費税等,ガソリン代,0,201,964838
6330,0001-20090807-21-967-1-2395,0,2009-08-07,726,旅費交通費,JR代,0,66191,898647
6331,0001-20090807-21-967-1-2395,1,2009-08-07,191,仮払消費税等,JR代,0,3309,895338
6334,0001-20090807-22-968-1-2397,0,2009-08-07,726,旅費交通費,旅費,0,47620,847718
6335,0001-20090807-22-968-1-2397,1,2009-08-07,191,仮払消費税等,旅費,0,2380,845338
6338,0001-20090807-58-969-1-2399,0,2009-08-07,726,旅費交通費,旅費,0,66667,778671
6339,0001-20090807-58-969-1-2399,1,2009-08-07,191,仮払消費税等,旅費,0,3333,775338
6342,0001-20090808-149-970-1-2401,0,2009-08-08,733,交際接待費,手土産代　五越百貨店,0,10000,765338
6343,0001-20090808-149-970-1-2401,1,2009-08-08,191,仮払消費税等,手土産代　五越百貨店,0,500,764838
6346,0001-20090808-150-971-1-2403,0,2009-08-08,733,交際接待費,お中元　今井百貨店,0,71661,693177
6347,0001-20090808-150-971-1-2403,1,2009-08-08,191,仮払消費税等,お中元　今井百貨店,0,3583,689594
6356,0001-20090809-143-977-1-2415,0,2009-08-09,740,車両費,点検作業料,0,30002,659592
6357,0001-20090809-143-977-1-2415,1,2009-08-09,191,仮払消費税等,点検作業料,0,1500,658092
6360,0001-20090809-20-972-1-2405,0,2009-08-09,726,旅費交通費,旅費,0,39048,619044
6361,0001-20090809-20-972-1-2405,1,2009-08-09,191,仮払消費税等,旅費,0,1952,617092
6364,0001-20090809-44-973-1-2407,0,2009-08-09,733,交際接待費,手土産代　エントリー,0,2705,614387
6365,0001-20090809-44-973-1-2407,1,2009-08-09,191,仮払消費税等,手土産代　エントリー,0,135,614252
6368,0001-20090809-46-974-1-2409,0,2009-08-09,740,車両費,レーダー代,0,3298,610954
6369,0001-20090809-46-974-1-2409,1,2009-08-09,191,仮払消費税等,レーダー代,0,164,610790
6371,0001-20090809-46-974-1-2409,3,2009-08-09,740,車両費,ガソリン代,0,4207,606583
6372,0001-20090809-46-974-1-2409,4,2009-08-09,191,仮払消費税等,ガソリン代,0,210,606373
6389,0001-20090810-148-993-1-2447,0,2009-08-10,740,車両費,ガソリン代,0,3755,602618
6390,0001-20090810-148-993-1-2447,1,2009-08-10,191,仮払消費税等,ガソリン代,0,187,602431
6393,0001-20090810-151-994-1-2449,0,2009-08-10,733,交際接待費,食事代　お好み焼きやきやき2名,0,2740,599691
6394,0001-20090810-151-994-1-2449,1,2009-08-10,191,仮払消費税等,食事代　お好み焼きやきやき2名,0,136,599555
6397,0001-20090810-152-995-1-2451,0,2009-08-10,733,交際接待費,手土産代　大塚物産,0,3000,596555
6398,0001-20090810-152-995-1-2451,1,2009-08-10,191,仮払消費税等,手土産代　大塚物産,0,150,596405
6401,0001-20090810-162-996-1-2453,0,2009-08-10,734,会議費,会議　食事代,0,23805,572600
6402,0001-20090810-162-996-1-2453,1,2009-08-10,191,仮払消費税等,会議　食事代,0,1190,571410
6458,0001-20090810-77-982-1-2425,0,2009-08-10,726,旅費交通費,旅費,0,14286,557124
6459,0001-20090810-77-982-1-2425,1,2009-08-10,191,仮払消費税等,旅費,0,714,556410
6462,0001-20090810-79-983-1-2427,0,2009-08-10,724,福利厚生費,景品代,0,28453,527957
6463,0001-20090810-79-983-1-2427,1,2009-08-10,191,仮払消費税等,景品代,0,1422,526535
6502,0001-20090811-144-1003-1-2467,0,2009-08-11,740,車両費,ガソリン代,0,3294,523241
6503,0001-20090811-144-1003-1-2467,1,2009-08-11,191,仮払消費税等,ガソリン代,0,164,523077
6505,0001-20090811-144-1003-1-2467,3,2009-08-11,740,車両費,ガソリン代,0,6195,516882
6506,0001-20090811-144-1003-1-2467,4,2009-08-11,191,仮払消費税等,ガソリン代,0,309,516573
6507,0001-20090811-144-1003-1-2467,5,2009-08-11,740,車両費,洗車代,0,1905,514668
6508,0001-20090811-144-1003-1-2467,6,2009-08-11,191,仮払消費税等,洗車代,0,95,514573
6510,0001-20090811-165-1004-1-2469,0,2009-08-11,791,雑費,ティッシュ他,0,743,513830
6511,0001-20090811-165-1004-1-2469,1,2009-08-11,191,仮払消費税等,ティッシュ他,0,37,513793
6515,0001-20090811-60-1000-1-2461,1,2009-08-11,121,当座預金,引き出し,1500000,0,2013793
6519,0001-20090811-7-999-1-2459,0,2009-08-11,733,交際接待費,昼食代　ホテルグランディ3名,0,7753,2006040
6520,0001-20090811-7-999-1-2459,1,2009-08-11,191,仮払消費税等,昼食代　ホテルグランディ3名,0,387,2005653
6523,0001-20090811-78-1001-1-2463,0,2009-08-11,726,旅費交通費,ＪＲ代,0,7810,1997843
6524,0001-20090811-78-1001-1-2463,1,2009-08-11,191,仮払消費税等,ＪＲ代,0,390,1997453
6533,0001-20090812-153-1005-1-2471,0,2009-08-12,733,交際接待費,食事代　ホテルクリーク2名,0,3267,1994186
6534,0001-20090812-153-1005-1-2471,1,2009-08-12,191,仮払消費税等,食事代　ホテルクリーク2名,0,163,1994023
6537,0001-20090813-11-1006-1-2473,0,2009-08-13,740,車両費,ガソリン代,0,3058,1990965
6538,0001-20090813-11-1006-1-2473,1,2009-08-13,191,仮払消費税等,ガソリン代,0,152,1990813
6541,0001-20090813-158-1007-1-2475,0,2009-08-13,726,旅費交通費,出張旅費,0,8477,1982336
6542,0001-20090813-158-1007-1-2475,1,2009-08-13,191,仮払消費税等,出張旅費,0,423,1981913
6560,0001-20090815-59-1010-1-2481,0,2009-08-15,726,旅費交通費,旅費,0,24762,1957151
6561,0001-20090815-59-1010-1-2481,1,2009-08-15,191,仮払消費税等,旅費,0,1238,1955913
6565,0001-20090815-81-1011-1-2483,1,2009-08-15,721,雑給,8月給与その他 0060 パート･アルバイト,0,508535,1447378
6623,0001-20090816-12-1020-1-2501,0,2009-08-16,740,車両費,ガソリン代,0,4456,1442922
6624,0001-20090816-12-1020-1-2501,1,2009-08-16,191,仮払消費税等,ガソリン代,0,222,1442700
6626,0001-20090816-12-1020-1-2501,3,2009-08-16,740,車両費,高速代,0,2313,1440387
6627,0001-20090816-12-1020-1-2501,4,2009-08-16,191,仮払消費税等,高速代,0,115,1440272
6628,0001-20090816-12-1020-1-2501,5,2009-08-16,740,車両費,ウォッシャー液,0,300,1439972
6629,0001-20090816-12-1020-1-2501,6,2009-08-16,191,仮払消費税等,ウォッシャー液,0,15,1439957
6631,0001-20090816-136-1023-1-2507,0,2009-08-16,791,雑費,ダスキン代,0,15715,1424242
6632,0001-20090816-136-1023-1-2507,1,2009-08-16,191,仮払消費税等,ダスキン代,0,785,1423457
6635,0001-20090816-51-1021-1-2503,0,2009-08-16,740,車両費,高速代,0,3362,1420095
6636,0001-20090816-51-1021-1-2503,1,2009-08-16,191,仮払消費税等,高速代,0,168,1419927
6638,0001-20090816-51-1021-1-2503,3,2009-08-16,740,車両費,ガソリン代,0,4412,1415515
6639,0001-20090816-51-1021-1-2503,4,2009-08-16,191,仮払消費税等,ガソリン代,0,220,1415295
6640,0001-20090816-51-1021-1-2503,5,2009-08-16,740,車両費,駐車代,0,1762,1413533
6641,0001-20090816-51-1021-1-2503,6,2009-08-16,191,仮払消費税等,駐車代,0,88,1413445
6643,0001-20090816-74-1022-1-2505,0,2009-08-16,733,交際接待費,飲食代　カフェバーライン,0,8905,1404540
6644,0001-20090816-74-1022-1-2505,1,2009-08-16,191,仮払消費税等,飲食代　カフェバーライン,0,445,1404095
6648,0001-20090817-117-1025-1-2511,1,2009-08-17,742,諸会費,会費,0,20000,1384095
6653,0001-20090817-159-1027-1-2515,0,2009-08-17,726,旅費交通費,タクシー代,0,10496,1373599
6654,0001-20090817-159-1027-1-2515,1,2009-08-17,191,仮払消費税等,タクシー代,0,524,1373075
6657,0001-20090817-52-1024-1-2509,0,2009-08-17,740,車両費,ガソリン代,0,3620,1369455
6658,0001-20090817-52-1024-1-2509,1,2009-08-17,191,仮払消費税等,ガソリン代,0,180,1369275
6661,0001-20090818-103-1029-1-2519,0,2009-08-18,733,交際接待費,手土産代　今井百貨店,0,3000,1366275
6662,0001-20090818-103-1029-1-2519,1,2009-08-18,191,仮払消費税等,手土産代　今井百貨店,0,150,1366125
6665,0001-20090818-23-1028-1-2517,0,2009-08-18,726,旅費交通費,旅費,0,26229,1339896
6666,0001-20090818-23-1028-1-2517,1,2009-08-18,191,仮払消費税等,旅費,0,1311,1338585
6668,0001-20090818-23-1028-1-2517,3,2009-08-18,726,旅費交通費,旅費,0,33720,1304865
6669,0001-20090818-23-1028-1-2517,4,2009-08-18,191,仮払消費税等,旅費,0,1685,1303180
6670,0001-20090818-23-1028-1-2517,5,2009-08-18,726,旅費交通費,旅費,0,39639,1263541
6671,0001-20090818-23-1028-1-2517,6,2009-08-18,191,仮払消費税等,旅費,0,1981,1261560
6673,0001-20090819-164-1033-1-2527,0,2009-08-19,754,事務用消耗品費,事務用品,0,2048,1259512
6674,0001-20090819-164-1033-1-2527,1,2009-08-19,191,仮払消費税等,事務用品,0,102,1259410
6677,0001-20090819-47-1030-1-2521,0,2009-08-19,740,車両費,駐車代,0,810,1258600
6678,0001-20090819-47-1030-1-2521,1,2009-08-19,191,仮払消費税等,駐車代,0,40,1258560
6681,0001-20090819-68-1031-1-2523,0,2009-08-19,791,雑費,お茶代,0,2343,1256217
6682,0001-20090819-68-1031-1-2523,1,2009-08-19,191,仮払消費税等,お茶代,0,117,1256100
6685,0001-20090819-84-1032-1-2525,0,2009-08-19,727,通信費,切手代,0,7620,1248480
6686,0001-20090819-84-1032-1-2525,1,2009-08-19,191,仮払消費税等,切手代,0,380,1248100
6690,0001-20090820-100-1047-1-2555,1,2009-08-20,152,売掛金,09年8月20日伝票No287株式会社　斉藤,385324,0,1633424
6716,0001-20090820-104-1051-1-2563,0,2009-08-20,733,交際接待費,コーヒー代2名,0,1200,1632224
6717,0001-20090820-104-1051-1-2563,1,2009-08-20,191,仮払消費税等,コーヒー代2名,0,60,1632164
6758,0001-20090820-161-1058-1-2577,0,2009-08-20,726,旅費交通費,旅費,0,8020,1624144
6759,0001-20090820-161-1058-1-2577,1,2009-08-20,191,仮払消費税等,旅費,0,400,1623744
6782,0001-20090820-53-1036-1-2533,0,2009-08-20,740,車両費,ガソリン代,0,9879,1613865
6783,0001-20090820-53-1036-1-2533,1,2009-08-20,191,仮払消費税等,ガソリン代,0,493,1613372
6816,0001-20090820-79-1042-1-2545,0,2009-08-20,726,旅費交通費,旅費,0,11429,1601943
6817,0001-20090820-79-1042-1-2545,1,2009-08-20,191,仮払消費税等,旅費,0,571,1601372
6843,0001-20090821-126-1065-1-2591,1,2009-08-21,738,租税公課,収入印紙,0,40000,1561372
6845,0001-20090821-155-1066-1-2593,0,2009-08-21,740,車両費,ガソリン代,0,6720,1554652
6846,0001-20090821-155-1066-1-2593,1,2009-08-21,191,仮払消費税等,ガソリン代,0,335,1554317
6849,0001-20090821-160-1067-1-2595,0,2009-08-21,726,旅費交通費,出張旅費,0,66667,1487650
6850,0001-20090821-160-1067-1-2595,1,2009-08-21,191,仮払消費税等,出張旅費,0,3333,1484317
6853,0001-20090821-25-1062-1-2585,0,2009-08-21,726,旅費交通費,旅費,0,53334,1430983
6854,0001-20090821-25-1062-1-2585,1,2009-08-21,191,仮払消費税等,旅費,0,2666,1428317
6862,0001-20090821-45-1064-1-2589,1,2009-08-21,733,交際接待費,香典代,0,10000,1418317
6870,0001-20090821-6-1061-1-2583,0,2009-08-21,732,広告宣伝費,広告料,0,4762,1413555
6871,0001-20090821-6-1061-1-2583,1,2009-08-21,191,仮払消費税等,広告料,0,238,1413317
6874,0001-20090822-107-1073-1-2607,0,2009-08-22,733,交際接待費,お見舞い,0,9524,1403793
6875,0001-20090822-107-1073-1-2607,1,2009-08-22,191,仮払消費税等,お見舞い,0,476,1403317
6883,0001-20090822-163-1075-1-2611,1,2009-08-22,742,諸会費,会費,0,18000,1385317
6885,0001-20090822-166-1076-1-2613,0,2009-08-22,791,雑費,ダスキン代,0,1800,1383517
6886,0001-20090822-166-1076-1-2613,1,2009-08-22,191,仮払消費税等,ダスキン代,0,90,1383427
6889,0001-20090822-24-1068-1-2597,0,2009-08-22,726,旅費交通費,JR回数券,0,78686,1304741
6890,0001-20090822-24-1068-1-2597,1,2009-08-22,191,仮払消費税等,JR回数券,0,3934,1300807
6893,0001-20090822-48-1069-1-2599,0,2009-08-22,740,車両費,ガソリン代,0,4874,1295933
6894,0001-20090822-48-1069-1-2599,1,2009-08-22,191,仮払消費税等,ガソリン代,0,243,1295690
6897,0001-20090822-69-1070-1-2601,0,2009-08-22,791,雑費,のし袋,0,300,1295390
6898,0001-20090822-69-1070-1-2601,1,2009-08-22,191,仮払消費税等,のし袋,0,15,1295375
6900,0001-20090822-69-1070-1-2601,3,2009-08-22,791,雑費,電池,0,740,1294635
6901,0001-20090822-69-1070-1-2601,4,2009-08-22,191,仮払消費税等,電池,0,37,1294598
6903,0001-20090822-90-1071-1-2603,0,2009-08-22,791,雑費,ダスキン代,0,10000,1284598
6904,0001-20090822-90-1071-1-2603,1,2009-08-22,191,仮払消費税等,ダスキン代,0,500,1284098
6911,0001-20090823-140-1079-1-2619,0,2009-08-23,726,旅費交通費,旅費,0,6143,1277955
6912,0001-20090823-140-1079-1-2619,1,2009-08-23,191,仮払消費税等,旅費,0,307,1277648
6925,0001-20090824-105-1083-1-2627,0,2009-08-24,733,交際接待費,飲食代　居酒屋梅田小路,0,12124,1265524
6926,0001-20090824-105-1083-1-2627,1,2009-08-24,191,仮払消費税等,飲食代　居酒屋梅田小路,0,606,1264918
6928,0001-20090824-105-1083-1-2627,3,2009-08-24,733,交際接待費,飲食代　スナック北新地,0,18734,1246184
6929,0001-20090824-105-1083-1-2627,4,2009-08-24,191,仮払消費税等,飲食代　スナック北新地,0,936,1245248
6939,0001-20090824-8-1080-1-2621,0,2009-08-24,733,交際接待費,定例ミーティング会費,0,19048,1226200
6940,0001-20090824-8-1080-1-2621,1,2009-08-24,191,仮払消費税等,定例ミーティング会費,0,952,1225248
6942,0001-20090824-8-1080-1-2621,3,2009-08-24,733,交際接待費,飲食代　スナック今日子6名,0,31048,1194200
6943,0001-20090824-8-1080-1-2621,4,2009-08-24,191,仮払消費税等,飲食代　スナック今日子6名,0,1552,1192648
7091,0001-20090825-114-1097-1-2655,0,2009-08-25,739,新聞図書費,新聞代,0,2540,1190108
7092,0001-20090825-114-1097-1-2655,1,2009-08-25,191,仮払消費税等,新聞代,0,126,1189982
7094,0001-20090825-114-1097-1-2655,3,2009-08-25,739,新聞図書費,新聞代,0,2864,1187118
7095,0001-20090825-114-1097-1-2655,4,2009-08-25,191,仮払消費税等,新聞代,0,143,1186975
7097,0001-20090825-15-1085-1-2631,0,2009-08-25,740,車両費,洗車代,0,2858,1184117
7098,0001-20090825-15-1085-1-2631,1,2009-08-25,191,仮払消費税等,洗車代,0,142,1183975
7107,0001-20090825-26-1086-1-2633,0,2009-08-25,726,旅費交通費,旅費,0,15220,1168755
7108,0001-20090825-26-1086-1-2633,1,2009-08-25,191,仮払消費税等,旅費,0,760,1167995
7121,0001-20090825-72-1089-1-2639,0,2009-08-25,739,新聞図書費,新聞代,0,2864,1165131
7122,0001-20090825-72-1089-1-2639,1,2009-08-25,191,仮払消費税等,新聞代,0,143,1164988
7124,0001-20090825-72-1089-1-2639,3,2009-08-25,739,新聞図書費,新聞代,0,2815,1162173
7125,0001-20090825-72-1089-1-2639,4,2009-08-25,191,仮払消費税等,新聞代,0,140,1162033
7126,0001-20090825-72-1089-1-2639,5,2009-08-25,739,新聞図書費,新聞代,0,3399,1158634
7127,0001-20090825-72-1089-1-2639,6,2009-08-25,191,仮払消費税等,新聞代,0,169,1158465
7129,0001-20090825-80-1090-1-2641,0,2009-08-25,726,旅費交通費,タクシー代,0,9334,1149131
7130,0001-20090825-80-1090-1-2641,1,2009-08-25,191,仮払消費税等,タクシー代,0,466,1148665
7150,0001-20090826-138-1103-1-2667,0,2009-08-26,740,車両費,高速代,0,5381,1143284
7151,0001-20090826-138-1103-1-2667,1,2009-08-26,191,仮払消費税等,高速代,0,269,1143015
7153,0001-20090826-138-1103-1-2667,3,2009-08-26,740,車両費,高速代,0,3858,1139157
7154,0001-20090826-138-1103-1-2667,4,2009-08-26,191,仮払消費税等,高速代,0,192,1138965
7155,0001-20090826-138-1103-1-2667,5,2009-08-26,740,車両費,ガソリン代,0,6381,1132584
7156,0001-20090826-138-1103-1-2667,6,2009-08-26,191,仮払消費税等,ガソリン代,0,319,1132265
7157,0001-20090826-138-1103-1-2667,7,2009-08-26,740,車両費,駐車代,0,3400,1128865
7158,0001-20090826-138-1103-1-2667,8,2009-08-26,191,仮払消費税等,駐車代,0,170,1128695
7168,0001-20090826-27-1099-1-2659,0,2009-08-26,726,旅費交通費,旅費,0,26648,1102047
7169,0001-20090826-27-1099-1-2659,1,2009-08-26,191,仮払消費税等,旅費,0,1332,1100715
7171,0001-20090826-27-1099-1-2659,3,2009-08-26,726,旅費交通費,旅費,0,34077,1066638
7172,0001-20090826-27-1099-1-2659,4,2009-08-26,191,仮払消費税等,旅費,0,1703,1064935
7173,0001-20090826-27-1099-1-2659,5,2009-08-26,726,旅費交通費,旅費,0,25591,1039344
7174,0001-20090826-27-1099-1-2659,6,2009-08-26,191,仮払消費税等,旅費,0,1279,1038065
7176,0001-20090826-60-1100-1-2661,0,2009-08-26,726,旅費交通費,旅費,0,8286,1029779
7177,0001-20090826-60-1100-1-2661,1,2009-08-26,191,仮払消費税等,旅費,0,414,1029365
7180,0001-20090827-13-1106-1-2673,0,2009-08-27,740,車両費,ガソリン代,0,7284,1022081
7181,0001-20090827-13-1106-1-2673,1,2009-08-27,191,仮払消費税等,ガソリン代,0,364,1021717
7184,0001-20090827-14-1107-1-2675,0,2009-08-27,740,車両費,ガソリン代,0,2858,1018859
7185,0001-20090827-14-1107-1-2675,1,2009-08-27,191,仮払消費税等,ガソリン代,0,142,1018717
7188,0001-20090827-170-1113-1-2687,0,2009-08-27,739,新聞図書費,新聞代,0,2864,1015853
7189,0001-20090827-170-1113-1-2687,1,2009-08-27,191,仮払消費税等,新聞代,0,143,1015710
7197,0001-20090827-35-1109-1-2679,0,2009-08-27,739,新聞図書費,新聞代,0,3739,1011971
7198,0001-20090827-35-1109-1-2679,1,2009-08-27,191,仮払消費税等,新聞代,0,186,1011785
7201,0001-20090827-39-1110-1-2681,0,2009-08-27,724,福利厚生費,会費,0,8572,1003213
7202,0001-20090827-39-1110-1-2681,1,2009-08-27,191,仮払消費税等,会費,0,428,1002785
7209,0001-20090827-88-1112-1-2685,0,2009-08-27,739,新聞図書費,新聞代,0,3399,999386
7210,0001-20090827-88-1112-1-2685,1,2009-08-27,191,仮払消費税等,新聞代,0,169,999217
7233,0001-20090828-54-1115-1-2691,0,2009-08-28,740,車両費,高速代,0,1715,997502
7234,0001-20090828-54-1115-1-2691,1,2009-08-28,191,仮払消費税等,高速代,0,85,997417
7236,0001-20090828-54-1115-1-2691,3,2009-08-28,740,車両費,駐車代,0,858,996559
7237,0001-20090828-54-1115-1-2691,4,2009-08-28,191,仮払消費税等,駐車代,0,42,996517
7239,0001-20090828-75-1116-1-2693,0,2009-08-28,733,交際接待費,飲食代　居酒屋チキンズ10名,0,38400,958117
7240,0001-20090828-75-1116-1-2693,1,2009-08-28,191,仮払消費税等,飲食代　居酒屋チキンズ10名,0,1920,956197
7248,0001-20090829-67-1119-1-2699,1,2009-08-29,742,諸会費,会費支払い,0,30000,926197
7250,0001-20090829-70-1120-1-2701,0,2009-08-29,733,交際接待費,ゴルフプレー代4名,0,40762,885435
7251,0001-20090829-70-1120-1-2701,1,2009-08-29,191,仮払消費税等,ゴルフプレー代4名,0,2038,883397
7254,0001-20090830-100-1127-1-2715,0,2009-08-30,724,福利厚生費,会費,0,5715,877682
7255,0001-20090830-100-1127-1-2715,1,2009-08-30,191,仮払消費税等,会費,0,285,877397
7263,0001-20090830-121-1129-1-2719,0,2009-08-30,724,福利厚生費,お茶代,0,11429,865968
7264,0001-20090830-121-1129-1-2719,1,2009-08-30,191,仮払消費税等,お茶代,0,571,865397
7281,0001-20090830-49-1121-1-2703,0,2009-08-30,740,車両費,ガソリン代,0,162269,703128
7282,0001-20090830-49-1121-1-2703,1,2009-08-30,191,仮払消費税等,ガソリン代,0,8113,695015
7284,0001-20090830-49-1121-1-2703,3,2009-08-30,740,車両費,車両管理費,0,23364,671651
7285,0001-20090830-49-1121-1-2703,4,2009-08-30,191,仮払消費税等,車両管理費,0,1168,670483
7293,0001-20090830-70-1122-1-2705,5,2009-08-30,740,車両費,高速代,0,53810,616673
7294,0001-20090830-70-1122-1-2705,6,2009-08-30,191,仮払消費税等,高速代,0,2690,613983
7300,0001-20090830-76-1123-1-2707,0,2009-08-30,740,車両費,ガソリン代,0,5623,608360
7301,0001-20090830-76-1123-1-2707,1,2009-08-30,191,仮払消費税等,ガソリン代,0,281,608079
7303,0001-20090830-76-1123-1-2707,3,2009-08-30,740,車両費,タイヤ代　175/60-14　4本,0,42286,565793
7304,0001-20090830-76-1123-1-2707,4,2009-08-30,191,仮払消費税等,タイヤ代　175/60-14　4本,0,2114,563679
7305,0001-20090830-76-1123-1-2707,5,2009-08-30,740,車両費,タイヤ交換代,0,1200,562479
7306,0001-20090830-76-1123-1-2707,6,2009-08-30,191,仮払消費税等,タイヤ交換代,0,60,562419
7326,0001-20090831-108-1142-1-2745,0,2009-08-31,733,交際接待費,コーヒー代2名,0,1296,561123
7327,0001-20090831-108-1142-1-2745,1,2009-08-31,191,仮払消費税等,コーヒー代2名,0,64,561059
7466,0001-20090831-120-1153-1-2767,1,2009-08-31,152,売掛金,09年8月31日伝票No454合同会社　エイム商事,740835,0,1301894
7668,0001-20090831-83-1140-1-2741,0,2009-08-31,740,車両費,車両管理費,0,40477,1261417
7669,0001-20090831-83-1140-1-2741,1,2009-08-31,191,仮払消費税等,車両管理費,0,2023,1259394
7676,0001-20090831-94-1141-1-2743,0,2009-08-31,791,雑費,お茶代他,0,4905,1254489
7677,0001-20090831-94-1141-1-2743,1,2009-08-31,191,仮払消費税等,お茶代他,0,245,1254244
,,,2009-08,,※※月計※※,,2626159,2595726,
7680,0001-20090901-56-1174-1-2809,0,2009-09-01,726,旅費交通費,旅費,0,29505,1224739
7681,0001-20090901-56-1174-1-2809,1,2009-09-01,191,仮払消費税等,旅費,0,1475,1223264
7684,0001-20090901-84-1175-1-2811,0,2009-09-01,726,旅費交通費,ＪＲ代,0,4953,1218311
7685,0001-20090901-84-1175-1-2811,1,2009-09-01,191,仮払消費税等,ＪＲ代,0,247,1218064
7688,0001-20090902-150-1181-1-2823,0,2009-09-02,733,交際接待費,食事代　長崎港屋2名,0,4143,1213921
7689,0001-20090902-150-1181-1-2823,1,2009-09-02,191,仮払消費税等,食事代　長崎港屋2名,0,207,1213714
7692,0001-20090902-151-1182-1-2825,0,2009-09-02,733,交際接待費,食事代　トルテーヤ2名,0,7315,1206399
7693,0001-20090902-151-1182-1-2825,1,2009-09-02,191,仮払消費税等,食事代　トルテーヤ2名,0,365,1206034
7695,0001-20090902-151-1182-1-2825,3,2009-09-02,733,交際接待費,食事代　和風ダイニング法善寺3名,0,13624,1192410
7696,0001-20090902-151-1182-1-2825,4,2009-09-02,191,仮払消費税等,食事代　和風ダイニング法善寺3名,0,681,1191729
7698,0001-20090902-159-1183-1-2827,0,2009-09-02,726,旅費交通費,タクシー代,0,4429,1187300
7699,0001-20090902-159-1183-1-2827,1,2009-09-02,191,仮払消費税等,タクシー代,0,221,1187079
7702,0001-20090902-164-1184-1-2829,0,2009-09-02,754,事務用消耗品費,事務用品,0,2958,1184121
7703,0001-20090902-164-1184-1-2829,1,2009-09-02,191,仮払消費税等,事務用品,0,147,1183974
7706,0001-20090902-19-1176-1-2813,0,2009-09-02,726,旅費交通費,旅費,0,16067,1167907
7707,0001-20090902-19-1176-1-2813,1,2009-09-02,191,仮払消費税等,旅費,0,803,1167104
7710,0001-20090902-57-1177-1-2815,0,2009-09-02,726,旅費交通費,JR代,0,84648,1082456
7711,0001-20090902-57-1177-1-2815,1,2009-09-02,191,仮払消費税等,JR代,0,4232,1078224
7714,0001-20090902-70-1178-1-2817,0,2009-09-02,791,雑費,お茶代,0,1076,1077148
7715,0001-20090902-70-1178-1-2817,1,2009-09-02,191,仮払消費税等,お茶代,0,53,1077095
7722,0001-20090902-94-1180-1-2821,0,2009-09-02,791,雑費,洗剤他,0,758,1076337
7723,0001-20090902-94-1180-1-2821,1,2009-09-02,191,仮払消費税等,洗剤他,0,37,1076300
7726,0001-20090903-134-1188-1-2837,0,2009-09-03,754,事務用消耗品費,用紙,0,13048,1063252
7727,0001-20090903-134-1188-1-2837,1,2009-09-03,191,仮払消費税等,用紙,0,652,1062600
7730,0001-20090903-18-1185-1-2831,0,2009-09-03,726,旅費交通費,旅費,0,15981,1046619
7731,0001-20090903-18-1185-1-2831,1,2009-09-03,191,仮払消費税等,旅費,0,799,1045820
7734,0001-20090903-50-1186-1-2833,0,2009-09-03,740,車両費,駐車代,0,572,1045248
7735,0001-20090903-50-1186-1-2833,1,2009-09-03,191,仮払消費税等,駐車代,0,28,1045220
7738,0001-20090903-69-1187-1-2835,0,2009-09-03,791,雑費,ティッシュ代,0,1146,1044074
7739,0001-20090903-69-1187-1-2835,1,2009-09-03,191,仮払消費税等,ティッシュ代,0,57,1044017
7746,0001-20090904-16-1189-1-2839,0,2009-09-04,740,車両費,駐車代,0,530,1043487
7747,0001-20090904-16-1189-1-2839,1,2009-09-04,191,仮払消費税等,駐車代,0,26,1043461
7749,0001-20090904-16-1189-1-2839,3,2009-09-04,740,車両費,ガソリン代,0,5951,1037510
7750,0001-20090904-16-1189-1-2839,4,2009-09-04,191,仮払消費税等,ガソリン代,0,297,1037213
7752,0001-20090905-142-1194-1-2849,0,2009-09-05,740,車両費,ガソリン代,0,7290,1029923
7753,0001-20090905-142-1194-1-2849,1,2009-09-05,191,仮払消費税等,ガソリン代,0,364,1029559
7755,0001-20090905-142-1194-1-2849,3,2009-09-05,740,車両費,洗車代,0,1905,1027654
7756,0001-20090905-142-1194-1-2849,4,2009-09-05,191,仮払消費税等,洗車代,0,95,1027559
7757,0001-20090905-142-1194-1-2849,5,2009-09-05,740,車両費,駐車代,0,3048,1024511
7758,0001-20090905-142-1194-1-2849,6,2009-09-05,191,仮払消費税等,駐車代,0,152,1024359
7781,0001-20090906-10-1195-1-2851,0,2009-09-06,740,車両費,ガソリン代,0,4023,1020336
7782,0001-20090906-10-1195-1-2851,1,2009-09-06,191,仮払消費税等,ガソリン代,0,201,1020135
7785,0001-20090906-110-1198-1-2857,0,2009-09-06,726,旅費交通費,タクシー代,0,2181,1017954
7786,0001-20090906-110-1198-1-2857,1,2009-09-06,191,仮払消費税等,タクシー代,0,109,1017845
7795,0001-20090906-42-1196-1-2853,0,2009-09-06,733,交際接待費,コーヒー代2名,0,1200,1016645
7796,0001-20090906-42-1196-1-2853,1,2009-09-06,191,仮払消費税等,コーヒー代2名,0,60,1016585
7799,0001-20090906-43-1197-1-2855,0,2009-09-06,733,交際接待費,食事代　トン吉2名,0,3924,1012661
7800,0001-20090906-43-1197-1-2855,1,2009-09-06,191,仮払消費税等,食事代　トン吉2名,0,196,1012465
7803,0001-20090907-21-1200-1-2861,0,2009-09-07,726,旅費交通費,JR代,0,66191,946274
7804,0001-20090907-21-1200-1-2861,1,2009-09-07,191,仮払消費税等,JR代,0,3309,942965
7807,0001-20090907-22-1201-1-2863,0,2009-09-07,726,旅費交通費,旅費,0,47620,895345
7808,0001-20090907-22-1201-1-2863,1,2009-09-07,191,仮払消費税等,旅費,0,2380,892965
7811,0001-20090908-9-1202-1-2865,0,2009-09-08,733,交際接待費,コーヒー代2名,0,1334,891631
7812,0001-20090908-9-1202-1-2865,1,2009-09-08,191,仮払消費税等,コーヒー代2名,0,66,891565
7815,0001-20090909-148-1204-1-2869,0,2009-09-09,740,車両費,ガソリン代,0,6865,884700
7816,0001-20090909-148-1204-1-2869,1,2009-09-09,191,仮払消費税等,ガソリン代,0,343,884357
7818,0001-20090909-148-1204-1-2869,3,2009-09-09,740,車両費,高速代,0,2286,882071
7819,0001-20090909-148-1204-1-2869,4,2009-09-09,191,仮払消費税等,高速代,0,114,881957
7821,0001-20090909-20-1203-1-2867,0,2009-09-09,726,旅費交通費,旅費,0,37115,844842
7822,0001-20090909-20-1203-1-2867,1,2009-09-09,191,仮払消費税等,旅費,0,1855,842987
7826,0001-20090910-103-1217-1-2895,1,2009-09-10,733,交際接待費,お見舞代,0,10000,832987
7833,0001-20090910-143-1219-1-2899,0,2009-09-10,740,車両費,点検作業料,0,20953,812034
7834,0001-20090910-143-1219-1-2899,1,2009-09-10,191,仮払消費税等,点検作業料,0,1047,810987
7837,0001-20090910-162-1220-1-2901,0,2009-09-10,734,会議費,会議　食事代,0,23805,787182
7838,0001-20090910-162-1220-1-2901,1,2009-09-10,191,仮払消費税等,会議　食事代,0,1190,785992
7847,0001-20090910-44-1205-1-2871,0,2009-09-10,733,交際接待費,手土産代　五越百貨店,0,2420,783572
7848,0001-20090910-44-1205-1-2871,1,2009-09-10,191,仮払消費税等,手土産代　五越百貨店,0,120,783452
7867,0001-20090910-73-1208-1-2877,0,2009-09-10,733,交際接待費,ゴルフプレー代,0,17715,765737
7868,0001-20090910-73-1208-1-2877,1,2009-09-10,191,仮払消費税等,ゴルフプレー代,0,885,764852
7871,0001-20090910-81-1209-1-2879,0,2009-09-10,740,車両費,ガソリン代,0,4931,759921
7872,0001-20090910-81-1209-1-2879,1,2009-09-10,191,仮払消費税等,ガソリン代,0,246,759675
7874,0001-20090910-81-1209-1-2879,3,2009-09-10,740,車両費,駐車代,0,572,759103
7875,0001-20090910-81-1209-1-2879,4,2009-09-10,191,仮払消費税等,駐車代,0,28,759075
7882,0001-20090910-85-1210-1-2881,3,2009-09-10,726,旅費交通費,ＪＲ代,0,5715,753360
7883,0001-20090910-85-1210-1-2881,4,2009-09-10,191,仮払消費税等,ＪＲ代,0,285,753075
7928,0001-20090911-156-1230-1-2921,0,2009-09-11,726,旅費交通費,出張旅費,0,6667,746408
7929,0001-20090911-156-1230-1-2921,1,2009-09-11,191,仮払消費税等,出張旅費,0,333,746075
7932,0001-20090911-161-1231-1-2923,0,2009-09-11,726,旅費交通費,旅費,0,4096,741979
7933,0001-20090911-161-1231-1-2923,1,2009-09-11,191,仮払消費税等,旅費,0,204,741775
7947,0001-20090911-23-1222-1-2905,0,2009-09-11,726,旅費交通費,旅費,0,28448,713327
7948,0001-20090911-23-1222-1-2905,1,2009-09-11,191,仮払消費税等,旅費,0,1422,711905
7950,0001-20090911-23-1222-1-2905,3,2009-09-11,726,旅費交通費,旅費,0,33181,678724
7951,0001-20090911-23-1222-1-2905,4,2009-09-11,191,仮払消費税等,旅費,0,1659,677065
7952,0001-20090911-23-1222-1-2905,5,2009-09-11,726,旅費交通費,旅費,0,39811,637254
7953,0001-20090911-23-1222-1-2905,6,2009-09-11,191,仮払消費税等,旅費,0,1990,635264
7966,0001-20090911-45-1224-1-2909,0,2009-09-11,733,交際接待費,飲食代　居酒屋富士4名,0,16534,618730
7967,0001-20090911-45-1224-1-2909,1,2009-09-11,191,仮払消費税等,飲食代　居酒屋富士4名,0,826,617904
7970,0001-20090911-58-1225-1-2911,0,2009-09-11,726,旅費交通費,旅費,0,85905,531999
7971,0001-20090911-58-1225-1-2911,1,2009-09-11,191,仮払消費税等,旅費,0,4295,527704
7986,0001-20090912-104-1236-1-2933,0,2009-09-12,733,交際接待費,コーヒー代3名,0,1800,525904
7987,0001-20090912-104-1236-1-2933,1,2009-09-12,191,仮払消費税等,コーヒー代3名,0,90,525814
7990,0001-20090912-11-1233-1-2927,0,2009-09-12,740,車両費,ガソリン代,0,3058,522756
7991,0001-20090912-11-1233-1-2927,1,2009-09-12,191,仮払消費税等,ガソリン代,0,152,522604
7994,0001-20090912-149-1237-1-2935,0,2009-09-12,733,交際接待費,コーヒー代3名,0,1800,520804
7995,0001-20090912-149-1237-1-2935,1,2009-09-12,191,仮払消費税等,コーヒー代3名,0,90,520714
7999,0001-20090912-59-1234-1-2929,1,2009-09-12,121,当座預金,引き出し,1000000,0,1520714
8003,0001-20090912-73-1235-1-2931,0,2009-09-12,733,交際接待費,コーヒー代3名,0,1500,1519214
8004,0001-20090912-73-1235-1-2931,1,2009-09-12,191,仮払消費税等,コーヒー代3名,0,75,1519139
8007,0001-20090913-152-1240-1-2941,0,2009-09-13,733,交際接待費,コーヒー代3名,0,1800,1517339
8008,0001-20090913-152-1240-1-2941,1,2009-09-13,191,仮払消費税等,コーヒー代3名,0,90,1517249
8017,0001-20090913-165-1242-1-2945,0,2009-09-13,791,雑費,台所用品他,0,1249,1516000
8018,0001-20090913-165-1242-1-2945,1,2009-09-13,191,仮払消費税等,台所用品他,0,62,1515938
8021,0001-20090913-17-1238-1-2937,0,2009-09-13,740,車両費,駐車代,0,351,1515587
8022,0001-20090913-17-1238-1-2937,1,2009-09-13,191,仮払消費税等,駐車代,0,17,1515570
8025,0001-20090913-75-1239-1-2939,0,2009-09-13,733,交際接待費,ゴルフプレー代,0,7000,1508570
8026,0001-20090913-75-1239-1-2939,1,2009-09-13,191,仮払消費税等,ゴルフプレー代,0,350,1508220
8029,0001-20090914-105-1245-1-2951,0,2009-09-14,733,交際接待費,飲食代　和食ダイニング小笹3名,0,17858,1490362
8030,0001-20090914-105-1245-1-2951,1,2009-09-14,191,仮払消費税等,飲食代　和食ダイニング小笹3名,0,892,1489470
8033,0001-20090914-51-1243-1-2947,0,2009-09-14,740,車両費,高速代,0,3124,1486346
8034,0001-20090914-51-1243-1-2947,1,2009-09-14,191,仮払消費税等,高速代,0,156,1486190
8036,0001-20090914-51-1243-1-2947,3,2009-09-14,740,車両費,駐車代,0,2620,1483570
8037,0001-20090914-51-1243-1-2947,4,2009-09-14,191,仮払消費税等,駐車代,0,130,1483440
8096,0001-20090915-117-1255-1-2971,1,2009-09-15,742,諸会費,会費,0,20000,1463440
8103,0001-20090915-88-1247-1-2955,1,2009-09-15,721,雑給,9月給与その他 0060 パート･アルバイト,0,349816,1113624
8116,0001-20090916-136-1259-1-2979,0,2009-09-16,791,雑費,ダスキン代,0,15715,1097909
8117,0001-20090916-136-1259-1-2979,1,2009-09-16,191,仮払消費税等,ダスキン代,0,785,1097124
8120,0001-20090916-74-1256-1-2973,0,2009-09-16,733,交際接待費,ゴルフプレー代,0,10477,1086647
8121,0001-20090916-74-1256-1-2973,1,2009-09-16,191,仮払消費税等,ゴルフプレー代,0,523,1086124
8124,0001-20090916-86-1257-1-2975,0,2009-09-16,726,旅費交通費,タクシー代,0,7239,1078885
8125,0001-20090916-86-1257-1-2975,1,2009-09-16,191,仮払消費税等,タクシー代,0,361,1078524
8128,0001-20090917-12-1261-1-2983,0,2009-09-17,740,車両費,ガソリン代,0,7113,1071411
8129,0001-20090917-12-1261-1-2983,1,2009-09-17,191,仮払消費税等,ガソリン代,0,355,1071056
8131,0001-20090917-12-1261-1-2983,3,2009-09-17,740,車両費,ガソリン代,0,4015,1067041
8132,0001-20090917-12-1261-1-2983,4,2009-09-17,191,仮払消費税等,ガソリン代,0,200,1066841
8138,0001-20090917-52-1262-1-2985,0,2009-09-17,740,車両費,高速代,0,1096,1065745
8139,0001-20090917-52-1262-1-2985,1,2009-09-17,191,仮払消費税等,高速代,0,54,1065691
8141,0001-20090917-52-1262-1-2985,3,2009-09-17,740,車両費,駐車代,0,762,1064929
8142,0001-20090917-52-1262-1-2985,4,2009-09-17,191,仮払消費税等,駐車代,0,38,1064891
8143,0001-20090917-52-1262-1-2985,5,2009-09-17,740,車両費,ガソリン代,0,5477,1059414
8144,0001-20090917-52-1262-1-2985,6,2009-09-17,191,仮払消費税等,ガソリン代,0,273,1059141
8146,0001-20090918-24-1263-1-2987,0,2009-09-18,726,旅費交通費,JR回数券,0,78686,980455
8147,0001-20090918-24-1263-1-2987,1,2009-09-18,191,仮払消費税等,JR回数券,0,3934,976521
8150,0001-20090918-74-1264-1-2989,0,2009-09-18,733,交際接待費,手土産代　今井百貨店,0,6000,970521
8151,0001-20090918-74-1264-1-2989,1,2009-09-18,191,仮払消費税等,手土産代　今井百貨店,0,300,970221
8154,0001-20090918-79-1265-1-2991,0,2009-09-18,724,福利厚生費,景品代,0,37976,932245
8155,0001-20090918-79-1265-1-2991,1,2009-09-18,191,仮払消費税等,景品代,0,1898,930347
8158,0001-20090919-47-1266-1-2993,0,2009-09-19,740,車両費,ガソリン代,0,3448,926899
8159,0001-20090919-47-1266-1-2993,1,2009-09-19,191,仮払消費税等,ガソリン代,0,172,926727
8162,0001-20090919-82-1267-1-2995,0,2009-09-19,740,車両費,ガソリン代,0,4602,922125
8163,0001-20090919-82-1267-1-2995,1,2009-09-19,191,仮払消費税等,ガソリン代,0,230,921895
8165,0001-20090919-82-1267-1-2995,3,2009-09-19,740,車両費,駐車代,0,381,921514
8166,0001-20090919-82-1267-1-2995,4,2009-09-19,191,仮払消費税等,駐車代,0,19,921495
8178,0001-20090920-107-1280-1-3021,1,2009-09-20,152,売掛金,09年9月20日伝票No310株式会社　斉藤,727257,0,1648752
8225,0001-20090920-138-1288-1-3037,0,2009-09-20,740,車両費,高速代,0,3410,1645342
8226,0001-20090920-138-1288-1-3037,1,2009-09-20,191,仮払消費税等,高速代,0,170,1645172
8228,0001-20090920-138-1288-1-3037,3,2009-09-20,740,車両費,高速代,0,2524,1642648
8229,0001-20090920-138-1288-1-3037,4,2009-09-20,191,仮払消費税等,高速代,0,126,1642522
8230,0001-20090920-138-1288-1-3037,5,2009-09-20,740,車両費,高速代,0,3667,1638855
8231,0001-20090920-138-1288-1-3037,6,2009-09-20,191,仮払消費税等,高速代,0,183,1638672
8232,0001-20090920-138-1288-1-3037,7,2009-09-20,740,車両費,洗車代,0,1905,1636767
8233,0001-20090920-138-1288-1-3037,8,2009-09-20,191,仮払消費税等,洗車代,0,95,1636672
8234,0001-20090920-138-1288-1-3037,9,2009-09-20,740,車両費,ガソリン代,0,8560,1628112
8235,0001-20090920-138-1288-1-3037,10,2009-09-20,191,仮払消費税等,ガソリン代,0,427,1627685
8236,0001-20090920-138-1288-1-3037,11,2009-09-20,740,車両費,ウォッシャー液代,0,572,1627113
8237,0001-20090920-138-1288-1-3037,12,2009-09-20,191,仮払消費税等,ウォッシャー液代,0,28,1627085
8238,0001-20090920-138-1288-1-3037,13,2009-09-20,740,車両費,高速代,0,4291,1622794
8239,0001-20090920-138-1288-1-3037,14,2009-09-20,191,仮払消費税等,高速代,0,214,1622580
8241,0001-20090920-141-1289-1-3039,0,2009-09-20,726,旅費交通費,JR代,0,8096,1614484
8242,0001-20090920-141-1289-1-3039,1,2009-09-20,191,仮払消費税等,JR代,0,404,1614080
8246,0001-20090920-163-1290-1-3041,1,2009-09-20,742,諸会費,会費,0,18000,1596080
8252,0001-20090920-48-1270-1-3001,0,2009-09-20,740,車両費,ガソリン代,0,4099,1591981
8253,0001-20090920-48-1270-1-3001,1,2009-09-20,191,仮払消費税等,ガソリン代,0,204,1591777
8256,0001-20090920-53-1271-1-3003,0,2009-09-20,740,車両費,ガソリン代,0,2381,1589396
8257,0001-20090920-53-1271-1-3003,1,2009-09-20,191,仮払消費税等,ガソリン代,0,119,1589277
8259,0001-20090920-53-1271-1-3003,3,2009-09-20,740,車両費,高速代,0,1191,1588086
8260,0001-20090920-53-1271-1-3003,4,2009-09-20,191,仮払消費税等,高速代,0,59,1588027
8262,0001-20090920-6-1268-1-2997,0,2009-09-20,732,広告宣伝費,広告料,0,4762,1583265
8263,0001-20090920-6-1268-1-2997,1,2009-09-20,191,仮払消費税等,広告料,0,238,1583027
8308,0001-20090921-160-1296-1-3053,0,2009-09-21,726,旅費交通費,出張旅費,0,66667,1516360
8309,0001-20090921-160-1296-1-3053,1,2009-09-21,191,仮払消費税等,出張旅費,0,3333,1513027
8346,0001-20090922-107-1304-1-3069,0,2009-09-22,733,交際接待費,お見舞い,0,9524,1503503
8347,0001-20090922-107-1304-1-3069,1,2009-09-22,191,仮払消費税等,お見舞い,0,476,1503027
8350,0001-20090922-153-1305-1-3071,0,2009-09-22,733,交際接待費,コーヒー代2名,0,1200,1501827
8351,0001-20090922-153-1305-1-3071,1,2009-09-22,191,仮払消費税等,コーヒー代2名,0,60,1501767
8354,0001-20090922-166-1306-1-3073,0,2009-09-22,791,雑費,ダスキン代,0,1800,1499967
8355,0001-20090922-166-1306-1-3073,1,2009-09-22,191,仮払消費税等,ダスキン代,0,90,1499877
8366,0001-20090922-67-1300-1-3061,0,2009-09-22,791,雑費,ティッシュペーパー他,0,1506,1498371
8367,0001-20090922-67-1300-1-3061,1,2009-09-22,191,仮払消費税等,ティッシュペーパー他,0,75,1498296
8370,0001-20090922-75-1301-1-3063,0,2009-09-22,733,交際接待費,飲食代　スナックりりあん2名,0,9962,1488334
8371,0001-20090922-75-1301-1-3063,1,2009-09-22,191,仮払消費税等,飲食代　スナックりりあん2名,0,498,1487836
8374,0001-20090922-90-1302-1-3065,0,2009-09-22,791,雑費,ダスキン代,0,10000,1477836
8375,0001-20090922-90-1302-1-3065,1,2009-09-22,191,仮払消費税等,ダスキン代,0,500,1477336
8382,0001-20090923-140-1311-1-3083,0,2009-09-23,726,旅費交通費,旅費,0,22381,1454955
8383,0001-20090923-140-1311-1-3083,1,2009-09-23,191,仮払消費税等,旅費,0,1119,1453836
8386,0001-20090923-26-1308-1-3077,0,2009-09-23,726,旅費交通費,旅費,0,10477,1443359
8387,0001-20090923-26-1308-1-3077,1,2009-09-23,191,仮払消費税等,旅費,0,523,1442836
8398,0001-20090923-54-1310-1-3081,0,2009-09-23,740,車両費,高速代,0,4381,1438455
8399,0001-20090923-54-1310-1-3081,1,2009-09-23,191,仮払消費税等,高速代,0,219,1438236
8410,0001-20090924-144-1316-1-3093,0,2009-09-24,740,車両費,ガソリン代,0,6172,1432064
8411,0001-20090924-144-1316-1-3093,1,2009-09-24,191,仮払消費税等,ガソリン代,0,308,1431756
8413,0001-20090924-144-1316-1-3093,3,2009-09-24,740,車両費,高速代,0,8477,1423279
8414,0001-20090924-144-1316-1-3093,4,2009-09-24,191,仮払消費税等,高速代,0,423,1422856
8426,0001-20090924-71-1313-1-3087,0,2009-09-24,791,雑費,ティッシュ代他,0,918,1421938
8427,0001-20090924-71-1313-1-3087,1,2009-09-24,191,仮払消費税等,ティッシュ代他,0,45,1421893
8461,0001-20090925-121-1327-1-3115,0,2009-09-25,724,福利厚生費,お茶代,0,9048,1412845
8462,0001-20090925-121-1327-1-3115,1,2009-09-25,191,仮払消費税等,お茶代,0,452,1412393
8480,0001-20090925-35-1319-1-3099,0,2009-09-25,739,新聞図書費,新聞代,0,3739,1408654
8481,0001-20090925-35-1319-1-3099,1,2009-09-25,191,仮払消費税等,新聞代,0,186,1408468
8603,0001-20090926-155-1334-1-3129,0,2009-09-26,740,車両費,ガソリン代,0,6901,1401567
8604,0001-20090926-155-1334-1-3129,1,2009-09-26,191,仮払消費税等,ガソリン代,0,345,1401222
8607,0001-20090926-170-1335-1-3131,0,2009-09-26,739,新聞図書費,新聞代,0,2864,1398358
8608,0001-20090926-170-1335-1-3131,1,2009-09-26,191,仮払消費税等,新聞代,0,143,1398215
8611,0001-20090926-25-1331-1-3123,0,2009-09-26,726,旅費交通費,旅費,0,58299,1339916
8612,0001-20090926-25-1331-1-3123,1,2009-09-26,191,仮払消費税等,旅費,0,2914,1337002
8615,0001-20090926-72-1332-1-3125,0,2009-09-26,739,新聞図書費,新聞代,0,2864,1334138
8616,0001-20090926-72-1332-1-3125,1,2009-09-26,191,仮払消費税等,新聞代,0,143,1333995
8618,0001-20090926-72-1332-1-3125,3,2009-09-26,739,新聞図書費,新聞代,0,2815,1331180
8619,0001-20090926-72-1332-1-3125,4,2009-09-26,191,仮払消費税等,新聞代,0,140,1331040
8620,0001-20090926-72-1332-1-3125,5,2009-09-26,739,新聞図書費,新聞代,0,3399,1327641
8621,0001-20090926-72-1332-1-3125,6,2009-09-26,191,仮払消費税等,新聞代,0,169,1327472
8623,0001-20090926-8-1330-1-3121,0,2009-09-26,733,交際接待費,定例ミーティング会費,0,19048,1308424
8624,0001-20090926-8-1330-1-3121,1,2009-09-26,191,仮払消費税等,定例ミーティング会費,0,952,1307472
8639,0001-20090927-114-1343-1-3147,0,2009-09-27,739,新聞図書費,新聞代,0,2540,1304932
8640,0001-20090927-114-1343-1-3147,1,2009-09-27,191,仮払消費税等,新聞代,0,126,1304806
8642,0001-20090927-114-1343-1-3147,3,2009-09-27,739,新聞図書費,新聞代,0,2864,1301942
8643,0001-20090927-114-1343-1-3147,4,2009-09-27,191,仮払消費税等,新聞代,0,143,1301799
8645,0001-20090927-13-1336-1-3133,0,2009-09-27,740,車両費,修理代,0,89000,1212799
8646,0001-20090927-13-1336-1-3133,1,2009-09-27,191,仮払消費税等,修理代,0,4450,1208349
8649,0001-20090927-14-1337-1-3135,0,2009-09-27,740,車両費,ガソリン代,0,3810,1204539
8650,0001-20090927-14-1337-1-3135,1,2009-09-27,191,仮払消費税等,ガソリン代,0,190,1204349
8668,0001-20090927-39-1340-1-3141,0,2009-09-27,724,福利厚生費,会費,0,8572,1195777
8669,0001-20090927-39-1340-1-3141,1,2009-09-27,191,仮払消費税等,会費,0,428,1195349
8672,0001-20090927-60-1341-1-3143,0,2009-09-27,726,旅費交通費,旅費,0,20477,1174872
8673,0001-20090927-60-1341-1-3143,1,2009-09-27,191,仮払消費税等,旅費,0,1023,1173849
8676,0001-20090928-83-1345-1-3151,0,2009-09-28,740,車両費,車両管理費,0,46191,1127658
8677,0001-20090928-83-1345-1-3151,1,2009-09-28,191,仮払消費税等,車両管理費,0,2309,1125349
8680,0001-20090928-88-1346-1-3153,0,2009-09-28,739,新聞図書費,新聞代,0,3399,1121950
8681,0001-20090928-88-1346-1-3153,1,2009-09-28,191,仮払消費税等,新聞代,0,169,1121781
8688,0001-20090929-108-1350-1-3161,0,2009-09-29,733,交際接待費,食事代　レストラン梅田,0,5267,1116514
8689,0001-20090929-108-1350-1-3161,1,2009-09-29,191,仮払消費税等,食事代　レストラン梅田,0,263,1116251
8726,0001-20090929-83-1349-1-3159,0,2009-09-29,740,車両費,ガソリン代,0,4153,1112098
8727,0001-20090929-83-1349-1-3159,1,2009-09-29,191,仮払消費税等,ガソリン代,0,207,1111891
8734,0001-20090930-100-1370-1-3201,0,2009-09-30,724,福利厚生費,会費,0,5715,1106176
8735,0001-20090930-100-1370-1-3201,1,2009-09-30,191,仮払消費税等,会費,0,285,1105891
8874,0001-20090930-127-1382-1-3225,1,2009-09-30,152,売掛金,09年9月30日伝票No455合同会社　エイム商事,454018,0,1559909
8877,0001-20090930-128-1383-1-3227,1,2009-09-30,738,租税公課,収入印紙,0,2000,1557909
9024,0001-20090930-156-1403-1-3267,0,2009-09-30,726,旅費交通費,出張旅費,0,12858,1545051
9025,0001-20090930-156-1403-1-3267,1,2009-09-30,191,仮払消費税等,出張旅費,0,642,1544409
9028,0001-20090930-158-1404-1-3269,0,2009-09-30,726,旅費交通費,出張旅費,0,6572,1537837
9029,0001-20090930-158-1404-1-3269,1,2009-09-30,191,仮払消費税等,出張旅費,0,328,1537509
9032,0001-20090930-27-1355-1-3171,0,2009-09-30,726,旅費交通費,旅費,0,28362,1509147
9033,0001-20090930-27-1355-1-3171,1,2009-09-30,191,仮払消費税等,旅費,0,1418,1507729
9035,0001-20090930-27-1355-1-3171,3,2009-09-30,726,旅費交通費,旅費,0,27739,1479990
9036,0001-20090930-27-1355-1-3171,4,2009-09-30,191,仮払消費税等,旅費,0,1386,1478604
9037,0001-20090930-27-1355-1-3171,5,2009-09-30,726,旅費交通費,旅費,0,37972,1440632
9038,0001-20090930-27-1355-1-3171,6,2009-09-30,191,仮払消費税等,旅費,0,1898,1438734
9050,0001-20090930-49-1358-1-3177,0,2009-09-30,740,車両費,ガソリン代,0,127620,1311114
9051,0001-20090930-49-1358-1-3177,1,2009-09-30,191,仮払消費税等,ガソリン代,0,6380,1304734
9053,0001-20090930-49-1358-1-3177,3,2009-09-30,740,車両費,高速代,0,5729,1299005
9054,0001-20090930-49-1358-1-3177,4,2009-09-30,191,仮払消費税等,高速代,0,286,1298719
9068,0001-20090930-67-1360-1-3181,1,2009-09-30,742,諸会費,会費支払い,0,30000,1268719
9075,0001-20090930-70-1361-1-3183,5,2009-09-30,740,車両費,高速代,0,69824,1198895
9076,0001-20090930-70-1361-1-3183,6,2009-09-30,191,仮払消費税等,高速代,0,3491,1195404
9116,0001-20090930-87-1366-1-3193,0,2009-09-30,726,旅費交通費,旅費,0,28572,1166832
9117,0001-20090930-87-1366-1-3193,1,2009-09-30,191,仮払消費税等,旅費,0,1428,1165404
,,,2009-09,,※※月計※※,,2181275,2270115,
9141,0001-20091001-141-1408-1-3277,0,2009-10-01,726,旅費交通費,JR代,0,7429,1157975
9142,0001-20091001-141-1408-1-3277,1,2009-10-01,191,仮払消費税等,JR代,0,371,1157604
9145,0001-20091001-18-1405-1-3271,0,2009-10-01,726,旅費交通費,旅費,0,25591,1132013
9146,0001-20091001-18-1405-1-3271,1,2009-10-01,191,仮払消費税等,旅費,0,1279,1130734
9155,0001-20091002-142-1413-1-3287,0,2009-10-02,740,車両費,ガソリン代,0,6229,1124505
9156,0001-20091002-142-1413-1-3287,1,2009-10-02,191,仮払消費税等,ガソリン代,0,311,1124194
9158,0001-20091002-142-1413-1-3287,3,2009-10-02,740,車両費,高速代,0,4289,1119905
9159,0001-20091002-142-1413-1-3287,4,2009-10-02,191,仮払消費税等,高速代,0,214,1119691
9160,0001-20091002-142-1413-1-3287,5,2009-10-02,740,車両費,点検作業料,0,43433,1076258
9161,0001-20091002-142-1413-1-3287,6,2009-10-02,191,仮払消費税等,点検作業料,0,2171,1074087
9173,0001-20091002-50-1411-1-3283,0,2009-10-02,740,車両費,駐車代,0,1143,1072944
9174,0001-20091002-50-1411-1-3283,1,2009-10-02,191,仮払消費税等,駐車代,0,57,1072887
9177,0001-20091002-7-1409-1-3279,0,2009-10-02,733,交際接待費,飲食代　居酒屋太助2名,0,11791,1061096
9178,0001-20091002-7-1409-1-3279,1,2009-10-02,191,仮払消費税等,飲食代　居酒屋太助2名,0,589,1060507
9181,0001-20091002-75-1412-1-3285,0,2009-10-02,733,交際接待費,コーヒー代2名,0,1200,1059307
9182,0001-20091002-75-1412-1-3285,1,2009-10-02,191,仮払消費税等,コーヒー代2名,0,60,1059247
9185,0001-20091003-102-1417-1-3295,0,2009-10-03,733,交際接待費,手土産代　阿部商店,0,1000,1058247
9186,0001-20091003-102-1417-1-3295,1,2009-10-03,191,仮払消費税等,手土産代　阿部商店,0,50,1058197
9189,0001-20091003-158-1418-1-3297,0,2009-10-03,726,旅費交通費,出張旅費,0,12858,1045339
9190,0001-20091003-158-1418-1-3297,1,2009-10-03,191,仮払消費税等,出張旅費,0,642,1044697
9193,0001-20091003-56-1415-1-3291,0,2009-10-03,726,旅費交通費,旅費,0,34667,1010030
9194,0001-20091003-56-1415-1-3291,1,2009-10-03,191,仮払消費税等,旅費,0,1733,1008297
9197,0001-20091003-75-1416-1-3293,0,2009-10-03,726,旅費交通費,旅費,0,11429,996868
9198,0001-20091003-75-1416-1-3293,1,2009-10-03,191,仮払消費税等,旅費,0,571,996297
9205,0001-20091005-161-1425-1-3311,0,2009-10-05,726,旅費交通費,旅費,0,6048,990249
9206,0001-20091005-161-1425-1-3311,1,2009-10-05,191,仮払消費税等,旅費,0,302,989947
9209,0001-20091005-164-1426-1-3313,0,2009-10-05,754,事務用消耗品費,事務用品,0,2685,987262
9210,0001-20091005-164-1426-1-3313,1,2009-10-05,191,仮払消費税等,事務用品,0,134,987128
9213,0001-20091005-19-1419-1-3299,0,2009-10-05,726,旅費交通費,旅費,0,18067,969061
9214,0001-20091005-19-1419-1-3299,1,2009-10-05,191,仮払消費税等,旅費,0,903,968158
9242,0001-20091006-110-1428-1-3317,0,2009-10-06,726,旅費交通費,タクシー代,0,2181,965977
9243,0001-20091006-110-1428-1-3317,1,2009-10-06,191,仮払消費税等,タクシー代,0,109,965868
9246,0001-20091006-149-1429-1-3319,0,2009-10-06,733,交際接待費,食事代　レストランラルー3名,0,8905,956963
9247,0001-20091006-149-1429-1-3319,1,2009-10-06,191,仮払消費税等,食事代　レストランラルー3名,0,445,956518
9250,0001-20091006-150-1430-1-3321,0,2009-10-06,733,交際接待費,ゴルフプレー代3名,0,33762,922756
9251,0001-20091006-150-1430-1-3321,1,2009-10-06,191,仮払消費税等,ゴルフプレー代3名,0,1688,921068
9254,0001-20091006-152-1431-1-3323,0,2009-10-06,733,交際接待費,飲食代　スナックいちい,0,23477,897591
9255,0001-20091006-152-1431-1-3323,1,2009-10-06,191,仮払消費税等,飲食代　スナックいちい,0,1173,896418
9258,0001-20091006-42-1427-1-3315,0,2009-10-06,733,交際接待費,食事代　レストランライラック3名,0,6020,890398
9259,0001-20091006-42-1427-1-3315,1,2009-10-06,191,仮払消費税等,食事代　レストランライラック3名,0,300,890098
9268,0001-20091007-21-1432-1-3325,0,2009-10-07,726,旅費交通費,JR代,0,66191,823907
9269,0001-20091007-21-1432-1-3325,1,2009-10-07,191,仮払消費税等,JR代,0,3309,820598
9272,0001-20091007-22-1433-1-3327,0,2009-10-07,726,旅費交通費,旅費,0,47620,772978
9273,0001-20091007-22-1433-1-3327,1,2009-10-07,191,仮払消費税等,旅費,0,2380,770598
9277,0001-20091007-43-1434-1-3329,1,2009-10-07,733,交際接待費,香典代,0,10000,760598
9279,0001-20091007-58-1435-1-3331,0,2009-10-07,726,旅費交通費,旅費,0,66667,693931
9280,0001-20091007-58-1435-1-3331,1,2009-10-07,191,仮払消費税等,旅費,0,3333,690598
9283,0001-20091008-10-1437-1-3335,0,2009-10-08,740,車両費,駐車代,0,477,690121
9284,0001-20091008-10-1437-1-3335,1,2009-10-08,191,仮払消費税等,駐車代,0,23,690098
9287,0001-20091008-151-1440-1-3341,0,2009-10-08,733,交際接待費,食事代　ラーメンめん吉,0,1429,688669
9288,0001-20091008-151-1440-1-3341,1,2009-10-08,191,仮払消費税等,食事代　ラーメンめん吉,0,71,688598
9291,0001-20091008-16-1438-1-3337,0,2009-10-08,740,車両費,洗車代,0,2858,685740
9292,0001-20091008-16-1438-1-3337,1,2009-10-08,191,仮払消費税等,洗車代,0,142,685598
9294,0001-20091008-16-1438-1-3337,3,2009-10-08,740,車両費,ガソリン代,0,6000,679598
9295,0001-20091008-16-1438-1-3337,4,2009-10-08,191,仮払消費税等,ガソリン代,0,300,679298
9302,0001-20091009-20-1441-1-3343,0,2009-10-09,726,旅費交通費,旅費,0,39286,640012
9303,0001-20091009-20-1441-1-3343,1,2009-10-09,191,仮払消費税等,旅費,0,1964,638048
9306,0001-20091009-46-1442-1-3345,0,2009-10-09,740,車両費,ガソリン代,0,6172,631876
9307,0001-20091009-46-1442-1-3345,1,2009-10-09,191,仮払消費税等,ガソリン代,0,308,631568
9309,0001-20091009-46-1442-1-3345,3,2009-10-09,740,車両費,高速代,0,7143,624425
9310,0001-20091009-46-1442-1-3345,4,2009-10-09,191,仮払消費税等,高速代,0,357,624068
9311,0001-20091009-46-1442-1-3345,5,2009-10-09,740,車両費,駐車代,0,3334,620734
9312,0001-20091009-46-1442-1-3345,6,2009-10-09,191,仮払消費税等,駐車代,0,166,620568
9314,0001-20091010-103-1458-1-3377,0,2009-10-10,733,交際接待費,食事代　イタリアンレストランペンネ2名,0,4469,616099
9315,0001-20091010-103-1458-1-3377,1,2009-10-10,191,仮払消費税等,食事代　イタリアンレストランペンネ2名,0,223,615876
9335,0001-20091010-162-1462-1-3385,0,2009-10-10,734,会議費,会議　食事代,0,23805,592071
9336,0001-20091010-162-1462-1-3385,1,2009-10-10,191,仮払消費税等,会議　食事代,0,1190,590881
9367,0001-20091010-44-1444-1-3349,0,2009-10-10,733,交際接待費,昼食代　ホテルエンペラー2名,0,2724,588157
9368,0001-20091010-44-1444-1-3349,1,2009-10-10,191,仮払消費税等,昼食代　ホテルエンペラー2名,0,136,588021
9398,0001-20091010-74-1448-1-3357,0,2009-10-10,733,交際接待費,飲食代　居酒屋栗の木4名,0,15469,572552
9399,0001-20091010-74-1448-1-3357,1,2009-10-10,191,仮払消費税等,飲食代　居酒屋栗の木4名,0,773,571779
9402,0001-20091010-76-1449-1-3359,0,2009-10-10,726,旅費交通費,ＪＲ代,0,13810,557969
9403,0001-20091010-76-1449-1-3359,1,2009-10-10,191,仮払消費税等,ＪＲ代,0,690,557279
9448,0001-20091011-73-1465-1-3391,0,2009-10-11,740,車両費,ガソリン代,0,6325,550954
9449,0001-20091011-73-1465-1-3391,1,2009-10-11,191,仮払消費税等,ガソリン代,0,316,550638
9451,0001-20091011-73-1465-1-3391,3,2009-10-11,740,車両費,高速代,0,1143,549495
9452,0001-20091011-73-1465-1-3391,4,2009-10-11,191,仮払消費税等,高速代,0,57,549438
9454,0001-20091012-148-1467-1-3395,0,2009-10-12,740,車両費,ガソリン代,0,6729,542709
9455,0001-20091012-148-1467-1-3395,1,2009-10-12,191,仮払消費税等,ガソリン代,0,336,542373
9462,0001-20091012-57-1466-1-3393,0,2009-10-12,726,旅費交通費,JR代,0,106953,435420
9463,0001-20091012-57-1466-1-3393,1,2009-10-12,191,仮払消費税等,JR代,0,5347,430073
9466,0001-20091013-11-1469-1-3399,0,2009-10-13,740,車両費,ガソリン代,0,3058,427015
9467,0001-20091013-11-1469-1-3399,1,2009-10-13,191,仮払消費税等,ガソリン代,0,152,426863
9470,0001-20091013-51-1470-1-3401,0,2009-10-13,740,車両費,駐車代,0,3667,423196
9471,0001-20091013-51-1470-1-3401,1,2009-10-13,191,仮払消費税等,駐車代,0,183,423013
9473,0001-20091013-51-1470-1-3401,3,2009-10-13,740,車両費,高速代,0,5524,417489
9474,0001-20091013-51-1470-1-3401,4,2009-10-13,191,仮払消費税等,高速代,0,276,417213
9475,0001-20091013-51-1470-1-3401,5,2009-10-13,740,車両費,ガソリン代,0,4381,412832
9476,0001-20091013-51-1470-1-3401,6,2009-10-13,191,仮払消費税等,ガソリン代,0,219,412613
9478,0001-20091013-77-1471-1-3403,0,2009-10-13,726,旅費交通費,タクシー代,0,3810,408803
9479,0001-20091013-77-1471-1-3403,1,2009-10-13,191,仮払消費税等,タクシー代,0,190,408613
9482,0001-20091013-79-1472-1-3405,0,2009-10-13,724,福利厚生費,景品代,0,46420,362193
9483,0001-20091013-79-1472-1-3405,1,2009-10-13,191,仮払消費税等,景品代,0,2320,359873
9486,0001-20091014-159-1475-1-3411,0,2009-10-14,726,旅費交通費,タクシー代,0,8477,351396
9487,0001-20091014-159-1475-1-3411,1,2009-10-14,191,仮払消費税等,タクシー代,0,423,350973
9490,0001-20091014-23-1473-1-3407,0,2009-10-14,726,旅費交通費,旅費,0,26667,324306
9491,0001-20091014-23-1473-1-3407,1,2009-10-14,191,仮払消費税等,旅費,0,1333,322973
9493,0001-20091014-23-1473-1-3407,3,2009-10-14,726,旅費交通費,旅費,0,29524,293449
9494,0001-20091014-23-1473-1-3407,4,2009-10-14,191,仮払消費税等,旅費,0,1476,291973
9495,0001-20091014-23-1473-1-3407,5,2009-10-14,726,旅費交通費,旅費,0,36667,255306
9496,0001-20091014-23-1473-1-3407,6,2009-10-14,191,仮払消費税等,旅費,0,1833,253473
9498,0001-20091014-68-1474-1-3409,0,2009-10-14,791,雑費,トイレットペーパー他,0,700,252773
9499,0001-20091014-68-1474-1-3409,1,2009-10-14,191,仮払消費税等,トイレットペーパー他,0,35,252738
9503,0001-20091015-117-1486-1-3433,1,2009-10-15,742,諸会費,会費,0,20000,232738
9515,0001-20091015-60-1477-1-3415,1,2009-10-15,121,当座預金,引き出し,1500000,0,1732738
9520,0001-20091015-80-1478-1-3417,1,2009-10-15,721,雑給,10月給与その他 0060 パート･アルバイト,0,498874,1233864
9578,0001-20091016-136-1490-1-3441,0,2009-10-16,791,雑費,ダスキン代,0,15715,1218149
9579,0001-20091016-136-1490-1-3441,1,2009-10-16,191,仮払消費税等,ダスキン代,0,785,1217364
9588,0001-20091016-94-1489-1-3439,0,2009-10-16,791,雑費,トイレットペーパー代,0,3000,1214364
9589,0001-20091016-94-1489-1-3439,1,2009-10-16,191,仮払消費税等,トイレットペーパー代,0,150,1214214
9591,0001-20091016-94-1489-1-3439,3,2009-10-16,791,雑費,電池代,0,1434,1212780
9592,0001-20091016-94-1489-1-3439,4,2009-10-16,191,仮払消費税等,電池代,0,71,1212709
9594,0001-20091017-47-1491-1-3443,0,2009-10-17,740,車両費,ガソリン代,0,2420,1210289
9595,0001-20091017-47-1491-1-3443,1,2009-10-17,191,仮払消費税等,ガソリン代,0,120,1210169
9598,0001-20091017-69-1492-1-3445,0,2009-10-17,791,雑費,洗剤他,0,2734,1207435
9599,0001-20091017-69-1492-1-3445,1,2009-10-17,191,仮払消費税等,洗剤他,0,136,1207299
9602,0001-20091018-104-1496-1-3453,0,2009-10-18,733,交際接待費,食事代　ホテルラフォーネ2名,0,6134,1201165
9603,0001-20091018-104-1496-1-3453,1,2009-10-18,191,仮払消費税等,食事代　ホテルラフォーネ2名,0,306,1200859
9606,0001-20091018-12-1493-1-3447,0,2009-10-18,740,車両費,ガソリン代,0,4456,1196403
9607,0001-20091018-12-1493-1-3447,1,2009-10-18,191,仮払消費税等,ガソリン代,0,222,1196181
9609,0001-20091018-12-1493-1-3447,3,2009-10-18,740,車両費,高速代,0,2313,1193868
9610,0001-20091018-12-1493-1-3447,4,2009-10-18,191,仮払消費税等,高速代,0,115,1193753
9613,0001-20091018-155-1497-1-3455,0,2009-10-18,740,車両費,ガソリン代,0,3372,1190381
9614,0001-20091018-155-1497-1-3455,1,2009-10-18,191,仮払消費税等,ガソリン代,0,168,1190213
9617,0001-20091018-52-1494-1-3449,0,2009-10-18,740,車両費,高速代,0,2191,1188022
9618,0001-20091018-52-1494-1-3449,1,2009-10-18,191,仮払消費税等,高速代,0,109,1187913
9620,0001-20091018-52-1494-1-3449,3,2009-10-18,740,車両費,駐車代,0,1715,1186198
9621,0001-20091018-52-1494-1-3449,4,2009-10-18,191,仮払消費税等,駐車代,0,85,1186113
9623,0001-20091018-86-1495-1-3451,0,2009-10-18,727,通信費,切手代,0,7620,1178493
9624,0001-20091018-86-1495-1-3451,1,2009-10-18,191,仮払消費税等,切手代,0,380,1178113
9627,0001-20091019-153-1498-1-3457,0,2009-10-19,733,交際接待費,手土産代　五越百貨店,0,6229,1171884
9628,0001-20091019-153-1498-1-3457,1,2009-10-19,191,仮払消費税等,手土産代　五越百貨店,0,311,1171573
9683,0001-20091020-144-1516-1-3493,0,2009-10-20,740,車両費,ガソリン代,0,4290,1167283
9684,0001-20091020-144-1516-1-3493,1,2009-10-20,191,仮払消費税等,ガソリン代,0,214,1167069
9686,0001-20091020-144-1516-1-3493,3,2009-10-20,740,車両費,ガソリン代,0,8096,1158973
9687,0001-20091020-144-1516-1-3493,4,2009-10-20,191,仮払消費税等,ガソリン代,0,404,1158569
9688,0001-20091020-144-1516-1-3493,5,2009-10-20,740,車両費,駐車代,0,3372,1155197
9689,0001-20091020-144-1516-1-3493,6,2009-10-20,191,仮払消費税等,駐車代,0,168,1155029
9695,0001-20091020-48-1500-1-3461,0,2009-10-20,740,車両費,ガソリン代,0,4099,1150930
9696,0001-20091020-48-1500-1-3461,1,2009-10-20,191,仮払消費税等,ガソリン代,0,204,1150726
9730,0001-20091020-99-1507-1-3475,1,2009-10-20,152,売掛金,09年10月20日伝票No333株式会社　斉藤,327228,0,1477954
9749,0001-20091021-160-1528-1-3517,0,2009-10-21,726,旅費交通費,出張旅費,0,66667,1411287
9750,0001-20091021-160-1528-1-3517,1,2009-10-21,191,仮払消費税等,出張旅費,0,3333,1407954
9761,0001-20091021-25-1520-1-3501,0,2009-10-21,726,旅費交通費,旅費,0,53334,1354620
9762,0001-20091021-25-1520-1-3501,1,2009-10-21,191,仮払消費税等,旅費,0,2666,1351954
9779,0001-20091021-53-1522-1-3505,0,2009-10-21,740,車両費,高速代,0,2286,1349668
9780,0001-20091021-53-1522-1-3505,1,2009-10-21,191,仮払消費税等,高速代,0,114,1349554
9782,0001-20091021-53-1522-1-3505,3,2009-10-21,740,車両費,ガソリン代,0,1000,1348554
9783,0001-20091021-53-1522-1-3505,4,2009-10-21,191,仮払消費税等,ガソリン代,0,50,1348504
9784,0001-20091021-53-1522-1-3505,5,2009-10-21,740,車両費,駐車代,0,762,1347742
9785,0001-20091021-53-1522-1-3505,6,2009-10-21,191,仮払消費税等,駐車代,0,38,1347704
9787,0001-20091021-6-1518-1-3497,0,2009-10-21,732,広告宣伝費,広告料,0,4762,1342942
9788,0001-20091021-6-1518-1-3497,1,2009-10-21,191,仮払消費税等,広告料,0,238,1342704
9803,0001-20091021-79-1525-1-3511,0,2009-10-21,726,旅費交通費,旅費,0,24762,1317942
9804,0001-20091021-79-1525-1-3511,1,2009-10-21,191,仮払消費税等,旅費,0,1238,1316704
9807,0001-20091021-8-1519-1-3499,0,2009-10-21,733,交際接待費,定例ミーティング会費,0,19048,1297656
9808,0001-20091021-8-1519-1-3499,1,2009-10-21,191,仮払消費税等,定例ミーティング会費,0,952,1296704
9821,0001-20091022-105-1536-1-3533,0,2009-10-22,733,交際接待費,食事代　串揚げ一心4名,0,15658,1281046
9822,0001-20091022-105-1536-1-3533,1,2009-10-22,191,仮払消費税等,食事代　串揚げ一心4名,0,782,1280264
9824,0001-20091022-105-1536-1-3533,3,2009-10-22,733,交際接待費,飲食代　スナック北新地4名,0,13962,1266302
9825,0001-20091022-105-1536-1-3533,4,2009-10-22,191,仮払消費税等,飲食代　スナック北新地4名,0,698,1265604
9842,0001-20091022-163-1538-1-3537,1,2009-10-22,742,諸会費,会費,0,18000,1247604
9844,0001-20091022-165-1539-1-3539,0,2009-10-22,791,雑費,トイレットペーパー代,0,1429,1246175
9845,0001-20091022-165-1539-1-3539,1,2009-10-22,191,仮払消費税等,トイレットペーパー代,0,71,1246104
9848,0001-20091022-166-1540-1-3541,0,2009-10-22,791,雑費,ダスキン代,0,1800,1244304
9849,0001-20091022-166-1540-1-3541,1,2009-10-22,191,仮払消費税等,ダスキン代,0,90,1244214
9857,0001-20091022-45-1532-1-3525,1,2009-10-22,733,交際接待費,香典代,0,10000,1234214
9859,0001-20091022-69-1533-1-3527,0,2009-10-22,733,交際接待費,ゴルフプレー代2名,0,20953,1213261
9860,0001-20091022-69-1533-1-3527,1,2009-10-22,191,仮払消費税等,ゴルフプレー代2名,0,1047,1212214
9863,0001-20091022-9-1531-1-3523,0,2009-10-22,733,交際接待費,商品券,0,4762,1207452
9864,0001-20091022-9-1531-1-3523,1,2009-10-22,191,仮払消費税等,商品券,0,238,1207214
9867,0001-20091022-90-1534-1-3529,0,2009-10-22,791,雑費,ダスキン代,0,10000,1197214
9868,0001-20091022-90-1534-1-3529,1,2009-10-22,191,仮払消費税等,ダスキン代,0,500,1196714
9875,0001-20091023-140-1544-1-3549,0,2009-10-23,726,旅費交通費,旅費,0,7515,1189199
9876,0001-20091023-140-1544-1-3549,1,2009-10-23,191,仮払消費税等,旅費,0,375,1188824
9879,0001-20091023-24-1541-1-3543,0,2009-10-23,726,旅費交通費,JR回数券,0,90649,1098175
9880,0001-20091023-24-1541-1-3543,1,2009-10-23,191,仮払消費税等,JR回数券,0,4532,1093643
9887,0001-20091023-54-1543-1-3547,0,2009-10-23,740,車両費,高速代,0,4381,1089262
9888,0001-20091023-54-1543-1-3547,1,2009-10-23,191,仮払消費税等,高速代,0,219,1089043
9891,0001-20091024-121-1546-1-3553,0,2009-10-24,724,福利厚生費,お茶代,0,6667,1082376
9892,0001-20091024-121-1546-1-3553,1,2009-10-24,191,仮払消費税等,お茶代,0,333,1082043
9899,0001-20091024-26-1545-1-3551,0,2009-10-24,726,旅費交通費,旅費,0,11524,1070519
9900,0001-20091024-26-1545-1-3551,1,2009-10-24,191,仮払消費税等,旅費,0,576,1069943
9934,0001-20091025-170-1559-1-3579,0,2009-10-25,739,新聞図書費,新聞代,0,2864,1067079
9935,0001-20091025-170-1559-1-3579,1,2009-10-25,191,仮払消費税等,新聞代,0,143,1066936
9945,0001-20091025-173-1561-1-3583,1,2009-10-25,738,租税公課,収入印紙代,0,10000,1056936
9953,0001-20091025-35-1549-1-3559,0,2009-10-25,739,新聞図書費,新聞代,0,3739,1053197
9954,0001-20091025-35-1549-1-3559,1,2009-10-25,191,仮払消費税等,新聞代,0,186,1053011
9961,0001-20091025-74-1551-1-3563,0,2009-10-25,740,車両費,ガソリン代,0,4351,1048660
9962,0001-20091025-74-1551-1-3563,1,2009-10-25,191,仮払消費税等,ガソリン代,0,217,1048443
9964,0001-20091025-74-1551-1-3563,3,2009-10-25,740,車両費,駐車代,0,572,1047871
9965,0001-20091025-74-1551-1-3563,4,2009-10-25,191,仮払消費税等,駐車代,0,28,1047843
10099,0001-20091026-27-1562-1-3585,0,2009-10-26,726,旅費交通費,旅費,0,26172,1021671
10100,0001-20091026-27-1562-1-3585,1,2009-10-26,191,仮払消費税等,旅費,0,1308,1020363
10102,0001-20091026-27-1562-1-3585,3,2009-10-26,726,旅費交通費,旅費,0,34000,986363
10103,0001-20091026-27-1562-1-3585,4,2009-10-26,191,仮払消費税等,旅費,0,1700,984663
10104,0001-20091026-27-1562-1-3585,5,2009-10-26,726,旅費交通費,旅費,0,24464,960199
10105,0001-20091026-27-1562-1-3585,6,2009-10-26,191,仮払消費税等,旅費,0,1223,958976
10127,0001-20091027-14-1569-1-3599,0,2009-10-27,740,車両費,ガソリン代,0,2858,956118
10128,0001-20091027-14-1569-1-3599,1,2009-10-27,191,仮払消費税等,ガソリン代,0,142,955976
10136,0001-20091027-39-1571-1-3603,0,2009-10-27,724,福利厚生費,会費,0,8572,947404
10137,0001-20091027-39-1571-1-3603,1,2009-10-27,191,仮払消費税等,会費,0,428,946976
10140,0001-20091027-83-1572-1-3605,0,2009-10-27,740,車両費,車両管理費,0,48762,898214
10141,0001-20091027-83-1572-1-3605,1,2009-10-27,191,仮払消費税等,車両管理費,0,2438,895776
10150,0001-20091027-88-1574-1-3609,0,2009-10-27,739,新聞図書費,新聞代,0,3399,892377
10151,0001-20091027-88-1574-1-3609,1,2009-10-27,191,仮払消費税等,新聞代,0,169,892208
10154,0001-20091028-114-1579-1-3619,0,2009-10-28,739,新聞図書費,新聞代,0,2540,889668
10155,0001-20091028-114-1579-1-3619,1,2009-10-28,191,仮払消費税等,新聞代,0,126,889542
10157,0001-20091028-114-1579-1-3619,3,2009-10-28,739,新聞図書費,新聞代,0,2864,886678
10158,0001-20091028-114-1579-1-3619,4,2009-10-28,191,仮払消費税等,新聞代,0,143,886535
10160,0001-20091028-15-1576-1-3613,0,2009-10-28,740,車両費,駐車代,0,762,885773
10161,0001-20091028-15-1576-1-3613,1,2009-10-28,191,仮払消費税等,駐車代,0,38,885735
10164,0001-20091028-59-1577-1-3615,0,2009-10-28,726,旅費交通費,旅費,0,46572,839163
10165,0001-20091028-59-1577-1-3615,1,2009-10-28,191,仮払消費税等,旅費,0,2328,836835
10176,0001-20091029-72-1580-1-3621,0,2009-10-29,739,新聞図書費,新聞代,0,2864,833971
10177,0001-20091029-72-1580-1-3621,1,2009-10-29,191,仮払消費税等,新聞代,0,143,833828
10179,0001-20091029-72-1580-1-3621,3,2009-10-29,739,新聞図書費,新聞代,0,2815,831013
10180,0001-20091029-72-1580-1-3621,4,2009-10-29,191,仮払消費税等,新聞代,0,140,830873
10181,0001-20091029-72-1580-1-3621,5,2009-10-29,739,新聞図書費,新聞代,0,3399,827474
10182,0001-20091029-72-1580-1-3621,6,2009-10-29,191,仮払消費税等,新聞代,0,169,827305
10184,0001-20091030-100-1587-1-3635,0,2009-10-30,724,福利厚生費,会費,0,5715,821590
10185,0001-20091030-100-1587-1-3635,1,2009-10-30,191,仮払消費税等,会費,0,285,821305
10193,0001-20091030-13-1582-1-3625,0,2009-10-30,740,車両費,ガソリン代,0,12381,808924
10194,0001-20091030-13-1582-1-3625,1,2009-10-30,191,仮払消費税等,ガソリン代,0,619,808305
10213,0001-20091030-55-1583-1-3627,0,2009-10-30,740,車両費,車両管理費,0,23810,784495
10214,0001-20091030-55-1583-1-3627,1,2009-10-30,191,仮払消費税等,車両管理費,0,1190,783305
10216,0001-20091030-55-1583-1-3627,3,2009-10-30,740,車両費,高速代,0,7667,775638
10217,0001-20091030-55-1583-1-3627,4,2009-10-30,191,仮払消費税等,高速代,0,383,775255
10233,0001-20091030-73-1585-1-3631,0,2009-10-30,733,交際接待費,コーヒー代2名,0,1200,774055
10234,0001-20091030-73-1585-1-3631,1,2009-10-30,191,仮払消費税等,コーヒー代2名,0,60,773995
10396,0001-20091031-119-1614-1-3689,1,2009-10-31,152,売掛金,09年10月31日伝票No456合同会社　エイム商事,323785,0,1097780
10562,0001-20091031-49-1593-1-3647,0,2009-10-31,740,車両費,ガソリン代,0,155686,942094
10563,0001-20091031-49-1593-1-3647,1,2009-10-31,191,仮払消費税等,ガソリン代,0,7784,934310
10578,0001-20091031-67-1596-1-3653,1,2009-10-31,742,諸会費,会費支払い,0,30000,904310
,,,2009-10,,※※月計※※,,2151013,2412107,
10614,0001-20091101-165-1638-1-3737,0,2009-11-01,791,雑費,お茶代他,0,3578,900732
10615,0001-20091101-165-1638-1-3737,1,2009-11-01,191,仮払消費税等,お茶代他,0,178,900554
10618,0001-20091101-18-1636-1-3733,0,2009-11-01,726,旅費交通費,旅費,0,20000,880554
10619,0001-20091101-18-1636-1-3733,1,2009-11-01,191,仮払消費税等,旅費,0,1000,879554
10622,0001-20091101-75-1637-1-3735,0,2009-11-01,740,車両費,ガソリン代,0,6151,873403
10623,0001-20091101-75-1637-1-3735,1,2009-11-01,191,仮払消費税等,ガソリン代,0,307,873096
10625,0001-20091101-75-1637-1-3735,3,2009-11-01,740,車両費,ウォッシャー液代,0,475,872621
10626,0001-20091101-75-1637-1-3735,4,2009-11-01,191,仮払消費税等,ウォッシャー液代,0,23,872598
10628,0001-20091102-149-1639-1-3739,0,2009-11-02,733,交際接待費,食事代　和食処川よし2名,0,7758,864840
10629,0001-20091102-149-1639-1-3739,1,2009-11-02,191,仮払消費税等,食事代　和食処川よし2名,0,387,864453
10631,0001-20091102-149-1639-1-3739,3,2009-11-02,733,交際接待費,飲食代　スナックランディ,0,11874,852579
10632,0001-20091102-149-1639-1-3739,4,2009-11-02,191,仮払消費税等,飲食代　スナックランディ,0,593,851986
10634,0001-20091103-134-1641-1-3743,0,2009-11-03,754,事務用消耗品費,用紙,0,9143,842843
10635,0001-20091103-134-1641-1-3743,1,2009-11-03,191,仮払消費税等,用紙,0,457,842386
10638,0001-20091103-41-1640-1-3741,0,2009-11-03,733,交際接待費,食事代　トン吉2名,0,3372,839014
10639,0001-20091103-41-1640-1-3741,1,2009-11-03,191,仮払消費税等,食事代　トン吉2名,0,168,838846
10642,0001-20091104-67-1642-1-3745,0,2009-11-04,791,雑費,お茶代他,0,2128,836718
10643,0001-20091104-67-1642-1-3745,1,2009-11-04,191,仮払消費税等,お茶代他,0,106,836612
10646,0001-20091104-68-1643-1-3747,0,2009-11-04,791,雑費,ティッシュ代他,0,2881,833731
10647,0001-20091104-68-1643-1-3747,1,2009-11-04,191,仮払消費税等,ティッシュ代他,0,144,833587
10651,0001-20091105-102-1652-1-3765,1,2009-11-05,733,交際接待費,香典代,0,10000,823587
10659,0001-20091105-143-1654-1-3769,0,2009-11-05,740,車両費,点検作業料,0,29858,793729
10660,0001-20091105-143-1654-1-3769,1,2009-11-05,191,仮払消費税等,点検作業料,0,1492,792237
10663,0001-20091105-19-1644-1-3749,0,2009-11-05,726,旅費交通費,旅費,0,9334,782903
10664,0001-20091105-19-1644-1-3749,1,2009-11-05,191,仮払消費税等,旅費,0,466,782437
10667,0001-20091105-42-1645-1-3751,0,2009-11-05,733,交際接待費,コーヒー代3名,0,1800,780637
10668,0001-20091105-42-1645-1-3751,1,2009-11-05,191,仮払消費税等,コーヒー代3名,0,90,780547
10671,0001-20091105-50-1646-1-3753,0,2009-11-05,740,車両費,高速代,0,3620,776927
10672,0001-20091105-50-1646-1-3753,1,2009-11-05,191,仮払消費税等,高速代,0,180,776747
10675,0001-20091105-56-1647-1-3755,0,2009-11-05,726,旅費交通費,旅費,0,9743,767004
10676,0001-20091105-56-1647-1-3755,1,2009-11-05,191,仮払消費税等,旅費,0,487,766517
10679,0001-20091105-79-1648-1-3757,0,2009-11-05,724,福利厚生費,景品代,0,28449,738068
10680,0001-20091105-79-1648-1-3757,1,2009-11-05,191,仮払消費税等,景品代,0,1422,736646
10704,0001-20091106-10-1655-1-3771,0,2009-11-06,740,車両費,ガソリン代,0,4023,732623
10705,0001-20091106-10-1655-1-3771,1,2009-11-06,191,仮払消費税等,ガソリン代,0,201,732422
10708,0001-20091106-110-1657-1-3775,0,2009-11-06,726,旅費交通費,タクシー代,0,2181,730241
10709,0001-20091106-110-1657-1-3775,1,2009-11-06,191,仮払消費税等,タクシー代,0,109,730132
10712,0001-20091106-16-1656-1-3773,0,2009-11-06,740,車両費,スノーブレード代,0,7620,722512
10713,0001-20091106-16-1656-1-3773,1,2009-11-06,191,仮払消費税等,スノーブレード代,0,380,722132
10716,0001-20091107-20-1658-1-3777,0,2009-11-07,726,旅費交通費,旅費,0,37143,684989
10717,0001-20091107-20-1658-1-3777,1,2009-11-07,191,仮払消費税等,旅費,0,1857,683132
10720,0001-20091107-21-1659-1-3779,0,2009-11-07,726,旅費交通費,JR代,0,66191,616941
10721,0001-20091107-21-1659-1-3779,1,2009-11-07,191,仮払消費税等,JR代,0,3309,613632
10724,0001-20091107-22-1660-1-3781,0,2009-11-07,726,旅費交通費,旅費,0,47620,566012
10725,0001-20091107-22-1660-1-3781,1,2009-11-07,191,仮払消費税等,旅費,0,2380,563632
10728,0001-20091107-58-1661-1-3783,0,2009-11-07,726,旅費交通費,旅費,0,66667,496965
10729,0001-20091107-58-1661-1-3783,1,2009-11-07,191,仮払消費税等,旅費,0,3333,493632
10736,0001-20091108-43-1663-1-3787,0,2009-11-08,733,交際接待費,コーヒー代2名,0,1500,492132
10737,0001-20091108-43-1663-1-3787,1,2009-11-08,191,仮払消費税等,コーヒー代2名,0,75,492057
10740,0001-20091108-44-1664-1-3789,0,2009-11-08,733,交際接待費,手土産代　今井百貨店,0,3000,489057
10741,0001-20091108-44-1664-1-3789,1,2009-11-08,191,仮払消費税等,手土産代　今井百貨店,0,150,488907
10744,0001-20091108-78-1665-1-3791,0,2009-11-08,726,旅費交通費,ＪＲ代,0,9334,479573
10745,0001-20091108-78-1665-1-3791,1,2009-11-08,191,仮払消費税等,ＪＲ代,0,466,479107
10752,0001-20091109-144-1669-1-3799,0,2009-11-09,740,車両費,ガソリン代,0,6116,472991
10753,0001-20091109-144-1669-1-3799,1,2009-11-09,191,仮払消費税等,ガソリン代,0,305,472686
10755,0001-20091109-144-1669-1-3799,3,2009-11-09,740,車両費,駐車代,0,2516,470170
10756,0001-20091109-144-1669-1-3799,4,2009-11-09,191,仮払消費税等,駐車代,0,125,470045
10757,0001-20091109-144-1669-1-3799,5,2009-11-09,740,車両費,高速代,0,5833,464212
10758,0001-20091109-144-1669-1-3799,6,2009-11-09,191,仮払消費税等,高速代,0,291,463921
10760,0001-20091109-151-1670-1-3801,0,2009-11-09,733,交際接待費,飲食代　和食ダイニング彩6名,0,25220,438701
10761,0001-20091109-151-1670-1-3801,1,2009-11-09,191,仮払消費税等,飲食代　和食ダイニング彩6名,0,1260,437441
10763,0001-20091109-151-1670-1-3801,3,2009-11-09,733,交際接待費,飲食代　パブランディー6名,0,31858,405583
10764,0001-20091109-151-1670-1-3801,4,2009-11-09,191,仮払消費税等,飲食代　パブランディー6名,0,1592,403991
10767,0001-20091109-7-1666-1-3793,1,2009-11-09,733,交際接待費,香典代,0,10000,393991
10786,0001-20091110-141-1685-1-3831,0,2009-11-10,726,旅費交通費,JR代,0,11429,382562
10787,0001-20091110-141-1685-1-3831,1,2009-11-10,191,仮払消費税等,JR代,0,571,381991
10794,0001-20091110-156-1687-1-3835,0,2009-11-10,726,旅費交通費,出張旅費,0,3239,378752
10795,0001-20091110-156-1687-1-3835,1,2009-11-10,191,仮払消費税等,出張旅費,0,161,378591
10798,0001-20091110-162-1688-1-3837,0,2009-11-10,734,会議費,会議　食事代,0,23805,354786
10799,0001-20091110-162-1688-1-3837,1,2009-11-10,191,仮払消費税等,会議　食事代,0,1190,353596
10831,0001-20091110-60-1672-1-3805,1,2009-11-10,121,当座預金,引き出し,2000000,0,2353596
10893,0001-20091111-103-1693-1-3847,0,2009-11-11,733,交際接待費,手土産代　今井百貨店,0,3000,2350596
10894,0001-20091111-103-1693-1-3847,1,2009-11-11,191,仮払消費税等,手土産代　今井百貨店,0,150,2350446
10903,0001-20091111-152-1695-1-3851,0,2009-11-11,733,交際接待費,食事代　博多ラーメン3名,0,2343,2348103
10904,0001-20091111-152-1695-1-3851,1,2009-11-11,191,仮払消費税等,食事代　博多ラーメン3名,0,117,2347986
10907,0001-20091111-46-1691-1-3843,0,2009-11-11,740,車両費,ガソリン代,0,8286,2339700
10908,0001-20091111-46-1691-1-3843,1,2009-11-11,191,仮払消費税等,ガソリン代,0,414,2339286
10910,0001-20091111-46-1691-1-3843,3,2009-11-11,740,車両費,高速代,0,1239,2338047
10911,0001-20091111-46-1691-1-3843,4,2009-11-11,191,仮払消費税等,高速代,0,61,2337986
10912,0001-20091111-46-1691-1-3843,5,2009-11-11,740,車両費,駐車代,0,572,2337414
10913,0001-20091111-46-1691-1-3843,6,2009-11-11,191,仮払消費税等,駐車代,0,28,2337386
10915,0001-20091111-70-1692-1-3845,0,2009-11-11,733,交際接待費,ゴルフプレー代4名,0,40000,2297386
10916,0001-20091111-70-1692-1-3845,1,2009-11-11,191,仮払消費税等,ゴルフプレー代4名,0,2000,2295386
10918,0001-20091111-70-1692-1-3845,3,2009-11-11,733,交際接待費,景品代,0,10000,2285386
10919,0001-20091111-70-1692-1-3845,4,2009-11-11,191,仮払消費税等,景品代,0,500,2284886
10921,0001-20091112-73-1696-1-3853,0,2009-11-12,733,交際接待費,飲食代　居酒屋栗の木3名,0,9931,2274955
10922,0001-20091112-73-1696-1-3853,1,2009-11-12,191,仮払消費税等,飲食代　居酒屋栗の木3名,0,496,2274459
10925,0001-20091112-74-1697-1-3855,0,2009-11-12,733,交際接待費,飲食代　スナックランディ,0,21572,2252887
10926,0001-20091112-74-1697-1-3855,1,2009-11-12,191,仮払消費税等,飲食代　スナックランディ,0,1078,2251809
10929,0001-20091112-79-1698-1-3857,0,2009-11-12,726,旅費交通費,旅費,0,11429,2240380
10930,0001-20091112-79-1698-1-3857,1,2009-11-12,191,仮払消費税等,旅費,0,571,2239809
10933,0001-20091113-142-1700-1-3861,0,2009-11-13,740,車両費,高速代,0,3446,2236363
10934,0001-20091113-142-1700-1-3861,1,2009-11-13,191,仮払消費税等,高速代,0,172,2236191
10936,0001-20091113-142-1700-1-3861,3,2009-11-13,740,車両費,高速代,0,2043,2234148
10937,0001-20091113-142-1700-1-3861,4,2009-11-13,191,仮払消費税等,高速代,0,102,2234046
10938,0001-20091113-142-1700-1-3861,5,2009-11-13,740,車両費,高速代,0,1195,2232851
10939,0001-20091113-142-1700-1-3861,6,2009-11-13,191,仮払消費税等,高速代,0,59,2232792
10940,0001-20091113-142-1700-1-3861,7,2009-11-13,740,車両費,駐車代,0,3000,2229792
10941,0001-20091113-142-1700-1-3861,8,2009-11-13,191,仮払消費税等,駐車代,0,150,2229642
10942,0001-20091113-142-1700-1-3861,9,2009-11-13,740,車両費,ガソリン代,0,7220,2222422
10943,0001-20091113-142-1700-1-3861,10,2009-11-13,191,仮払消費税等,ガソリン代,0,360,2222062
10945,0001-20091113-158-1701-1-3863,0,2009-11-13,726,旅費交通費,航空券,0,44762,2177300
10946,0001-20091113-158-1701-1-3863,1,2009-11-13,191,仮払消費税等,航空券,0,2238,2175062
10949,0001-20091113-17-1699-1-3859,0,2009-11-13,740,車両費,ウォッシャー液,0,351,2174711
10950,0001-20091113-17-1699-1-3859,1,2009-11-13,191,仮払消費税等,ウォッシャー液,0,17,2174694
10953,0001-20091114-161-1704-1-3869,0,2009-11-14,726,旅費交通費,旅費,0,7096,2167598
10954,0001-20091114-161-1704-1-3869,1,2009-11-14,191,仮払消費税等,旅費,0,354,2167244
10957,0001-20091114-23-1702-1-3865,0,2009-11-14,726,旅費交通費,旅費,0,26667,2140577
10958,0001-20091114-23-1702-1-3865,1,2009-11-14,191,仮払消費税等,旅費,0,1333,2139244
10960,0001-20091114-23-1702-1-3865,3,2009-11-14,726,旅費交通費,旅費,0,29524,2109720
10961,0001-20091114-23-1702-1-3865,4,2009-11-14,191,仮払消費税等,旅費,0,1476,2108244
10962,0001-20091114-23-1702-1-3865,5,2009-11-14,726,旅費交通費,旅費,0,36667,2071577
10963,0001-20091114-23-1702-1-3865,6,2009-11-14,191,仮払消費税等,旅費,0,1833,2069744
10965,0001-20091114-51-1703-1-3867,0,2009-11-14,740,車両費,高速代,0,6477,2063267
10966,0001-20091114-51-1703-1-3867,1,2009-11-14,191,仮払消費税等,高速代,0,323,2062944
10974,0001-20091115-11-1705-1-3871,0,2009-11-15,740,車両費,ガソリン代,0,3058,2059886
10975,0001-20091115-11-1705-1-3871,1,2009-11-15,191,仮払消費税等,ガソリン代,0,152,2059734
10979,0001-20091115-117-1718-1-3897,1,2009-11-15,742,諸会費,会費,0,20000,2039734
10981,0001-20091115-57-1706-1-3873,0,2009-11-15,726,旅費交通費,JR代,0,99524,1940210
10982,0001-20091115-57-1706-1-3873,1,2009-11-15,191,仮払消費税等,JR代,0,4976,1935234
10996,0001-20091115-81-1709-1-3879,1,2009-11-15,721,雑給,11月給与その他 0060 パート･アルバイト,0,668749,1266485
11062,0001-20091116-136-1722-1-3905,0,2009-11-16,791,雑費,ダスキン代,0,15715,1250770
11063,0001-20091116-136-1722-1-3905,1,2009-11-16,191,仮払消費税等,ダスキン代,0,785,1249985
11066,0001-20091116-164-1723-1-3907,0,2009-11-16,754,事務用消耗品費,事務用品,0,2299,1247686
11067,0001-20091116-164-1723-1-3907,1,2009-11-16,191,仮払消費税等,事務用品,0,114,1247572
11070,0001-20091116-47-1719-1-3899,0,2009-11-16,740,車両費,ガソリン代,0,8286,1239286
11071,0001-20091116-47-1719-1-3899,1,2009-11-16,191,仮払消費税等,ガソリン代,0,414,1238872
11084,0001-20091118-104-1727-1-3915,0,2009-11-18,733,交際接待費,コーヒー代2名,0,1200,1237672
11085,0001-20091118-104-1727-1-3915,1,2009-11-18,191,仮払消費税等,コーヒー代2名,0,60,1237612
11088,0001-20091118-59-1725-1-3911,0,2009-11-18,726,旅費交通費,旅費,0,52858,1184754
11089,0001-20091118-59-1725-1-3911,1,2009-11-18,191,仮払消費税等,旅費,0,2642,1182112
11092,0001-20091118-76-1726-1-3913,0,2009-11-18,740,車両費,ガソリン代,0,3686,1178426
11093,0001-20091118-76-1726-1-3913,1,2009-11-18,191,仮払消費税等,ガソリン代,0,184,1178242
11095,0001-20091118-76-1726-1-3913,3,2009-11-18,740,車両費,高速代,0,762,1177480
11096,0001-20091118-76-1726-1-3913,4,2009-11-18,191,仮払消費税等,高速代,0,38,1177442
11098,0001-20091119-12-1729-1-3919,0,2009-11-19,740,車両費,ガソリン代,0,4456,1172986
11099,0001-20091119-12-1729-1-3919,1,2009-11-19,191,仮払消費税等,ガソリン代,0,222,1172764
11101,0001-20091119-12-1729-1-3919,3,2009-11-19,740,車両費,高速代,0,1572,1171192
11102,0001-20091119-12-1729-1-3919,4,2009-11-19,191,仮払消費税等,高速代,0,78,1171114
11103,0001-20091119-12-1729-1-3919,5,2009-11-19,740,車両費,駐車代,0,762,1170352
11104,0001-20091119-12-1729-1-3919,6,2009-11-19,191,仮払消費税等,駐車代,0,38,1170314
11106,0001-20091119-45-1730-1-3921,0,2009-11-19,733,交際接待費,コーヒー代,0,1200,1169114
11107,0001-20091119-45-1730-1-3921,1,2009-11-19,191,仮払消費税等,コーヒー代,0,60,1169054
11110,0001-20091119-52-1731-1-3923,0,2009-11-19,740,車両費,高速代,0,1096,1167958
11111,0001-20091119-52-1731-1-3923,1,2009-11-19,191,仮払消費税等,高速代,0,54,1167904
11113,0001-20091119-52-1731-1-3923,3,2009-11-19,740,車両費,駐車代,0,2191,1165713
11114,0001-20091119-52-1731-1-3923,4,2009-11-19,191,仮払消費税等,駐車代,0,109,1165604
11116,0001-20091119-8-1728-1-3917,0,2009-11-19,733,交際接待費,定例ミーティング会費,0,19048,1146556
11117,0001-20091119-8-1728-1-3917,1,2009-11-19,191,仮払消費税等,定例ミーティング会費,0,952,1145604
11124,0001-20091120-101-1745-1-3951,4,2009-11-20,152,売掛金,09年11月20日伝票No367株式会社　斉藤,570515,0,1716119
11186,0001-20091120-153-1756-1-3973,0,2009-11-20,733,交際接待費,飲食代　居酒屋田舎2名,0,7206,1708913
11187,0001-20091120-153-1756-1-3973,1,2009-11-20,191,仮払消費税等,飲食代　居酒屋田舎2名,0,360,1708553
11198,0001-20091120-24-1733-1-3927,0,2009-11-20,726,旅費交通費,JR回数券,0,78686,1629867
11199,0001-20091120-24-1733-1-3927,1,2009-11-20,191,仮払消費税等,JR回数券,0,3934,1625933
11214,0001-20091120-53-1736-1-3933,0,2009-11-20,740,車両費,高速代,0,381,1625552
11215,0001-20091120-53-1736-1-3933,1,2009-11-20,191,仮払消費税等,高速代,0,19,1625533
11217,0001-20091120-53-1736-1-3933,3,2009-11-20,740,車両費,高速代,0,1000,1624533
11218,0001-20091120-53-1736-1-3933,4,2009-11-20,191,仮払消費税等,高速代,0,50,1624483
11219,0001-20091120-53-1736-1-3933,5,2009-11-20,740,車両費,高速代,0,1000,1623483
11220,0001-20091120-53-1736-1-3933,6,2009-11-20,191,仮払消費税等,高速代,0,50,1623433
11222,0001-20091120-6-1732-1-3925,0,2009-11-20,732,広告宣伝費,広告料,0,4762,1618671
11223,0001-20091120-6-1732-1-3925,1,2009-11-20,191,仮払消費税等,広告料,0,238,1618433
11274,0001-20091121-160-1760-1-3981,0,2009-11-21,726,旅費交通費,出張旅費,0,90515,1527918
11275,0001-20091121-160-1760-1-3981,1,2009-11-21,191,仮払消費税等,出張旅費,0,4525,1523393
11279,0001-20091121-163-1761-1-3983,1,2009-11-21,742,諸会費,会費,0,18000,1505393
11281,0001-20091121-25-1758-1-3977,0,2009-11-21,726,旅費交通費,旅費,0,53334,1452059
11282,0001-20091121-25-1758-1-3977,1,2009-11-21,191,仮払消費税等,旅費,0,2666,1449393
11285,0001-20091121-69-1759-1-3979,0,2009-11-21,791,雑費,ティッシュ代,0,1077,1448316
11286,0001-20091121-69-1759-1-3979,1,2009-11-21,191,仮払消費税等,ティッシュ代,0,53,1448263
11289,0001-20091122-105-1767-1-3995,0,2009-11-22,733,交際接待費,コーヒー代他2名,0,2343,1445920
11290,0001-20091122-105-1767-1-3995,1,2009-11-22,191,仮払消費税等,コーヒー代他2名,0,117,1445803
11292,0001-20091122-105-1767-1-3995,3,2009-11-22,733,交際接待費,食事代　串揚げ一心2名,0,6074,1439729
11293,0001-20091122-105-1767-1-3995,4,2009-11-22,191,仮払消費税等,食事代　串揚げ一心2名,0,303,1439426
11294,0001-20091122-105-1767-1-3995,5,2009-11-22,733,交際接待費,飲食代　カフェバーラウル,0,9296,1430130
11295,0001-20091122-105-1767-1-3995,6,2009-11-22,191,仮払消費税等,飲食代　カフェバーラウル,0,464,1429666
11298,0001-20091122-107-1768-1-3997,1,2009-11-22,733,交際接待費,結婚祝い金,0,10000,1419666
11300,0001-20091122-159-1769-1-3999,0,2009-11-22,726,旅費交通費,タクシー代,0,12381,1407285
11301,0001-20091122-159-1769-1-3999,1,2009-11-22,191,仮払消費税等,タクシー代,0,619,1406666
11304,0001-20091122-166-1770-1-4001,0,2009-11-22,791,雑費,ダスキン代,0,1800,1404866
11305,0001-20091122-166-1770-1-4001,1,2009-11-22,191,仮払消費税等,ダスキン代,0,90,1404776
11308,0001-20091122-48-1762-1-3985,0,2009-11-22,740,車両費,ガソリン代,0,3298,1401478
11309,0001-20091122-48-1762-1-3985,1,2009-11-22,191,仮払消費税等,ガソリン代,0,164,1401314
11316,0001-20091122-80-1764-1-3989,0,2009-11-22,726,旅費交通費,旅費,0,29524,1371790
11317,0001-20091122-80-1764-1-3989,1,2009-11-22,191,仮払消費税等,旅費,0,1476,1370314
11320,0001-20091122-90-1765-1-3991,0,2009-11-22,791,雑費,ダスキン代,0,10000,1360314
11321,0001-20091122-90-1765-1-3991,1,2009-11-22,191,仮払消費税等,ダスキン代,0,500,1359814
11328,0001-20091123-13-1772-1-4005,0,2009-11-23,740,車両費,ガソリン代,0,10477,1349337
11329,0001-20091123-13-1772-1-4005,1,2009-11-23,191,仮払消費税等,ガソリン代,0,523,1348814
11332,0001-20091123-140-1777-1-4015,0,2009-11-23,726,旅費交通費,旅費,0,4381,1344433
11333,0001-20091123-140-1777-1-4015,1,2009-11-23,191,仮払消費税等,旅費,0,219,1344214
11336,0001-20091123-26-1773-1-4007,0,2009-11-23,726,旅費交通費,旅費,0,10477,1333737
11337,0001-20091123-26-1773-1-4007,1,2009-11-23,191,仮払消費税等,旅費,0,523,1333214
11463,0001-20091123-94-1776-1-4013,0,2009-11-23,791,雑費,洗剤代,0,1527,1331687
11464,0001-20091123-94-1776-1-4013,1,2009-11-23,191,仮払消費税等,洗剤代,0,76,1331611
11471,0001-20091124-150-1782-1-4025,0,2009-11-24,733,交際接待費,ゴルフプレー代,0,13667,1317944
11472,0001-20091124-150-1782-1-4025,1,2009-11-24,191,仮払消費税等,ゴルフプレー代,0,683,1317261
11474,0001-20091124-150-1782-1-4025,3,2009-11-24,733,交際接待費,景品代　今井百貨店,0,5000,1312261
11475,0001-20091124-150-1782-1-4025,4,2009-11-24,191,仮払消費税等,景品代　今井百貨店,0,250,1312011
11481,0001-20091124-77-1779-1-4019,0,2009-11-24,740,車両費,ガソリン代,0,3053,1308958
11482,0001-20091124-77-1779-1-4019,1,2009-11-24,191,仮払消費税等,ガソリン代,0,152,1308806
11484,0001-20091124-77-1779-1-4019,3,2009-11-24,740,車両費,駐車代,0,572,1308234
11485,0001-20091124-77-1779-1-4019,4,2009-11-24,191,仮払消費税等,駐車代,0,28,1308206
11487,0001-20091124-83-1780-1-4021,0,2009-11-24,740,車両費,車両管理費,0,30000,1278206
11488,0001-20091124-83-1780-1-4021,1,2009-11-24,191,仮払消費税等,車両管理費,0,1500,1276706
11536,0001-20091125-170-1795-1-4051,0,2009-11-25,739,新聞図書費,新聞代,0,2864,1273842
11537,0001-20091125-170-1795-1-4051,1,2009-11-25,191,仮払消費税等,新聞代,0,143,1273699
11560,0001-20091125-88-1787-1-4035,0,2009-11-25,739,新聞図書費,新聞代,0,3399,1270300
11561,0001-20091125-88-1787-1-4035,1,2009-11-25,191,仮払消費税等,新聞代,0,169,1270131
11564,0001-20091125-9-1783-1-4027,0,2009-11-25,733,交際接待費,飲食代　いろは2名,0,6229,1263902
11565,0001-20091125-9-1783-1-4027,1,2009-11-25,191,仮払消費税等,飲食代　いろは2名,0,311,1263591
11567,0001-20091125-9-1783-1-4027,3,2009-11-25,733,交際接待費,飲食代　カフェバー,0,8334,1255257
11568,0001-20091125-9-1783-1-4027,4,2009-11-25,191,仮払消費税等,飲食代　カフェバー,0,416,1254841
11576,0001-20091126-121-1800-1-4061,0,2009-11-26,724,福利厚生費,お茶代,0,8096,1246745
11577,0001-20091126-121-1800-1-4061,1,2009-11-26,191,仮払消費税等,お茶代,0,404,1246341
11580,0001-20091126-54-1797-1-4055,0,2009-11-26,740,車両費,高速代,0,2381,1243960
11581,0001-20091126-54-1797-1-4055,1,2009-11-26,191,仮払消費税等,高速代,0,119,1243841
11584,0001-20091126-72-1798-1-4057,0,2009-11-26,739,新聞図書費,新聞代,0,2864,1240977
11585,0001-20091126-72-1798-1-4057,1,2009-11-26,191,仮払消費税等,新聞代,0,143,1240834
11587,0001-20091126-72-1798-1-4057,3,2009-11-26,739,新聞図書費,新聞代,0,2815,1238019
11588,0001-20091126-72-1798-1-4057,4,2009-11-26,191,仮払消費税等,新聞代,0,140,1237879
11589,0001-20091126-72-1798-1-4057,5,2009-11-26,739,新聞図書費,新聞代,0,3399,1234480
11590,0001-20091126-72-1798-1-4057,6,2009-11-26,191,仮払消費税等,新聞代,0,169,1234311
11592,0001-20091127-114-1806-1-4073,0,2009-11-27,739,新聞図書費,新聞代,0,2540,1231771
11593,0001-20091127-114-1806-1-4073,1,2009-11-27,191,仮払消費税等,新聞代,0,126,1231645
11595,0001-20091127-114-1806-1-4073,3,2009-11-27,739,新聞図書費,新聞代,0,2864,1228781
11596,0001-20091127-114-1806-1-4073,4,2009-11-27,191,仮払消費税等,新聞代,0,143,1228638
11603,0001-20091127-14-1801-1-4063,0,2009-11-27,740,車両費,ガソリン代,0,2858,1225780
11604,0001-20091127-14-1801-1-4063,1,2009-11-27,191,仮払消費税等,ガソリン代,0,142,1225638
11607,0001-20091127-15-1802-1-4065,0,2009-11-27,740,車両費,車両管理費,0,85715,1139923
11608,0001-20091127-15-1802-1-4065,1,2009-11-27,191,仮払消費税等,車両管理費,0,4285,1135638
11622,0001-20091127-39-1804-1-4069,0,2009-11-27,724,福利厚生費,会費,0,8572,1127066
11623,0001-20091127-39-1804-1-4069,1,2009-11-27,191,仮払消費税等,会費,0,428,1126638
11638,0001-20091128-27-1809-1-4079,0,2009-11-28,726,旅費交通費,旅費,0,26667,1099971
11639,0001-20091128-27-1809-1-4079,1,2009-11-28,191,仮払消費税等,旅費,0,1333,1098638
11641,0001-20091128-27-1809-1-4079,3,2009-11-28,726,旅費交通費,旅費,0,29524,1069114
11642,0001-20091128-27-1809-1-4079,4,2009-11-28,191,仮払消費税等,旅費,0,1476,1067638
11643,0001-20091128-27-1809-1-4079,5,2009-11-28,726,旅費交通費,旅費,0,21429,1046209
11644,0001-20091128-27-1809-1-4079,6,2009-11-28,191,仮払消費税等,旅費,0,1071,1045138
11646,0001-20091128-35-1810-1-4081,0,2009-11-28,739,新聞図書費,新聞代,0,3739,1041399
11647,0001-20091128-35-1810-1-4081,1,2009-11-28,191,仮払消費税等,新聞代,0,186,1041213
11688,0001-20091129-148-1819-1-4099,0,2009-11-29,740,車両費,ガソリン代,0,4762,1036451
11689,0001-20091129-148-1819-1-4099,1,2009-11-29,191,仮払消費税等,ガソリン代,0,238,1036213
11693,0001-20091129-67-1814-1-4089,1,2009-11-29,742,諸会費,会費支払い,0,30000,1006213
11695,0001-20091129-75-1815-1-4091,0,2009-11-29,733,交際接待費,飲食代　スナックわたなべ5名,0,31039,975174
11696,0001-20091129-75-1815-1-4091,1,2009-11-29,191,仮払消費税等,飲食代　スナックわたなべ5名,0,1551,973623
11707,0001-20091130-100-1837-1-4135,0,2009-11-30,724,福利厚生費,会費,0,5715,967908
11708,0001-20091130-100-1837-1-4135,1,2009-11-30,191,仮払消費税等,会費,0,285,967623
11711,0001-20091130-108-1838-1-4137,0,2009-11-30,733,交際接待費,コーヒー代　ホテルラフォーネ3名,0,2286,965337
11712,0001-20091130-108-1838-1-4137,1,2009-11-30,191,仮払消費税等,コーヒー代　ホテルラフォーネ3名,0,114,965223
11850,0001-20091130-118-1847-1-4155,1,2009-11-30,152,売掛金,09年11月30日伝票No376合同会社　エイム商事,75494,0,1040717
12037,0001-20091130-49-1824-1-4109,0,2009-11-30,740,車両費,ガソリン代,0,138096,902621
12038,0001-20091130-49-1824-1-4109,1,2009-11-30,191,仮払消費税等,ガソリン代,0,6904,895717
12047,0001-20091130-55-1825-1-4111,0,2009-11-30,740,車両費,車両管理費,0,11905,883812
12048,0001-20091130-55-1825-1-4111,1,2009-11-30,191,仮払消費税等,車両管理費,0,595,883217
12050,0001-20091130-55-1825-1-4111,3,2009-11-30,740,車両費,駐車代,0,7667,875550
12051,0001-20091130-55-1825-1-4111,4,2009-11-30,191,仮払消費税等,駐車代,0,383,875167
12064,0001-20091130-69-1828-1-4117,0,2009-11-30,791,雑費,洗剤代,0,700,874467
12065,0001-20091130-69-1828-1-4117,1,2009-11-30,191,仮払消費税等,洗剤代,0,35,874432
,,,2009-11,,※※月計※※,,2646009,2675887,
12118,0001-20091201-10-1872-1-4205,0,2009-12-01,740,車両費,洗車代,0,2858,871574
12119,0001-20091201-10-1872-1-4205,1,2009-12-01,191,仮払消費税等,洗車代,0,142,871432
12122,0001-20091201-143-1876-1-4213,0,2009-12-01,740,車両費,点検作業料,0,28000,843432
12123,0001-20091201-143-1876-1-4213,1,2009-12-01,191,仮払消費税等,点検作業料,0,1400,842032
12126,0001-20091201-18-1873-1-4207,0,2009-12-01,726,旅費交通費,旅費,0,28096,813936
12127,0001-20091201-18-1873-1-4207,1,2009-12-01,191,仮払消費税等,旅費,0,1404,812532
12130,0001-20091201-56-1874-1-4209,0,2009-12-01,726,旅費交通費,旅費,0,47620,764912
12131,0001-20091201-56-1874-1-4209,1,2009-12-01,191,仮払消費税等,旅費,0,2380,762532
12133,0001-20091201-56-1874-1-4209,3,2009-12-01,726,旅費交通費,ＪＲ代,0,40000,722532
12134,0001-20091201-56-1874-1-4209,4,2009-12-01,191,仮払消費税等,ＪＲ代,0,2000,720532
12136,0001-20091201-85-1875-1-4211,0,2009-12-01,726,旅費交通費,旅費,0,18858,701674
12137,0001-20091201-85-1875-1-4211,1,2009-12-01,191,仮払消費税等,旅費,0,942,700732
12140,0001-20091202-19-1877-1-4215,0,2009-12-02,726,旅費交通費,旅費,0,20953,679779
12141,0001-20091202-19-1877-1-4215,1,2009-12-02,191,仮払消費税等,旅費,0,1047,678732
12144,0001-20091203-134-1878-1-4217,0,2009-12-03,754,事務用消耗品費,用紙,0,13905,664827
12145,0001-20091203-134-1878-1-4217,1,2009-12-03,191,仮払消費税等,用紙,0,695,664132
12152,0001-20091204-41-1880-1-4221,0,2009-12-04,733,交際接待費,お歳暮　五越百貨店,0,69191,594941
12153,0001-20091204-41-1880-1-4221,1,2009-12-04,191,仮払消費税等,お歳暮　五越百貨店,0,3459,591482
12155,0001-20091204-41-1880-1-4221,3,2009-12-04,733,交際接待費,お歳暮　今井百貨店,0,40629,550853
12156,0001-20091204-41-1880-1-4221,4,2009-12-04,191,仮払消費税等,お歳暮　今井百貨店,0,2031,548822
12157,0001-20091204-41-1880-1-4221,5,2009-12-04,733,交際接待費,お歳暮　豊岡商店,0,15953,532869
12158,0001-20091204-41-1880-1-4221,6,2009-12-04,191,仮払消費税等,お歳暮　豊岡商店,0,797,532072
12166,0001-20091205-50-1881-1-4223,0,2009-12-05,740,車両費,高速代,0,3334,528738
12167,0001-20091205-50-1881-1-4223,1,2009-12-05,191,仮払消費税等,高速代,0,166,528572
12170,0001-20091205-86-1882-1-4225,0,2009-12-05,726,旅費交通費,ＪＲ代,0,11429,517143
12171,0001-20091205-86-1882-1-4225,1,2009-12-05,191,仮払消費税等,ＪＲ代,0,571,516572
12195,0001-20091206-106-1888-1-4237,0,2009-12-06,733,交際接待費,お歳暮　五越百貨店,0,71810,444762
12196,0001-20091206-106-1888-1-4237,1,2009-12-06,191,仮払消費税等,お歳暮　五越百貨店,0,3590,441172
12198,0001-20091206-106-1888-1-4237,3,2009-12-06,733,交際接待費,お歳暮　今井百貨店,0,40629,400543
12199,0001-20091206-106-1888-1-4237,4,2009-12-06,191,仮払消費税等,お歳暮　今井百貨店,0,2031,398512
12201,0001-20091206-110-1889-1-4239,0,2009-12-06,726,旅費交通費,タクシー代,0,2181,396331
12202,0001-20091206-110-1889-1-4239,1,2009-12-06,191,仮払消費税等,タクシー代,0,109,396222
12205,0001-20091206-159-1890-1-4241,0,2009-12-06,726,旅費交通費,タクシー代,0,10000,386222
12206,0001-20091206-159-1890-1-4241,1,2009-12-06,191,仮払消費税等,タクシー代,0,500,385722
12209,0001-20091206-87-1887-1-4235,0,2009-12-06,726,旅費交通費,タクシー代,0,4286,381436
12210,0001-20091206-87-1887-1-4235,1,2009-12-06,191,仮払消費税等,タクシー代,0,214,381222
12213,0001-20091207-102-1897-1-4255,0,2009-12-07,733,交際接待費,お歳暮　阿部商店,0,17429,363793
12214,0001-20091207-102-1897-1-4255,1,2009-12-07,191,仮払消費税等,お歳暮　阿部商店,0,871,362922
12217,0001-20091207-16-1891-1-4243,0,2009-12-07,740,車両費,ガソリン代,0,2858,360064
12218,0001-20091207-16-1891-1-4243,1,2009-12-07,191,仮払消費税等,ガソリン代,0,142,359922
12220,0001-20091207-16-1891-1-4243,3,2009-12-07,740,車両費,駐車代,0,378,359544
12221,0001-20091207-16-1891-1-4243,4,2009-12-07,191,仮払消費税等,駐車代,0,18,359526
12223,0001-20091207-20-1892-1-4245,0,2009-12-07,726,旅費交通費,旅費,0,37143,322383
12224,0001-20091207-20-1892-1-4245,1,2009-12-07,191,仮払消費税等,旅費,0,1857,320526
12227,0001-20091207-21-1893-1-4247,0,2009-12-07,726,旅費交通費,JR代,0,66191,254335
12228,0001-20091207-21-1893-1-4247,1,2009-12-07,191,仮払消費税等,JR代,0,3309,251026
12231,0001-20091207-22-1894-1-4249,0,2009-12-07,726,旅費交通費,旅費,0,47620,203406
12232,0001-20091207-22-1894-1-4249,1,2009-12-07,191,仮払消費税等,旅費,0,2380,201026
12235,0001-20091207-58-1895-1-4251,0,2009-12-07,726,旅費交通費,旅費,0,66667,134359
12236,0001-20091207-58-1895-1-4251,1,2009-12-07,191,仮払消費税等,旅費,0,3333,131026
12239,0001-20091207-69-1896-1-4253,0,2009-12-07,791,雑費,洗剤代,0,380,130646
12240,0001-20091207-69-1896-1-4253,1,2009-12-07,191,仮払消費税等,洗剤代,0,18,130628
12242,0001-20091207-69-1896-1-4253,3,2009-12-07,791,雑費,台所用品,0,2710,127918
12243,0001-20091207-69-1896-1-4253,4,2009-12-07,191,仮払消費税等,台所用品,0,135,127783
12244,0001-20091207-69-1896-1-4253,5,2009-12-07,791,雑費,洗剤代,0,856,126927
12245,0001-20091207-69-1896-1-4253,6,2009-12-07,191,仮払消費税等,洗剤代,0,42,126885
12248,0001-20091208-142-1900-1-4261,0,2009-12-08,740,車両費,高速代,0,3102,123783
12249,0001-20091208-142-1900-1-4261,1,2009-12-08,191,仮払消費税等,高速代,0,155,123628
12251,0001-20091208-142-1900-1-4261,3,2009-12-08,740,車両費,高速代,0,9373,114255
12252,0001-20091208-142-1900-1-4261,4,2009-12-08,191,仮払消費税等,高速代,0,468,113787
12253,0001-20091208-142-1900-1-4261,5,2009-12-08,740,車両費,高速代,0,3404,110383
12254,0001-20091208-142-1900-1-4261,6,2009-12-08,191,仮払消費税等,高速代,0,170,110213
12255,0001-20091208-142-1900-1-4261,7,2009-12-08,740,車両費,高速代,0,6229,103984
12256,0001-20091208-142-1900-1-4261,8,2009-12-08,191,仮払消費税等,高速代,0,311,103673
12257,0001-20091208-142-1900-1-4261,9,2009-12-08,740,車両費,高速代,0,4353,99320
12258,0001-20091208-142-1900-1-4261,10,2009-12-08,191,仮払消費税等,高速代,0,217,99103
12259,0001-20091208-142-1900-1-4261,11,2009-12-08,740,車両費,ガソリン代,0,5715,93388
12260,0001-20091208-142-1900-1-4261,12,2009-12-08,191,仮払消費税等,ガソリン代,0,285,93103
12266,0001-20091208-77-1899-1-4259,0,2009-12-08,733,交際接待費,ゴルフプレー代2名,0,14096,79007
12267,0001-20091208-77-1899-1-4259,1,2009-12-08,191,仮払消費税等,ゴルフプレー代2名,0,704,78303
12276,0001-20091209-150-1903-1-4267,0,2009-12-09,733,交際接待費,お歳暮　五越百貨店,0,61058,17245
12277,0001-20091209-150-1903-1-4267,1,2009-12-09,191,仮払消費税等,お歳暮　五越百貨店,0,3052,14193
12279,0001-20091209-150-1903-1-4267,3,2009-12-09,733,交際接待費,お歳暮　今井百貨店,0,25115,-10922
12280,0001-20091209-150-1903-1-4267,4,2009-12-09,191,仮払消費税等,お歳暮　今井百貨店,0,1255,-12177
12282,0001-20091209-44-1901-1-4263,0,2009-12-09,733,交際接待費,食事代　レストランフード3名,0,5962,-18139
12283,0001-20091209-44-1901-1-4263,1,2009-12-09,191,仮払消費税等,食事代　レストランフード3名,0,298,-18437
12300,0001-20091210-103-1918-1-4297,0,2009-12-10,733,交際接待費,コーヒー代　喫茶まどい,0,2553,-20990
12301,0001-20091210-103-1918-1-4297,1,2009-12-10,191,仮払消費税等,コーヒー代　喫茶まどい,0,127,-21117
12325,0001-20091210-162-1922-1-4305,0,2009-12-10,734,会議費,会議　食事代,0,23805,-44922
12326,0001-20091210-162-1922-1-4305,1,2009-12-10,191,仮払消費税等,会議　食事代,0,1190,-46112
12358,0001-20091210-62-1906-1-4273,1,2009-12-10,121,当座預金,引き出し,1500000,0,1453888
12394,0001-20091210-88-1912-1-4285,0,2009-12-10,726,旅費交通費,タクシー代,0,7620,1446268
12395,0001-20091210-88-1912-1-4285,1,2009-12-10,191,仮払消費税等,タクシー代,0,380,1445888
12398,0001-20091210-9-1904-1-4269,0,2009-12-10,733,交際接待費,お歳暮　もみじデパート,0,74667,1371221
12399,0001-20091210-9-1904-1-4269,1,2009-12-10,191,仮払消費税等,お歳暮　もみじデパート,0,3733,1367488
12414,0001-20091211-127-1926-1-4313,1,2009-12-11,738,租税公課,収入印紙,0,2000,1365488
12416,0001-20091211-82-1925-1-4311,0,2009-12-11,740,車両費,ガソリン代,0,4014,1361474
12417,0001-20091211-82-1925-1-4311,1,2009-12-11,191,仮払消費税等,ガソリン代,0,200,1361274
12419,0001-20091211-82-1925-1-4311,3,2009-12-11,740,車両費,高速代,0,572,1360702
12420,0001-20091211-82-1925-1-4311,4,2009-12-11,191,仮払消費税等,高速代,0,28,1360674
12422,0001-20091212-70-1927-1-4315,0,2009-12-12,733,交際接待費,お歳暮　五越百貨店,0,27267,1333407
12423,0001-20091212-70-1927-1-4315,1,2009-12-12,191,仮払消費税等,お歳暮　五越百貨店,0,1363,1332044
12425,0001-20091212-70-1927-1-4315,3,2009-12-12,733,交際接待費,お歳暮　今井百貨店,0,10953,1321091
12426,0001-20091212-70-1927-1-4315,4,2009-12-12,191,仮払消費税等,お歳暮　今井百貨店,0,547,1320544
12428,0001-20091213-11-1929-1-4319,0,2009-12-13,740,車両費,高速代,0,2667,1317877
12429,0001-20091213-11-1929-1-4319,1,2009-12-13,191,仮払消費税等,高速代,0,133,1317744
12431,0001-20091213-11-1929-1-4319,3,2009-12-13,740,車両費,ガソリン代,0,4381,1313363
12432,0001-20091213-11-1929-1-4319,4,2009-12-13,191,仮払消費税等,ガソリン代,0,219,1313144
12435,0001-20091213-141-1930-1-4321,0,2009-12-13,726,旅費交通費,JR代,0,22381,1290763
12436,0001-20091213-141-1930-1-4321,1,2009-12-13,191,仮払消費税等,JR代,0,1119,1289644
12439,0001-20091213-158-1931-1-4323,0,2009-12-13,726,旅費交通費,航空券,0,32381,1257263
12440,0001-20091213-158-1931-1-4323,1,2009-12-13,191,仮払消費税等,航空券,0,1619,1255644
12443,0001-20091213-7-1928-1-4317,0,2009-12-13,733,交際接待費,飲食代　鳥仙人3名,0,15115,1240529
12444,0001-20091213-7-1928-1-4317,1,2009-12-13,191,仮払消費税等,飲食代　鳥仙人3名,0,755,1239774
12446,0001-20091213-7-1928-1-4317,3,2009-12-13,733,交際接待費,飲食代　スナックさらら3名,0,17486,1222288
12447,0001-20091213-7-1928-1-4317,4,2009-12-13,191,仮払消費税等,飲食代　スナックさらら3名,0,874,1221414
12449,0001-20091214-23-1932-1-4325,0,2009-12-14,726,旅費交通費,旅費,0,26667,1194747
12450,0001-20091214-23-1932-1-4325,1,2009-12-14,191,仮払消費税等,旅費,0,1333,1193414
12452,0001-20091214-23-1932-1-4325,3,2009-12-14,726,旅費交通費,旅費,0,29524,1163890
12453,0001-20091214-23-1932-1-4325,4,2009-12-14,191,仮払消費税等,旅費,0,1476,1162414
12454,0001-20091214-23-1932-1-4325,5,2009-12-14,726,旅費交通費,旅費,0,36667,1125747
12455,0001-20091214-23-1932-1-4325,6,2009-12-14,191,仮払消費税等,旅費,0,1833,1123914
12457,0001-20091214-46-1933-1-4327,0,2009-12-14,740,車両費,ガソリン代,0,7429,1116485
12458,0001-20091214-46-1933-1-4327,1,2009-12-14,191,仮払消費税等,ガソリン代,0,371,1116114
12460,0001-20091214-46-1933-1-4327,3,2009-12-14,740,車両費,駐車代,0,1239,1114875
12461,0001-20091214-46-1933-1-4327,4,2009-12-14,191,仮払消費税等,駐車代,0,61,1114814
12462,0001-20091214-46-1933-1-4327,5,2009-12-14,740,車両費,高速代,0,3334,1111480
12463,0001-20091214-46-1933-1-4327,6,2009-12-14,191,仮払消費税等,高速代,0,166,1111314
12465,0001-20091214-51-1934-1-4329,0,2009-12-14,740,車両費,高速代,0,5096,1106218
12466,0001-20091214-51-1934-1-4329,1,2009-12-14,191,仮払消費税等,高速代,0,254,1105964
12468,0001-20091214-51-1934-1-4329,3,2009-12-14,740,車両費,ガソリン代,0,6381,1099583
12469,0001-20091214-51-1934-1-4329,4,2009-12-14,191,仮払消費税等,ガソリン代,0,319,1099264
12470,0001-20091214-51-1934-1-4329,5,2009-12-14,740,車両費,駐車代,0,2191,1097073
12471,0001-20091214-51-1934-1-4329,6,2009-12-14,191,仮払消費税等,駐車代,0,109,1096964
12473,0001-20091214-73-1935-1-4331,0,2009-12-14,733,交際接待費,忘年会会費,0,7620,1089344
12474,0001-20091214-73-1935-1-4331,1,2009-12-14,191,仮払消費税等,忘年会会費,0,380,1088964
12528,0001-20091215-117-1946-1-4353,1,2009-12-15,742,諸会費,会費,0,20000,1068964
12539,0001-20091215-83-1937-1-4335,0,2009-12-15,740,車両費,ガソリン代,0,6229,1062735
12540,0001-20091215-83-1937-1-4335,1,2009-12-15,191,仮払消費税等,ガソリン代,0,311,1062424
12542,0001-20091215-83-1937-1-4335,3,2009-12-15,740,車両費,高速代,0,4020,1058404
12543,0001-20091215-83-1937-1-4335,4,2009-12-15,191,仮払消費税等,高速代,0,200,1058204
12544,0001-20091215-83-1937-1-4335,5,2009-12-15,740,車両費,駐車代,0,800,1057404
12545,0001-20091215-83-1937-1-4335,6,2009-12-15,191,仮払消費税等,駐車代,0,40,1057364
12548,0001-20091215-91-1938-1-4337,1,2009-12-15,721,雑給,12月給与その他 0060 パート･アルバイト,0,400068,657296
12556,0001-20091216-136-1951-1-4363,0,2009-12-16,791,雑費,ダスキン代,0,15715,641581
12557,0001-20091216-136-1951-1-4363,1,2009-12-16,191,仮払消費税等,ダスキン代,0,785,640796
12560,0001-20091216-144-1952-1-4365,0,2009-12-16,740,車両費,ウォッシャー液代,0,572,640224
12561,0001-20091216-144-1952-1-4365,1,2009-12-16,191,仮払消費税等,ウォッシャー液代,0,28,640196
12563,0001-20091216-144-1952-1-4365,3,2009-12-16,740,車両費,ガソリン代,0,6229,633967
12564,0001-20091216-144-1952-1-4365,4,2009-12-16,191,仮払消費税等,ガソリン代,0,311,633656
12565,0001-20091216-144-1952-1-4365,5,2009-12-16,740,車両費,ガソリン代,0,8096,625560
12566,0001-20091216-144-1952-1-4365,6,2009-12-16,191,仮払消費税等,ガソリン代,0,404,625156
12568,0001-20091216-149-1953-1-4367,0,2009-12-16,733,交際接待費,忘年会会費,0,9524,615632
12569,0001-20091216-149-1953-1-4367,1,2009-12-16,191,仮払消費税等,忘年会会費,0,476,615156
12572,0001-20091216-152-1954-1-4369,0,2009-12-16,733,交際接待費,忘年会会費,0,9524,605632
12573,0001-20091216-152-1954-1-4369,1,2009-12-16,191,仮払消費税等,忘年会会費,0,476,605156
12576,0001-20091216-156-1955-1-4371,0,2009-12-16,726,旅費交通費,出張旅費,0,8191,596965
12577,0001-20091216-156-1955-1-4371,1,2009-12-16,191,仮払消費税等,出張旅費,0,409,596556
12580,0001-20091216-57-1948-1-4357,0,2009-12-16,726,旅費交通費,JR代,0,105381,491175
12581,0001-20091216-57-1948-1-4357,1,2009-12-16,191,仮払消費税等,JR代,0,5269,485906
12590,0001-20091216-74-1950-1-4361,0,2009-12-16,733,交際接待費,忘年会会費,0,9524,476382
12591,0001-20091216-74-1950-1-4361,1,2009-12-16,191,仮払消費税等,忘年会会費,0,476,475906
12594,0001-20091217-12-1956-1-4373,0,2009-12-17,740,車両費,ガソリン代,0,7473,468433
12595,0001-20091217-12-1956-1-4373,1,2009-12-17,191,仮払消費税等,ガソリン代,0,373,468060
12597,0001-20091217-12-1956-1-4373,3,2009-12-17,740,車両費,ガソリン代,0,2858,465202
12598,0001-20091217-12-1956-1-4373,4,2009-12-17,191,仮払消費税等,ガソリン代,0,142,465060
12599,0001-20091217-12-1956-1-4373,5,2009-12-17,740,車両費,ガソリン代,0,6174,458886
12600,0001-20091217-12-1956-1-4373,6,2009-12-17,191,仮払消費税等,ガソリン代,0,308,458578
12601,0001-20091217-12-1956-1-4373,7,2009-12-17,740,車両費,高速代,0,2000,456578
12602,0001-20091217-12-1956-1-4373,8,2009-12-17,191,仮払消費税等,高速代,0,100,456478
12604,0001-20091217-164-1960-1-4381,0,2009-12-17,754,事務用消耗品費,事務用品,0,11391,445087
12605,0001-20091217-164-1960-1-4381,1,2009-12-17,191,仮払消費税等,事務用品,0,569,444518
12612,0001-20091217-45-1958-1-4377,0,2009-12-17,733,交際接待費,忘年会会費2名,0,19048,425470
12613,0001-20091217-45-1958-1-4377,1,2009-12-17,191,仮払消費税等,忘年会会費2名,0,952,424518
12616,0001-20091217-52-1959-1-4379,0,2009-12-17,740,車両費,高速代,0,1096,423422
12617,0001-20091217-52-1959-1-4379,1,2009-12-17,191,仮払消費税等,高速代,0,54,423368
12619,0001-20091217-52-1959-1-4379,3,2009-12-17,740,車両費,高速代,0,1096,422272
12620,0001-20091217-52-1959-1-4379,4,2009-12-17,191,仮払消費税等,高速代,0,54,422218
12621,0001-20091217-52-1959-1-4379,5,2009-12-17,740,車両費,高速代,0,1429,420789
12622,0001-20091217-52-1959-1-4379,6,2009-12-17,191,仮払消費税等,高速代,0,71,420718
12624,0001-20091218-104-1963-1-4387,0,2009-12-18,733,交際接待費,忘年会会費,0,7620,413098
12625,0001-20091218-104-1963-1-4387,1,2009-12-18,191,仮払消費税等,忘年会会費,0,380,412718
12628,0001-20091218-153-1964-1-4389,0,2009-12-18,733,交際接待費,忘年会会費,0,7620,405098
12629,0001-20091218-153-1964-1-4389,1,2009-12-18,191,仮払消費税等,忘年会会費,0,380,404718
12632,0001-20091218-8-1961-1-4383,0,2009-12-18,733,交際接待費,定例ミーティング会費,0,19048,385670
12633,0001-20091218-8-1961-1-4383,1,2009-12-18,191,仮払消費税等,定例ミーティング会費,0,952,384718
12636,0001-20091218-86-1962-1-4385,0,2009-12-18,727,通信費,切手代,0,15239,369479
12637,0001-20091218-86-1962-1-4385,1,2009-12-18,191,仮払消費税等,切手代,0,761,368718
12640,0001-20091219-148-1969-1-4399,0,2009-12-19,740,車両費,ガソリン代,0,5040,363678
12641,0001-20091219-148-1969-1-4399,1,2009-12-19,191,仮払消費税等,ガソリン代,0,251,363427
12644,0001-20091219-47-1966-1-4393,0,2009-12-19,740,車両費,ガソリン代,0,2420,361007
12645,0001-20091219-47-1966-1-4393,1,2009-12-19,191,仮払消費税等,ガソリン代,0,120,360887
12648,0001-20091219-59-1967-1-4395,0,2009-12-19,726,旅費交通費,旅費,0,47620,313267
12649,0001-20091219-59-1967-1-4395,1,2009-12-19,191,仮払消費税等,旅費,0,2380,310887
12652,0001-20091219-6-1965-1-4391,0,2009-12-19,732,広告宣伝費,広告料,0,4762,306125
12653,0001-20091219-6-1965-1-4391,1,2009-12-19,191,仮払消費税等,広告料,0,238,305887
12656,0001-20091219-89-1968-1-4397,0,2009-12-19,726,旅費交通費,旅費,0,19048,286839
12657,0001-20091219-89-1968-1-4397,1,2009-12-19,191,仮払消費税等,旅費,0,952,285887
12671,0001-20091220-105-1982-1-4425,0,2009-12-20,733,交際接待費,忘年会会費,0,9524,276363
12672,0001-20091220-105-1982-1-4425,1,2009-12-20,191,仮払消費税等,忘年会会費,0,476,275887
12674,0001-20091220-105-1982-1-4425,3,2009-12-20,733,交際接待費,景品代　阿部商店,0,10000,265887
12675,0001-20091220-105-1982-1-4425,4,2009-12-20,191,仮払消費税等,景品代　阿部商店,0,500,265387
12678,0001-20091220-111-1983-1-4427,1,2009-12-20,152,売掛金,09年12月20日伝票No393株式会社　斉藤,1216943,0,1482330
12731,0001-20091220-163-1993-1-4447,1,2009-12-20,742,諸会費,会費,0,18000,1464330
12733,0001-20091220-24-1970-1-4401,0,2009-12-20,726,旅費交通費,JR回数券,0,78686,1385644
12734,0001-20091220-24-1970-1-4401,1,2009-12-20,191,仮払消費税等,JR回数券,0,3934,1381710
12741,0001-20091220-48-1972-1-4405,0,2009-12-20,740,車両費,ガソリン代,0,4099,1377611
12742,0001-20091220-48-1972-1-4405,1,2009-12-20,191,仮払消費税等,ガソリン代,0,204,1377407
12753,0001-20091220-75-1975-1-4411,0,2009-12-20,740,車両費,ガソリン代,0,2858,1374549
12754,0001-20091220-75-1975-1-4411,1,2009-12-20,191,仮払消費税等,ガソリン代,0,142,1374407
12756,0001-20091220-75-1975-1-4411,3,2009-12-20,740,車両費,駐車代,0,286,1374121
12757,0001-20091220-75-1975-1-4411,4,2009-12-20,191,仮払消費税等,駐車代,0,14,1374107
12758,0001-20091220-75-1975-1-4411,5,2009-12-20,740,車両費,駐車代,0,381,1373726
12759,0001-20091220-75-1975-1-4411,6,2009-12-20,191,仮払消費税等,駐車代,0,19,1373707
12784,0001-20091221-114-2001-1-4463,0,2009-12-21,739,新聞図書費,新聞代,0,2540,1371167
12785,0001-20091221-114-2001-1-4463,1,2009-12-21,191,仮払消費税等,新聞代,0,126,1371041
12787,0001-20091221-114-2001-1-4463,3,2009-12-21,739,新聞図書費,新聞代,0,2864,1368177
12788,0001-20091221-114-2001-1-4463,4,2009-12-21,191,仮払消費税等,新聞代,0,143,1368034
12791,0001-20091221-126-2002-1-4465,1,2009-12-21,738,租税公課,収入印紙,0,40000,1328034
12809,0001-20091221-25-1995-1-4451,0,2009-12-21,726,旅費交通費,旅費,0,53334,1274700
12810,0001-20091221-25-1995-1-4451,1,2009-12-21,191,仮払消費税等,旅費,0,2666,1272034
12833,0001-20091221-75-1998-1-4457,0,2009-12-21,733,交際接待費,忘年会会費,0,7620,1264414
12834,0001-20091221-75-1998-1-4457,1,2009-12-21,191,仮払消費税等,忘年会会費,0,380,1264034
12847,0001-20091221-94-2000-1-4461,0,2009-12-21,791,雑費,しめ飾り他,0,5121,1258913
12848,0001-20091221-94-2000-1-4461,1,2009-12-21,191,仮払消費税等,しめ飾り他,0,256,1258657
12851,0001-20091222-107-2013-1-4487,0,2009-12-22,733,交際接待費,忘年会会費3名,0,22858,1235799
12852,0001-20091222-107-2013-1-4487,1,2009-12-22,191,仮払消費税等,忘年会会費3名,0,1142,1234657
12860,0001-20091222-151-2015-1-4491,0,2009-12-22,733,交際接待費,忘年会会費3名,0,28572,1206085
12861,0001-20091222-151-2015-1-4491,1,2009-12-22,191,仮払消費税等,忘年会会費3名,0,1428,1204657
12864,0001-20091222-166-2016-1-4493,0,2009-12-22,791,雑費,ダスキン代,0,1800,1202857
12865,0001-20091222-166-2016-1-4493,1,2009-12-22,191,仮払消費税等,ダスキン代,0,90,1202767
12868,0001-20091222-170-2017-1-4495,0,2009-12-22,739,新聞図書費,新聞代,0,2864,1199903
12869,0001-20091222-170-2017-1-4495,1,2009-12-22,191,仮払消費税等,新聞代,0,143,1199760
12872,0001-20091222-35-2005-1-4471,0,2009-12-22,739,新聞図書費,新聞代,0,3739,1196021
12873,0001-20091222-35-2005-1-4471,1,2009-12-22,191,仮払消費税等,新聞代,0,186,1195835
12876,0001-20091222-53-2006-1-4473,0,2009-12-22,740,車両費,高速代,0,381,1195454
12877,0001-20091222-53-2006-1-4473,1,2009-12-22,191,仮払消費税等,高速代,0,19,1195435
12879,0001-20091222-53-2006-1-4473,3,2009-12-22,740,車両費,駐車代,0,1762,1193673
12880,0001-20091222-53-2006-1-4473,4,2009-12-22,191,仮払消費税等,駐車代,0,88,1193585
12882,0001-20091222-72-2007-1-4475,0,2009-12-22,739,新聞図書費,新聞代,0,2864,1190721
12883,0001-20091222-72-2007-1-4475,1,2009-12-22,191,仮払消費税等,新聞代,0,143,1190578
12885,0001-20091222-72-2007-1-4475,3,2009-12-22,739,新聞図書費,新聞代,0,2815,1187763
12886,0001-20091222-72-2007-1-4475,4,2009-12-22,191,仮払消費税等,新聞代,0,140,1187623
12887,0001-20091222-72-2007-1-4475,5,2009-12-22,739,新聞図書費,新聞代,0,3399,1184224
12888,0001-20091222-72-2007-1-4475,6,2009-12-22,191,仮払消費税等,新聞代,0,169,1184055
12889,0001-20091222-72-2007-1-4475,7,2009-12-22,791,雑費,しめ飾り、鏡もち他,0,8589,1175466
12890,0001-20091222-72-2007-1-4475,8,2009-12-22,191,仮払消費税等,しめ飾り、鏡もち他,0,429,1175037
12893,0001-20091222-74-2008-1-4477,0,2009-12-22,791,雑費,しめ飾り他,0,4465,1170572
12894,0001-20091222-74-2008-1-4477,1,2009-12-22,191,仮払消費税等,しめ飾り他,0,223,1170349
12897,0001-20091222-84-2009-1-4479,0,2009-12-22,740,車両費,ガソリン代,0,6501,1163848
12898,0001-20091222-84-2009-1-4479,1,2009-12-22,191,仮払消費税等,ガソリン代,0,325,1163523
12901,0001-20091222-88-2010-1-4481,0,2009-12-22,739,新聞図書費,新聞代,0,3399,1160124
12902,0001-20091222-88-2010-1-4481,1,2009-12-22,191,仮払消費税等,新聞代,0,169,1159955
12905,0001-20091222-90-2011-1-4483,0,2009-12-22,791,雑費,ダスキン代,0,10000,1149955
12906,0001-20091222-90-2011-1-4483,1,2009-12-22,191,仮払消費税等,ダスキン代,0,500,1149455
12913,0001-20091223-140-2022-1-4505,0,2009-12-23,726,旅費交通費,旅費,0,9400,1140055
12914,0001-20091223-140-2022-1-4505,1,2009-12-23,191,仮払消費税等,旅費,0,470,1139585
12917,0001-20091223-26-2018-1-4497,0,2009-12-23,726,旅費交通費,旅費,0,23810,1115775
12918,0001-20091223-26-2018-1-4497,1,2009-12-23,191,仮払消費税等,旅費,0,1190,1114585
12929,0001-20091223-71-2021-1-4503,0,2009-12-23,791,雑費,しめ飾り他,0,4572,1110013
12930,0001-20091223-71-2021-1-4503,1,2009-12-23,191,仮払消費税等,しめ飾り他,0,228,1109785
12951,0001-20091224-54-2024-1-4509,0,2009-12-24,740,車両費,高速代,0,1810,1107975
12952,0001-20091224-54-2024-1-4509,1,2009-12-24,191,仮払消費税等,高速代,0,90,1107885
12954,0001-20091224-54-2024-1-4509,3,2009-12-24,740,車両費,ガソリン代,0,2572,1105313
12955,0001-20091224-54-2024-1-4509,4,2009-12-24,191,仮払消費税等,ガソリン代,0,128,1105185
12998,0001-20091225-121-2041-1-4543,0,2009-12-25,724,福利厚生費,お茶代,0,17191,1087994
12999,0001-20091225-121-2041-1-4543,1,2009-12-25,191,仮払消費税等,お茶代,0,859,1087135
13006,0001-20091225-160-2043-1-4547,0,2009-12-25,726,旅費交通費,出張旅費,0,69524,1017611
13007,0001-20091225-160-2043-1-4547,1,2009-12-25,191,仮払消費税等,出張旅費,0,3476,1014135
13024,0001-20091225-79-2032-1-4525,0,2009-12-25,724,福利厚生費,景品代,0,72365,941770
13025,0001-20091225-79-2032-1-4525,1,2009-12-25,191,仮払消費税等,景品代,0,3618,938152
13028,0001-20091225-90-2033-1-4527,0,2009-12-25,726,旅費交通費,旅費,0,14286,923866
13029,0001-20091225-90-2033-1-4527,1,2009-12-25,191,仮払消費税等,旅費,0,714,923152
13219,0001-20091226-165-2050-1-4561,0,2009-12-26,791,雑費,しめ飾り代他,0,4762,918390
13220,0001-20091226-165-2050-1-4561,1,2009-12-26,191,仮払消費税等,しめ飾り代他,0,238,918152
13222,0001-20091226-165-2050-1-4561,3,2009-12-26,791,雑費,洗剤他,0,1146,917006
13223,0001-20091226-165-2050-1-4561,4,2009-12-26,191,仮払消費税等,洗剤他,0,57,916949
13225,0001-20091226-39-2045-1-4551,0,2009-12-26,724,福利厚生費,会費,0,8572,908377
13226,0001-20091226-39-2045-1-4551,1,2009-12-26,191,仮払消費税等,会費,0,428,907949
13229,0001-20091226-49-2046-1-4553,0,2009-12-26,740,車両費,ガソリン代,0,117143,790806
13230,0001-20091226-49-2046-1-4553,1,2009-12-26,191,仮払消費税等,ガソリン代,0,5857,784949
13232,0001-20091226-49-2046-1-4553,3,2009-12-26,740,車両費,駐車代,0,2620,782329
13233,0001-20091226-49-2046-1-4553,4,2009-12-26,191,仮払消費税等,駐車代,0,130,782199
13235,0001-20091226-49-2046-1-4553,6,2009-12-26,740,車両費,高速代,0,1191,781008
13236,0001-20091226-49-2046-1-4553,7,2009-12-26,191,仮払消費税等,高速代,0,59,780949
13248,0001-20091227-13-2051-1-4563,0,2009-12-27,740,車両費,ガソリン代,0,12381,768568
13249,0001-20091227-13-2051-1-4563,1,2009-12-27,191,仮払消費税等,ガソリン代,0,619,767949
13252,0001-20091227-14-2052-1-4565,0,2009-12-27,740,車両費,洗車代,0,2858,765091
13253,0001-20091227-14-2052-1-4565,1,2009-12-27,191,仮払消費税等,洗車代,0,142,764949
13256,0001-20091227-148-2054-1-4569,0,2009-12-27,740,車両費,ガソリン代,0,5422,759527
13257,0001-20091227-148-2054-1-4569,1,2009-12-27,191,仮払消費税等,ガソリン代,0,271,759256
13259,0001-20091227-148-2054-1-4569,3,2009-12-27,740,車両費,洗車代,0,1000,758256
13260,0001-20091227-148-2054-1-4569,4,2009-12-27,191,仮払消費税等,洗車代,0,50,758206
13262,0001-20091227-161-2055-1-4571,0,2009-12-27,726,旅費交通費,旅費,0,9286,748920
13263,0001-20091227-161-2055-1-4571,1,2009-12-27,191,仮払消費税等,旅費,0,464,748456
13281,0001-20091228-108-2067-1-4595,0,2009-12-28,733,交際接待費,食事代　そば屋三品3名,0,2153,746303
13282,0001-20091228-108-2067-1-4595,1,2009-12-28,191,仮払消費税等,食事代　そば屋三品3名,0,107,746196
13289,0001-20091228-27-2059-1-4579,0,2009-12-28,726,旅費交通費,旅費,0,26667,719529
13290,0001-20091228-27-2059-1-4579,1,2009-12-28,191,仮払消費税等,旅費,0,1333,718196
13292,0001-20091228-27-2059-1-4579,3,2009-12-28,726,旅費交通費,旅費,0,29524,688672
13293,0001-20091228-27-2059-1-4579,4,2009-12-28,191,仮払消費税等,旅費,0,1476,687196
13294,0001-20091228-27-2059-1-4579,5,2009-12-28,726,旅費交通費,旅費,0,21429,665767
13295,0001-20091228-27-2059-1-4579,6,2009-12-28,191,仮払消費税等,旅費,0,1071,664696
13313,0001-20091228-55-2062-1-4585,0,2009-12-28,740,車両費,車両管理費,0,11429,653267
13314,0001-20091228-55-2062-1-4585,1,2009-12-28,191,仮払消費税等,車両管理費,0,571,652696
13318,0001-20091228-67-2063-1-4587,1,2009-12-28,742,諸会費,会費支払い,0,30000,622696
13324,0001-20091228-83-2065-1-4591,0,2009-12-28,740,車両費,車両管理費,0,48762,573934
13325,0001-20091228-83-2065-1-4591,1,2009-12-28,191,仮払消費税等,車両管理費,0,2438,571496
13327,0001-20091228-83-2065-1-4591,3,2009-12-28,740,車両費,ガソリン代,0,18573,552923
13328,0001-20091228-83-2065-1-4591,4,2009-12-28,191,仮払消費税等,ガソリン代,0,928,551995
13350,0001-20091230-100-2072-1-4605,0,2009-12-30,724,福利厚生費,会費,0,5715,546280
13351,0001-20091230-100-2072-1-4605,1,2009-12-30,191,仮払消費税等,会費,0,285,545995
13364,0001-20091230-128-2075-1-4611,1,2009-12-30,738,租税公課,収入印紙,0,10000,535995
13380,0001-20091230-138-2077-1-4615,0,2009-12-30,740,車両費,駐車場代,0,3410,532585
13381,0001-20091230-138-2077-1-4615,1,2009-12-30,191,仮払消費税等,駐車場代,0,170,532415
13383,0001-20091230-138-2077-1-4615,3,2009-12-30,740,車両費,高速代,0,2524,529891
13384,0001-20091230-138-2077-1-4615,4,2009-12-30,191,仮払消費税等,高速代,0,126,529765
13385,0001-20091230-138-2077-1-4615,5,2009-12-30,740,車両費,高速代,0,3667,526098
13386,0001-20091230-138-2077-1-4615,6,2009-12-30,191,仮払消費税等,高速代,0,183,525915
13387,0001-20091230-138-2077-1-4615,7,2009-12-30,740,車両費,高速代,0,1096,524819
13388,0001-20091230-138-2077-1-4615,8,2009-12-30,191,仮払消費税等,高速代,0,54,524765
13389,0001-20091230-138-2077-1-4615,9,2009-12-30,740,車両費,高速代,0,3000,521765
13390,0001-20091230-138-2077-1-4615,10,2009-12-30,191,仮払消費税等,高速代,0,150,521615
13391,0001-20091230-138-2077-1-4615,11,2009-12-30,740,車両費,高速代,0,1096,520519
13392,0001-20091230-138-2077-1-4615,12,2009-12-30,191,仮払消費税等,高速代,0,54,520465
13393,0001-20091230-138-2077-1-4615,13,2009-12-30,740,車両費,ガソリン代,0,3810,516655
13394,0001-20091230-138-2077-1-4615,14,2009-12-30,191,仮払消費税等,ガソリン代,0,190,516465
13396,0001-20091230-155-2078-1-4617,0,2009-12-30,740,車両費,車両管理費,0,23810,492655
13397,0001-20091230-155-2078-1-4617,1,2009-12-30,191,仮払消費税等,車両管理費,0,1190,491465
13532,0001-20091231-128-2092-1-4645,1,2009-12-31,152,売掛金,09年12月31日伝票No402合同会社　エイム商事,539879,0,1031344
,,,2009-12,,※※月計※※,,3256822,3099910,
13744,0001-20100101-18-2114-1-4689,0,2010-01-01,726,旅費交通費,旅費,0,18572,1012772
13745,0001-20100101-18-2114-1-4689,1,2010-01-01,191,仮払消費税等,旅費,0,928,1011844
13748,0001-20100102-19-2115-1-4691,0,2010-01-02,726,旅費交通費,旅費,0,10477,1001367
13749,0001-20100102-19-2115-1-4691,1,2010-01-02,191,仮払消費税等,旅費,0,523,1000844
13768,0001-20100105-143-2122-1-4705,0,2010-01-05,740,車両費,点検作業料,0,29715,971129
13769,0001-20100105-143-2122-1-4705,1,2010-01-05,191,仮払消費税等,点検作業料,0,1485,969644
13793,0001-20100106-110-2123-1-4707,0,2010-01-06,726,旅費交通費,タクシー代,0,2181,967463
13794,0001-20100106-110-2123-1-4707,1,2010-01-06,191,仮払消費税等,タクシー代,0,109,967354
13797,0001-20100106-123-2124-1-4709,0,2010-01-06,727,通信費,切手代,0,7620,959734
13798,0001-20100106-123-2124-1-4709,1,2010-01-06,191,仮払消費税等,切手代,0,380,959354
13802,0001-20100106-124-2125-1-4711,1,2010-01-06,738,租税公課,収入印紙,0,2000,957354
13804,0001-20100107-102-2130-1-4721,0,2010-01-07,733,交際接待費,差し入れ,0,1000,956354
13805,0001-20100107-102-2130-1-4721,1,2010-01-07,191,仮払消費税等,差し入れ,0,50,956304
13808,0001-20100107-106-2131-1-4723,0,2010-01-07,733,交際接待費,新年会会費2名,0,19048,937256
13809,0001-20100107-106-2131-1-4723,1,2010-01-07,191,仮払消費税等,新年会会費2名,0,952,936304
13818,0001-20100107-20-2127-1-4715,0,2010-01-07,726,旅費交通費,旅費,0,37143,899161
13819,0001-20100107-20-2127-1-4715,1,2010-01-07,191,仮払消費税等,旅費,0,1857,897304
13822,0001-20100107-21-2128-1-4717,0,2010-01-07,726,旅費交通費,JR代,0,66191,831113
13823,0001-20100107-21-2128-1-4717,1,2010-01-07,191,仮払消費税等,JR代,0,3309,827804
13826,0001-20100107-22-2129-1-4719,0,2010-01-07,726,旅費交通費,旅費,0,47620,780184
13827,0001-20100107-22-2129-1-4719,1,2010-01-07,191,仮払消費税等,旅費,0,2380,777804
13830,0001-20100107-7-2126-1-4713,0,2010-01-07,733,交際接待費,新年会会費　エイム,0,9524,768280
13831,0001-20100107-7-2126-1-4713,1,2010-01-07,191,仮払消費税等,新年会会費　エイム,0,476,767804
13834,0001-20100108-150-2137-1-4735,0,2010-01-08,733,交際接待費,新年会会費2名,0,15239,752565
13835,0001-20100108-150-2137-1-4735,1,2010-01-08,191,仮払消費税等,新年会会費2名,0,761,751804
13838,0001-20100108-45-2133-1-4727,0,2010-01-08,733,交際接待費,新年会会費,0,11429,740375
13839,0001-20100108-45-2133-1-4727,1,2010-01-08,191,仮払消費税等,新年会会費,0,571,739804
13842,0001-20100108-50-2134-1-4729,0,2010-01-08,740,車両費,高速代,0,1143,738661
13843,0001-20100108-50-2134-1-4729,1,2010-01-08,191,仮払消費税等,高速代,0,57,738604
13846,0001-20100108-75-2135-1-4731,0,2010-01-08,733,交際接待費,飲食代　スナックランディ,0,25220,713384
13847,0001-20100108-75-2135-1-4731,1,2010-01-08,191,仮払消費税等,飲食代　スナックランディ,0,1260,712124
13850,0001-20100108-79-2136-1-4733,0,2010-01-08,724,福利厚生費,景品代,0,37684,674440
13851,0001-20100108-79-2136-1-4733,1,2010-01-08,191,仮払消費税等,景品代,0,1884,672556
13871,0001-20100110-142-2155-1-4771,0,2010-01-10,740,車両費,高速代,0,3382,669174
13872,0001-20100110-142-2155-1-4771,1,2010-01-10,191,仮払消費税等,高速代,0,169,669005
13874,0001-20100110-142-2155-1-4771,3,2010-01-10,740,車両費,駐車代,0,5343,663662
13875,0001-20100110-142-2155-1-4771,4,2010-01-10,191,仮払消費税等,駐車代,0,267,663395
13876,0001-20100110-142-2155-1-4771,5,2010-01-10,740,車両費,高速代,0,2223,661172
13877,0001-20100110-142-2155-1-4771,6,2010-01-10,191,仮払消費税等,高速代,0,111,661061
13878,0001-20100110-142-2155-1-4771,7,2010-01-10,740,車両費,高速代,0,4306,656755
13879,0001-20100110-142-2155-1-4771,8,2010-01-10,191,仮払消費税等,高速代,0,215,656540
13880,0001-20100110-142-2155-1-4771,9,2010-01-10,740,車両費,高速代,0,429,656111
13881,0001-20100110-142-2155-1-4771,10,2010-01-10,191,仮払消費税等,高速代,0,21,656090
13883,0001-20100110-149-2156-1-4773,0,2010-01-10,733,交際接待費,新年会会費,0,11429,644661
13884,0001-20100110-149-2156-1-4773,1,2010-01-10,191,仮払消費税等,新年会会費,0,571,644090
13887,0001-20100110-152-2157-1-4775,0,2010-01-10,733,交際接待費,新年会会費,0,9524,634566
13888,0001-20100110-152-2157-1-4775,1,2010-01-10,191,仮払消費税等,新年会会費,0,476,634090
13891,0001-20100110-159-2158-1-4777,0,2010-01-10,726,旅費交通費,タクシー代,0,4000,630090
13892,0001-20100110-159-2158-1-4777,1,2010-01-10,191,仮払消費税等,タクシー代,0,200,629890
13895,0001-20100110-16-2140-1-4741,0,2010-01-10,740,車両費,高速代,0,381,629509
13896,0001-20100110-16-2140-1-4741,1,2010-01-10,191,仮払消費税等,高速代,0,19,629490
13898,0001-20100110-16-2140-1-4741,3,2010-01-10,740,車両費,駐車代,0,762,628728
13899,0001-20100110-16-2140-1-4741,4,2010-01-10,191,仮払消費税等,駐車代,0,38,628690
13901,0001-20100110-162-2159-1-4779,0,2010-01-10,734,会議費,会議　食事代,0,23805,604885
13902,0001-20100110-162-2159-1-4779,1,2010-01-10,191,仮払消費税等,会議　食事代,0,1190,603695
13911,0001-20100110-42-2141-1-4743,0,2010-01-10,733,交際接待費,年始挨拶手土産品　五越百貨店,0,23105,580590
13912,0001-20100110-42-2141-1-4743,1,2010-01-10,191,仮払消費税等,年始挨拶手土産品　五越百貨店,0,1155,579435
13915,0001-20100110-44-2142-1-4745,0,2010-01-10,733,交際接待費,新年会会費,0,11429,568006
13916,0001-20100110-44-2142-1-4745,1,2010-01-10,191,仮払消費税等,新年会会費,0,571,567435
13919,0001-20100110-56-2143-1-4747,0,2010-01-10,726,旅費交通費,旅費,0,18858,548577
13920,0001-20100110-56-2143-1-4747,1,2010-01-10,191,仮払消費税等,旅費,0,942,547635
13924,0001-20100110-62-2144-1-4749,1,2010-01-10,121,当座預金,引き出し,1000000,0,1547635
13944,0001-20100110-71-2147-1-4755,0,2010-01-10,791,雑費,お茶他,0,3005,1544630
13945,0001-20100110-71-2147-1-4755,1,2010-01-10,191,仮払消費税等,お茶他,0,150,1544480
14022,0001-20100111-73-2164-1-4789,0,2010-01-11,733,交際接待費,新年会会費2名,0,15239,1529241
14023,0001-20100111-73-2164-1-4789,1,2010-01-11,191,仮払消費税等,新年会会費2名,0,761,1528480
14030,0001-20100111-94-2166-1-4793,0,2010-01-11,791,雑費,お茶代他,0,1940,1526540
14031,0001-20100111-94-2166-1-4793,1,2010-01-11,191,仮払消費税等,お茶代他,0,96,1526444
14034,0001-20100112-151-2173-1-4807,0,2010-01-12,733,交際接待費,飲食代　居酒屋佐助4名,0,17755,1508689
14035,0001-20100112-151-2173-1-4807,1,2010-01-12,191,仮払消費税等,飲食代　居酒屋佐助4名,0,887,1507802
14038,0001-20100112-153-2174-1-4809,0,2010-01-12,733,交際接待費,新年会会費2名,0,15239,1492563
14039,0001-20100112-153-2174-1-4809,1,2010-01-12,191,仮払消費税等,新年会会費2名,0,761,1491802
14042,0001-20100112-43-2171-1-4803,0,2010-01-12,733,交際接待費,コーヒー代3名,0,1500,1490302
14043,0001-20100112-43-2171-1-4803,1,2010-01-12,191,仮払消費税等,コーヒー代3名,0,75,1490227
14046,0001-20100112-57-2172-1-4805,0,2010-01-12,726,旅費交通費,JR代,0,100639,1389588
14047,0001-20100112-57-2172-1-4805,1,2010-01-12,191,仮払消費税等,JR代,0,5031,1384557
14050,0001-20100112-9-2170-1-4801,0,2010-01-12,733,交際接待費,新年会会費　たかだ,0,6667,1377890
14051,0001-20100112-9-2170-1-4801,1,2010-01-12,191,仮払消費税等,新年会会費　たかだ,0,333,1377557
14054,0001-20100113-11-2175-1-4811,0,2010-01-13,740,車両費,ガソリン代,0,3058,1374499
14055,0001-20100113-11-2175-1-4811,1,2010-01-13,191,仮払消費税等,ガソリン代,0,152,1374347
14058,0001-20100113-17-2176-1-4813,0,2010-01-13,740,車両費,駐車代,0,286,1374061
14059,0001-20100113-17-2176-1-4813,1,2010-01-13,191,仮払消費税等,駐車代,0,14,1374047
14061,0001-20100113-17-2176-1-4813,3,2010-01-13,740,車両費,駐車代,0,762,1373285
14062,0001-20100113-17-2176-1-4813,4,2010-01-13,191,仮払消費税等,駐車代,0,38,1373247
14064,0001-20100114-23-2177-1-4815,0,2010-01-14,726,旅費交通費,旅費,0,26667,1346580
14065,0001-20100114-23-2177-1-4815,1,2010-01-14,191,仮払消費税等,旅費,0,1333,1345247
14067,0001-20100114-23-2177-1-4815,3,2010-01-14,726,旅費交通費,旅費,0,29524,1315723
14068,0001-20100114-23-2177-1-4815,4,2010-01-14,191,仮払消費税等,旅費,0,1476,1314247
14069,0001-20100114-23-2177-1-4815,5,2010-01-14,726,旅費交通費,旅費,0,36667,1277580
14070,0001-20100114-23-2177-1-4815,6,2010-01-14,191,仮払消費税等,旅費,0,1833,1275747
14072,0001-20100114-46-2178-1-4817,0,2010-01-14,740,車両費,ガソリン代,0,2341,1273406
14073,0001-20100114-46-2178-1-4817,1,2010-01-14,191,仮払消費税等,ガソリン代,0,117,1273289
14075,0001-20100114-46-2178-1-4817,3,2010-01-14,740,車両費,ガソリン代,0,4767,1268522
14076,0001-20100114-46-2178-1-4817,4,2010-01-14,191,仮払消費税等,ガソリン代,0,238,1268284
14077,0001-20100114-46-2178-1-4817,5,2010-01-14,740,車両費,ガソリン代,0,4880,1263404
14078,0001-20100114-46-2178-1-4817,6,2010-01-14,191,仮払消費税等,ガソリン代,0,244,1263160
14080,0001-20100114-51-2179-1-4819,0,2010-01-14,740,車両費,高速代,0,1505,1261655
14081,0001-20100114-51-2179-1-4819,1,2010-01-14,191,仮払消費税等,高速代,0,75,1261580
14083,0001-20100114-51-2179-1-4819,3,2010-01-14,740,車両費,高速代,0,620,1260960
14084,0001-20100114-51-2179-1-4819,4,2010-01-14,191,仮払消費税等,高速代,0,30,1260930
14085,0001-20100114-51-2179-1-4819,5,2010-01-14,740,車両費,高速代,0,810,1260120
14086,0001-20100114-51-2179-1-4819,6,2010-01-14,191,仮払消費税等,高速代,0,40,1260080
14087,0001-20100114-51-2179-1-4819,7,2010-01-14,740,車両費,高速代,0,1096,1258984
14088,0001-20100114-51-2179-1-4819,8,2010-01-14,191,仮払消費税等,高速代,0,54,1258930
14089,0001-20100114-51-2179-1-4819,9,2010-01-14,740,車両費,高速代,0,1096,1257834
14090,0001-20100114-51-2179-1-4819,10,2010-01-14,191,仮払消費税等,高速代,0,54,1257780
14091,0001-20100114-51-2179-1-4819,11,2010-01-14,740,車両費,高速代,0,1096,1256684
14092,0001-20100114-51-2179-1-4819,12,2010-01-14,191,仮払消費税等,高速代,0,54,1256630
14093,0001-20100114-51-2179-1-4819,13,2010-01-14,740,車両費,高速代,0,953,1255677
14094,0001-20100114-51-2179-1-4819,14,2010-01-14,191,仮払消費税等,高速代,0,47,1255630
14115,0001-20100115-103-2192-1-4845,0,2010-01-15,733,交際接待費,コーヒー代2名,0,1200,1254430
14116,0001-20100115-103-2192-1-4845,1,2010-01-15,191,仮払消費税等,コーヒー代2名,0,60,1254370
14128,0001-20100115-156-2195-1-4851,0,2010-01-15,726,旅費交通費,出張旅費,0,7334,1247036
14129,0001-20100115-156-2195-1-4851,1,2010-01-15,191,仮払消費税等,出張旅費,0,366,1246670
14132,0001-20100115-165-2196-1-4853,0,2010-01-15,791,雑費,電池代他,0,960,1245710
14133,0001-20100115-165-2196-1-4853,1,2010-01-15,191,仮払消費税等,電池代他,0,47,1245663
14140,0001-20100115-58-2182-1-4825,0,2010-01-15,726,旅費交通費,旅費,0,81905,1163758
14141,0001-20100115-58-2182-1-4825,1,2010-01-15,191,仮払消費税等,旅費,0,4095,1159663
14144,0001-20100115-81-2183-1-4827,0,2010-01-15,726,旅費交通費,ＪＲ代,0,11429,1148234
14145,0001-20100115-81-2183-1-4827,1,2010-01-15,191,仮払消費税等,ＪＲ代,0,571,1147663
14149,0001-20100115-84-2184-1-4829,1,2010-01-15,721,雑給,1月給与その他 0060 パート･アルバイト,0,303937,843726
14195,0001-20100116-117-2199-1-4859,1,2010-01-16,742,諸会費,会費,0,20000,823726
14197,0001-20100116-136-2200-1-4861,0,2010-01-16,791,雑費,ダスキン代,0,15715,808011
14198,0001-20100116-136-2200-1-4861,1,2010-01-16,191,仮払消費税等,ダスキン代,0,785,807226
14207,0001-20100116-73-2197-1-4855,0,2010-01-16,733,交際接待費,ゴルフプレー代2名,0,26667,780559
14208,0001-20100116-73-2197-1-4855,1,2010-01-16,191,仮払消費税等,ゴルフプレー代2名,0,1333,779226
14211,0001-20100116-74-2198-1-4857,0,2010-01-16,733,交際接待費,新年会会費,0,9524,769702
14212,0001-20100116-74-2198-1-4857,1,2010-01-16,191,仮払消費税等,新年会会費,0,476,769226
14215,0001-20100117-104-2204-1-4869,0,2010-01-17,733,交際接待費,手土産代　阿部商店,0,2000,767226
14216,0001-20100117-104-2204-1-4869,1,2010-01-17,191,仮払消費税等,手土産代　阿部商店,0,100,767126
14219,0001-20100117-47-2202-1-4865,0,2010-01-17,740,車両費,ガソリン代,0,2420,764706
14220,0001-20100117-47-2202-1-4865,1,2010-01-17,191,仮払消費税等,ガソリン代,0,120,764586
14223,0001-20100117-52-2203-1-4867,0,2010-01-17,740,車両費,高速代,0,1096,763490
14224,0001-20100117-52-2203-1-4867,1,2010-01-17,191,仮払消費税等,高速代,0,54,763436
14226,0001-20100117-52-2203-1-4867,3,2010-01-17,740,車両費,高速代,0,1096,762340
14227,0001-20100117-52-2203-1-4867,4,2010-01-17,191,仮払消費税等,高速代,0,54,762286
14228,0001-20100117-52-2203-1-4867,5,2010-01-17,740,車両費,高速代,0,1429,760857
14229,0001-20100117-52-2203-1-4867,6,2010-01-17,191,仮払消費税等,高速代,0,71,760786
14231,0001-20100118-148-2207-1-4875,0,2010-01-18,740,車両費,ガソリン代,0,6613,754173
14232,0001-20100118-148-2207-1-4875,1,2010-01-18,191,仮払消費税等,ガソリン代,0,330,753843
14234,0001-20100118-148-2207-1-4875,3,2010-01-18,740,車両費,高速代,0,620,753223
14235,0001-20100118-148-2207-1-4875,4,2010-01-18,191,仮払消費税等,高速代,0,30,753193
14237,0001-20100118-68-2205-1-4871,0,2010-01-18,733,交際接待費,飲食代　居酒屋田舎3名,0,11128,742065
14238,0001-20100118-68-2205-1-4871,1,2010-01-18,191,仮払消費税等,飲食代　居酒屋田舎3名,0,556,741509
14241,0001-20100118-82-2206-1-4873,0,2010-01-18,726,旅費交通費,タクシー代,0,4762,736747
14242,0001-20100118-82-2206-1-4873,1,2010-01-18,191,仮払消費税等,タクシー代,0,238,736509
14245,0001-20100119-105-2209-1-4879,0,2010-01-19,733,交際接待費,飲食代　和食ダイニング彩6名,0,23372,713137
14246,0001-20100119-105-2209-1-4879,1,2010-01-19,191,仮払消費税等,飲食代　和食ダイニング彩6名,0,1168,711969
14248,0001-20100119-105-2209-1-4879,3,2010-01-19,733,交際接待費,飲食代　スナック北新地,0,39096,672873
14249,0001-20100119-105-2209-1-4879,4,2010-01-19,191,仮払消費税等,飲食代　スナック北新地,0,1954,670919
14250,0001-20100119-105-2209-1-4879,5,2010-01-19,733,交際接待費,飲食代　スナック寺地,0,21334,649585
14251,0001-20100119-105-2209-1-4879,6,2010-01-19,191,仮払消費税等,飲食代　スナック寺地,0,1066,648519
14253,0001-20100119-69-2208-1-4877,0,2010-01-19,791,雑費,お茶代他,0,2616,645903
14254,0001-20100119-69-2208-1-4877,1,2010-01-19,191,仮払消費税等,お茶代他,0,130,645773
14262,0001-20100120-102-2227-1-4915,1,2010-01-20,152,売掛金,10年1月20日伝票No419株式会社　斉藤,1241111,0,1886884
14301,0001-20100120-12-2211-1-4883,0,2010-01-20,740,車両費,ガソリン代,0,4762,1882122
14302,0001-20100120-12-2211-1-4883,1,2010-01-20,191,仮払消費税等,ガソリン代,0,238,1881884
14304,0001-20100120-12-2211-1-4883,3,2010-01-20,740,車両費,ガソリン代,0,4431,1877453
14305,0001-20100120-12-2211-1-4883,4,2010-01-20,191,仮払消費税等,ガソリン代,0,221,1877232
14321,0001-20100120-144-2237-1-4935,0,2010-01-20,740,車両費,ガソリン代,0,4351,1872881
14322,0001-20100120-144-2237-1-4935,1,2010-01-20,191,仮払消費税等,ガソリン代,0,217,1872664
14324,0001-20100120-144-2237-1-4935,3,2010-01-20,740,車両費,ガソリン代,0,7162,1865502
14325,0001-20100120-144-2237-1-4935,4,2010-01-20,191,仮払消費税等,ガソリン代,0,358,1865144
14326,0001-20100120-144-2237-1-4935,5,2010-01-20,740,車両費,ガソリン代,0,305,1864839
14327,0001-20100120-144-2237-1-4935,6,2010-01-20,191,仮払消費税等,ガソリン代,0,15,1864824
14337,0001-20100120-24-2212-1-4885,0,2010-01-20,726,旅費交通費,JR回数券,0,78686,1786138
14338,0001-20100120-24-2212-1-4885,1,2010-01-20,191,仮払消費税等,JR回数券,0,3934,1782204
14353,0001-20100120-48-2215-1-4891,0,2010-01-20,740,車両費,ガソリン代,0,4099,1778105
14354,0001-20100120-48-2215-1-4891,1,2010-01-20,191,仮払消費税等,ガソリン代,0,204,1777901
14357,0001-20100120-53-2216-1-4893,0,2010-01-20,740,車両費,高速代,0,381,1777520
14358,0001-20100120-53-2216-1-4893,1,2010-01-20,191,仮払消費税等,高速代,0,19,1777501
14360,0001-20100120-53-2216-1-4893,3,2010-01-20,740,車両費,高速代,0,1000,1776501
14361,0001-20100120-53-2216-1-4893,4,2010-01-20,191,仮払消費税等,高速代,0,50,1776451
14362,0001-20100120-53-2216-1-4893,5,2010-01-20,740,車両費,高速代,0,1000,1775451
14363,0001-20100120-53-2216-1-4893,6,2010-01-20,191,仮払消費税等,高速代,0,50,1775401
14365,0001-20100120-6-2210-1-4881,0,2010-01-20,732,広告宣伝費,広告料,0,4762,1770639
14366,0001-20100120-6-2210-1-4881,1,2010-01-20,191,仮払消費税等,広告料,0,238,1770401
14422,0001-20100121-126-2243-1-4947,1,2010-01-21,738,租税公課,収入印紙,0,2000,1768401
14424,0001-20100121-160-2244-1-4949,0,2010-01-21,726,旅費交通費,出張旅費,0,66667,1701734
14425,0001-20100121-160-2244-1-4949,1,2010-01-21,191,仮払消費税等,出張旅費,0,3333,1698401
14429,0001-20100121-163-2245-1-4951,1,2010-01-21,742,諸会費,会費,0,18000,1680401
14431,0001-20100121-25-2240-1-4941,0,2010-01-21,726,旅費交通費,旅費,0,53334,1627067
14432,0001-20100121-25-2240-1-4941,1,2010-01-21,191,仮払消費税等,旅費,0,2666,1624401
14435,0001-20100121-69-2241-1-4943,0,2010-01-21,791,雑費,お茶代他,0,2275,1622126
14436,0001-20100121-69-2241-1-4943,1,2010-01-21,191,仮払消費税等,お茶代他,0,113,1622013
14439,0001-20100121-8-2239-1-4939,0,2010-01-21,733,交際接待費,定例ミーティング会費,0,19048,1602965
14440,0001-20100121-8-2239-1-4939,1,2010-01-21,191,仮払消費税等,定例ミーティング会費,0,952,1602013
14447,0001-20100122-138-2249-1-4959,0,2010-01-22,740,車両費,駐車代,0,4430,1597583
14448,0001-20100122-138-2249-1-4959,1,2010-01-22,191,仮払消費税等,駐車代,0,221,1597362
14450,0001-20100122-138-2249-1-4959,3,2010-01-22,740,車両費,高速代,0,8115,1589247
14451,0001-20100122-138-2249-1-4959,4,2010-01-22,191,仮払消費税等,高速代,0,405,1588842
14452,0001-20100122-138-2249-1-4959,5,2010-01-22,740,車両費,高速代,0,1166,1587676
14453,0001-20100122-138-2249-1-4959,6,2010-01-22,191,仮払消費税等,高速代,0,58,1587618
14454,0001-20100122-138-2249-1-4959,7,2010-01-22,740,車両費,高速代,0,6230,1581388
14455,0001-20100122-138-2249-1-4959,8,2010-01-22,191,仮払消費税等,高速代,0,311,1581077
14456,0001-20100122-138-2249-1-4959,9,2010-01-22,740,車両費,高速代,0,2140,1578937
14457,0001-20100122-138-2249-1-4959,10,2010-01-22,191,仮払消費税等,高速代,0,107,1578830
14458,0001-20100122-138-2249-1-4959,11,2010-01-22,740,車両費,ガソリン代,0,9059,1569771
14459,0001-20100122-138-2249-1-4959,12,2010-01-22,191,仮払消費税等,ガソリン代,0,452,1569319
14461,0001-20100122-161-2250-1-4961,0,2010-01-22,726,旅費交通費,旅費,0,6915,1562404
14462,0001-20100122-161-2250-1-4961,1,2010-01-22,191,仮払消費税等,旅費,0,345,1562059
14465,0001-20100122-166-2251-1-4963,0,2010-01-22,791,雑費,ダスキン代,0,1800,1560259
14466,0001-20100122-166-2251-1-4963,1,2010-01-22,191,仮払消費税等,ダスキン代,0,90,1560169
14473,0001-20100122-90-2247-1-4955,0,2010-01-22,791,雑費,ダスキン代,0,10000,1550169
14474,0001-20100122-90-2247-1-4955,1,2010-01-22,191,仮払消費税等,ダスキン代,0,500,1549669
14481,0001-20100123-140-2255-1-4971,0,2010-01-23,726,旅費交通費,旅費,0,4734,1544935
14482,0001-20100123-140-2255-1-4971,1,2010-01-23,191,仮払消費税等,旅費,0,236,1544699
14485,0001-20100123-158-2256-1-4973,0,2010-01-23,726,旅費交通費,出張旅費,0,9048,1535651
14486,0001-20100123-158-2256-1-4973,1,2010-01-23,191,仮払消費税等,出張旅費,0,452,1535199
14489,0001-20100123-26-2252-1-4965,0,2010-01-23,726,旅費交通費,旅費,0,10477,1524722
14490,0001-20100123-26-2252-1-4965,1,2010-01-23,191,仮払消費税等,旅費,0,523,1524199
14497,0001-20100123-54-2254-1-4969,0,2010-01-23,740,車両費,高速代,0,1810,1522389
14498,0001-20100123-54-2254-1-4969,1,2010-01-23,191,仮払消費税等,高速代,0,90,1522299
14500,0001-20100123-54-2254-1-4969,3,2010-01-23,740,車両費,高速代,0,2572,1519727
14501,0001-20100123-54-2254-1-4969,4,2010-01-23,191,仮払消費税等,高速代,0,128,1519599
14503,0001-20100124-108-2257-1-4975,0,2010-01-24,733,交際接待費,コーヒー代2名,0,1296,1518303
14504,0001-20100124-108-2257-1-4975,1,2010-01-24,191,仮払消費税等,コーヒー代2名,0,64,1518239
14507,0001-20100124-114-2258-1-4977,0,2010-01-24,739,新聞図書費,新聞代,0,2540,1515699
14508,0001-20100124-114-2258-1-4977,1,2010-01-24,191,仮払消費税等,新聞代,0,126,1515573
14510,0001-20100124-114-2258-1-4977,3,2010-01-24,739,新聞図書費,新聞代,0,2864,1512709
14511,0001-20100124-114-2258-1-4977,4,2010-01-24,191,仮払消費税等,新聞代,0,143,1512566
14530,0001-20100124-137-2260-1-4981,11,2010-01-24,740,車両費,ガソリン代,0,12582,1499984
14531,0001-20100124-137-2260-1-4981,12,2010-01-24,191,仮払消費税等,ガソリン代,0,629,1499355
14538,0001-20100124-155-2262-1-4985,0,2010-01-24,740,車両費,ガソリン代,0,6761,1492594
14539,0001-20100124-155-2262-1-4985,1,2010-01-24,191,仮払消費税等,ガソリン代,0,338,1492256
14593,0001-20100125-72-2264-1-4989,0,2010-01-25,739,新聞図書費,新聞代,0,2864,1489392
14594,0001-20100125-72-2264-1-4989,1,2010-01-25,191,仮払消費税等,新聞代,0,143,1489249
14596,0001-20100125-72-2264-1-4989,3,2010-01-25,739,新聞図書費,新聞代,0,2815,1486434
14597,0001-20100125-72-2264-1-4989,4,2010-01-25,191,仮払消費税等,新聞代,0,140,1486294
14598,0001-20100125-72-2264-1-4989,5,2010-01-25,739,新聞図書費,新聞代,0,3399,1482895
14599,0001-20100125-72-2264-1-4989,6,2010-01-25,191,仮払消費税等,新聞代,0,169,1482726
14716,0001-20100125-88-2266-1-4993,0,2010-01-25,739,新聞図書費,新聞代,0,3399,1479327
14717,0001-20100125-88-2266-1-4993,1,2010-01-25,191,仮払消費税等,新聞代,0,169,1479158
14721,0001-20100126-107-2279-1-5019,1,2010-01-26,733,交際接待費,出産祝い,0,10000,1469158
14739,0001-20100126-59-2276-1-5013,0,2010-01-26,726,旅費交通費,旅費,0,40000,1429158
14740,0001-20100126-59-2276-1-5013,1,2010-01-26,191,仮払消費税等,旅費,0,2000,1427158
14753,0001-20100127-121-2285-1-5031,0,2010-01-27,724,福利厚生費,お茶代,0,10572,1416586
14754,0001-20100127-121-2285-1-5031,1,2010-01-27,191,仮払消費税等,お茶代,0,528,1416058
14757,0001-20100127-14-2281-1-5023,0,2010-01-27,740,車両費,ガソリン代,0,2858,1413200
14758,0001-20100127-14-2281-1-5023,1,2010-01-27,191,仮払消費税等,ガソリン代,0,142,1413058
14761,0001-20100127-170-2286-1-5033,0,2010-01-27,739,新聞図書費,新聞代,0,2864,1410194
14762,0001-20100127-170-2286-1-5033,1,2010-01-27,191,仮払消費税等,新聞代,0,143,1410051
14774,0001-20100127-39-2284-1-5029,0,2010-01-27,724,福利厚生費,会費,0,8572,1401479
14775,0001-20100127-39-2284-1-5029,1,2010-01-27,191,仮払消費税等,会費,0,428,1401051
14778,0001-20100128-13-2287-1-5035,0,2010-01-28,740,車両費,タイヤ交換代,0,2400,1398651
14779,0001-20100128-13-2287-1-5035,1,2010-01-28,191,仮払消費税等,タイヤ交換代,0,120,1398531
14782,0001-20100128-27-2288-1-5037,0,2010-01-28,726,旅費交通費,旅費,0,26667,1371864
14783,0001-20100128-27-2288-1-5037,1,2010-01-28,191,仮払消費税等,旅費,0,1333,1370531
14785,0001-20100128-27-2288-1-5037,3,2010-01-28,726,旅費交通費,旅費,0,29524,1341007
14786,0001-20100128-27-2288-1-5037,4,2010-01-28,191,仮払消費税等,旅費,0,1476,1339531
14787,0001-20100128-27-2288-1-5037,5,2010-01-28,726,旅費交通費,旅費,0,21429,1318102
14788,0001-20100128-27-2288-1-5037,6,2010-01-28,191,仮払消費税等,旅費,0,1071,1317031
14790,0001-20100128-35-2289-1-5039,0,2010-01-28,739,新聞図書費,新聞代,0,3739,1313292
14791,0001-20100128-35-2289-1-5039,1,2010-01-28,191,仮払消費税等,新聞代,0,186,1313106
14798,0001-20100128-83-2291-1-5043,0,2010-01-28,740,車両費,車両管理費,0,42858,1270248
14799,0001-20100128-83-2291-1-5043,1,2010-01-28,191,仮払消費税等,車両管理費,0,2142,1268106
14806,0001-20100130-100-2299-1-5059,0,2010-01-30,724,福利厚生費,会費,0,5715,1262391
14807,0001-20100130-100-2299-1-5059,1,2010-01-30,191,仮払消費税等,会費,0,285,1262106
14845,0001-20100130-49-2293-1-5047,3,2010-01-30,740,車両費,ガソリン代,0,2626,1259480
14846,0001-20100130-49-2293-1-5047,4,2010-01-30,191,仮払消費税等,ガソリン代,0,131,1259349
14848,0001-20100130-49-2293-1-5047,6,2010-01-30,740,車両費,ガソリン代,0,5729,1253620
14849,0001-20100130-49-2293-1-5047,7,2010-01-30,191,仮払消費税等,ガソリン代,0,286,1253334
14851,0001-20100130-55-2294-1-5049,0,2010-01-30,740,車両費,車両管理費,0,23810,1229524
14852,0001-20100130-55-2294-1-5049,1,2010-01-30,191,仮払消費税等,車両管理費,0,1190,1228334
14854,0001-20100130-55-2294-1-5049,3,2010-01-30,740,車両費,車両管理費,0,26667,1201667
14855,0001-20100130-55-2294-1-5049,4,2010-01-30,191,仮払消費税等,車両管理費,0,1333,1200334
14856,0001-20100130-55-2294-1-5049,5,2010-01-30,740,車両費,高速代,0,7667,1192667
14857,0001-20100130-55-2294-1-5049,6,2010-01-30,191,仮払消費税等,高速代,0,383,1192284
14873,0001-20100130-80-2296-1-5053,0,2010-01-30,740,車両費,ガソリン代,0,5834,1186450
14874,0001-20100130-80-2296-1-5053,1,2010-01-30,191,仮払消費税等,ガソリン代,0,291,1186159
14877,0001-20100130-83-2297-1-5055,0,2010-01-30,726,旅費交通費,ＪＲ代,0,8572,1177587
14878,0001-20100130-83-2297-1-5055,1,2010-01-30,191,仮払消費税等,ＪＲ代,0,428,1177159
15017,0001-20100131-119-2324-1-5109,1,2010-01-31,152,売掛金,10年1月31日伝票No428合同会社　エイム商事,465863,0,1643022
15177,0001-20100131-141-2345-1-5151,0,2010-01-31,726,旅費交通費,JR代,0,10000,1633022
15178,0001-20100131-141-2345-1-5151,1,2010-01-31,191,仮払消費税等,JR代,0,500,1632522
15210,0001-20100131-164-2350-1-5161,0,2010-01-31,754,事務用消耗品費,事務用品,0,1245,1631277
15211,0001-20100131-164-2350-1-5161,1,2010-01-31,191,仮払消費税等,事務用品,0,62,1631215
15242,0001-20100131-67-2310-1-5081,1,2010-01-31,742,諸会費,会費支払い,0,30000,1601215
,,,2010-01,,※※月計※※,,2706974,2137103,
15269,0001-20100201-67-2351-1-5163,0,2010-02-01,791,雑費,ティッシュ他,0,980,1600235
15270,0001-20100201-67-2351-1-5163,1,2010-02-01,191,仮払消費税等,ティッシュ他,0,49,1600186
15273,0001-20100202-102-2354-1-5169,0,2010-02-02,733,交際接待費,ゴルフ景品代　阿部商店,0,5000,1595186
15274,0001-20100202-102-2354-1-5169,1,2010-02-02,191,仮払消費税等,ゴルフ景品代　阿部商店,0,250,1594936
15277,0001-20100202-150-2355-1-5171,0,2010-02-02,733,交際接待費,飲食代　居酒屋華ゆう4名,0,14172,1580764
15278,0001-20100202-150-2355-1-5171,1,2010-02-02,191,仮払消費税等,飲食代　居酒屋華ゆう4名,0,708,1580056
15280,0001-20100202-150-2355-1-5171,3,2010-02-02,733,交際接待費,飲食代　バー薩摩4名,0,15467,1564589
15281,0001-20100202-150-2355-1-5171,4,2010-02-02,191,仮払消費税等,飲食代　バー薩摩4名,0,773,1563816
15283,0001-20100202-18-2352-1-5165,0,2010-02-02,726,旅費交通費,旅費,0,13810,1550006
15284,0001-20100202-18-2352-1-5165,1,2010-02-02,191,仮払消費税等,旅費,0,690,1549316
15287,0001-20100202-94-2353-1-5167,0,2010-02-02,791,雑費,台所用品他,0,964,1548352
15288,0001-20100202-94-2353-1-5167,1,2010-02-02,191,仮払消費税等,台所用品他,0,48,1548304
15296,0001-20100203-41-2356-1-5173,1,2010-02-03,733,交際接待費,香典代,0,10000,1538304
15302,0001-20100204-19-2358-1-5177,0,2010-02-04,726,旅費交通費,旅費,0,8096,1530208
15303,0001-20100204-19-2358-1-5177,1,2010-02-04,191,仮払消費税等,旅費,0,404,1529804
15312,0001-20100205-142-2366-1-5193,0,2010-02-05,740,車両費,高速代,0,4991,1524813
15313,0001-20100205-142-2366-1-5193,1,2010-02-05,191,仮払消費税等,高速代,0,249,1524564
15315,0001-20100205-142-2366-1-5193,3,2010-02-05,740,車両費,高速代,0,3004,1521560
15316,0001-20100205-142-2366-1-5193,4,2010-02-05,191,仮払消費税等,高速代,0,150,1521410
15317,0001-20100205-142-2366-1-5193,5,2010-02-05,740,車両費,高速代,0,4561,1516849
15318,0001-20100205-142-2366-1-5193,6,2010-02-05,191,仮払消費税等,高速代,0,228,1516621
15320,0001-20100205-161-2367-1-5195,0,2010-02-05,726,旅費交通費,旅費,0,6648,1509973
15321,0001-20100205-161-2367-1-5195,1,2010-02-05,191,仮払消費税等,旅費,0,332,1509641
15324,0001-20100205-20-2360-1-5181,0,2010-02-05,726,旅費交通費,旅費,0,40000,1469641
15325,0001-20100205-20-2360-1-5181,1,2010-02-05,191,仮払消費税等,旅費,0,2000,1467641
15353,0001-20100206-106-2369-1-5199,0,2010-02-06,733,交際接待費,ゴルフプレー代,0,17715,1449926
15354,0001-20100206-106-2369-1-5199,1,2010-02-06,191,仮払消費税等,ゴルフプレー代,0,885,1449041
15357,0001-20100206-110-2370-1-5201,0,2010-02-06,726,旅費交通費,タクシー代,0,2181,1446860
15358,0001-20100206-110-2370-1-5201,1,2010-02-06,191,仮払消費税等,タクシー代,0,109,1446751
15361,0001-20100206-149-2371-1-5203,0,2010-02-06,733,交際接待費,コーヒー代2名,0,1200,1445551
15362,0001-20100206-149-2371-1-5203,1,2010-02-06,191,仮払消費税等,コーヒー代2名,0,60,1445491
15365,0001-20100206-21-2368-1-5197,0,2010-02-06,726,旅費交通費,JR代,0,56762,1388729
15366,0001-20100206-21-2368-1-5197,1,2010-02-06,191,仮払消費税等,JR代,0,2838,1385891
15369,0001-20100207-143-2374-1-5209,0,2010-02-07,740,車両費,車両管理料,0,22096,1363795
15370,0001-20100207-143-2374-1-5209,1,2010-02-07,191,仮払消費税等,車両管理料,0,1104,1362691
15373,0001-20100207-43-2372-1-5205,0,2010-02-07,733,交際接待費,コーヒー代他2名,0,2105,1360586
15374,0001-20100207-43-2372-1-5205,1,2010-02-07,191,仮払消費税等,コーヒー代他2名,0,105,1360481
15377,0001-20100207-58-2373-1-5207,0,2010-02-07,726,旅費交通費,旅費,0,66667,1293814
15378,0001-20100207-58-2373-1-5207,1,2010-02-07,191,仮払消費税等,旅費,0,3333,1290481
15381,0001-20100208-164-2377-1-5215,0,2010-02-08,754,事務用消耗品費,事務用品,0,856,1289625
15382,0001-20100208-164-2377-1-5215,1,2010-02-08,191,仮払消費税等,事務用品,0,42,1289583
15385,0001-20100208-50-2375-1-5211,0,2010-02-08,740,車両費,高速代,0,1143,1288440
15386,0001-20100208-50-2375-1-5211,1,2010-02-08,191,仮払消費税等,高速代,0,57,1288383
15389,0001-20100208-75-2376-1-5213,0,2010-02-08,740,車両費,ガソリン代,0,6630,1281753
15390,0001-20100208-75-2376-1-5213,1,2010-02-08,191,仮払消費税等,ガソリン代,0,331,1281422
15392,0001-20100208-75-2376-1-5213,3,2010-02-08,740,車両費,高速代,0,2286,1279136
15393,0001-20100208-75-2376-1-5213,4,2010-02-08,191,仮払消費税等,高速代,0,114,1279022
15394,0001-20100208-75-2376-1-5213,5,2010-02-08,740,車両費,駐車代,0,762,1278260
15395,0001-20100208-75-2376-1-5213,6,2010-02-08,191,仮払消費税等,駐車代,0,38,1278222
15397,0001-20100209-152-2378-1-5217,0,2010-02-09,733,交際接待費,ゴルフプレー代,0,11429,1266793
15398,0001-20100209-152-2378-1-5217,1,2010-02-09,191,仮払消費税等,ゴルフプレー代,0,571,1266222
15401,0001-20100210-10-2379-1-5219,0,2010-02-10,740,車両費,ガソリン代,0,2858,1263364
15402,0001-20100210-10-2379-1-5219,1,2010-02-10,191,仮払消費税等,ガソリン代,0,142,1263222
15410,0001-20100210-162-2392-1-5245,0,2010-02-10,734,会議費,会議　食事代,0,23805,1239417
15411,0001-20100210-162-2392-1-5245,1,2010-02-10,191,仮払消費税等,会議　食事代,0,1190,1238227
15421,0001-20100210-60-2380-1-5221,1,2010-02-10,121,当座預金,引き出し,500000,0,1738227
15441,0001-20100210-76-2383-1-5227,0,2010-02-10,740,車両費,ガソリン代,0,5726,1732501
15442,0001-20100210-76-2383-1-5227,1,2010-02-10,191,仮払消費税等,ガソリン代,0,286,1732215
15445,0001-20100210-79-2384-1-5229,0,2010-02-10,726,旅費交通費,旅費,0,20953,1711262
15446,0001-20100210-79-2384-1-5229,1,2010-02-10,191,仮払消費税等,旅費,0,1047,1710215
15491,0001-20100211-141-2403-1-5267,0,2010-02-11,726,旅費交通費,JR代,0,20477,1689738
15492,0001-20100211-141-2403-1-5267,1,2010-02-11,191,仮払消費税等,JR代,0,1023,1688715
15495,0001-20100211-165-2404-1-5269,0,2010-02-11,791,雑費,ティッシュ代他,0,1272,1687443
15496,0001-20100211-165-2404-1-5269,1,2010-02-11,191,仮払消費税等,ティッシュ代他,0,63,1687380
15510,0001-20100211-22-2394-1-5249,0,2010-02-11,726,旅費交通費,旅費,0,21905,1665475
15511,0001-20100211-22-2394-1-5249,1,2010-02-11,191,仮払消費税等,旅費,0,1095,1664380
15537,0001-20100211-73-2398-1-5257,0,2010-02-11,733,交際接待費,食事代,0,25267,1639113
15538,0001-20100211-73-2398-1-5257,1,2010-02-11,191,仮払消費税等,食事代,0,1263,1637850
15541,0001-20100211-80-2399-1-5259,0,2010-02-11,726,旅費交通費,ＪＲ代,0,9524,1628326
15542,0001-20100211-80-2399-1-5259,1,2010-02-11,191,仮払消費税等,ＪＲ代,0,476,1627850
15551,0001-20100212-44-2406-1-5273,0,2010-02-12,733,交際接待費,飲食代　スナックランディ5名,0,32086,1595764
15552,0001-20100212-44-2406-1-5273,1,2010-02-12,191,仮払消費税等,飲食代　スナックランディ5名,0,1604,1594160
15555,0001-20100212-69-2407-1-5275,0,2010-02-12,733,交際接待費,ゴルフプレー代,0,12000,1582160
15556,0001-20100212-69-2407-1-5275,1,2010-02-12,191,仮払消費税等,ゴルフプレー代,0,600,1581560
15559,0001-20100212-71-2408-1-5277,0,2010-02-12,733,交際接待費,ゴルフプレー代,0,13000,1568560
15560,0001-20100212-71-2408-1-5277,1,2010-02-12,191,仮払消費税等,ゴルフプレー代,0,650,1567910
15563,0001-20100213-17-2409-1-5279,0,2010-02-13,740,車両費,駐車代,0,381,1567529
15564,0001-20100213-17-2409-1-5279,1,2010-02-13,191,仮払消費税等,駐車代,0,19,1567510
15566,0001-20100213-17-2409-1-5279,3,2010-02-13,740,車両費,高速代,0,2000,1565510
15567,0001-20100213-17-2409-1-5279,4,2010-02-13,191,仮払消費税等,高速代,0,100,1565410
15569,0001-20100213-23-2410-1-5281,0,2010-02-13,726,旅費交通費,旅費,0,23810,1541600
15570,0001-20100213-23-2410-1-5281,1,2010-02-13,191,仮払消費税等,旅費,0,1190,1540410
15572,0001-20100213-23-2410-1-5281,3,2010-02-13,726,旅費交通費,旅費,0,62858,1477552
15573,0001-20100213-23-2410-1-5281,4,2010-02-13,191,仮払消費税等,旅費,0,3142,1474410
15579,0001-20100214-46-2412-1-5285,0,2010-02-14,740,車両費,ガソリン代,0,2341,1472069
15580,0001-20100214-46-2412-1-5285,1,2010-02-14,191,仮払消費税等,ガソリン代,0,117,1471952
15582,0001-20100214-46-2412-1-5285,3,2010-02-14,740,車両費,ガソリン代,0,4767,1467185
15583,0001-20100214-46-2412-1-5285,4,2010-02-14,191,仮払消費税等,ガソリン代,0,238,1466947
15584,0001-20100214-46-2412-1-5285,5,2010-02-14,740,車両費,ガソリン代,0,4880,1462067
15585,0001-20100214-46-2412-1-5285,6,2010-02-14,191,仮払消費税等,ガソリン代,0,244,1461823
15587,0001-20100214-51-2413-1-5287,0,2010-02-14,740,車両費,高速代,0,1505,1460318
15588,0001-20100214-51-2413-1-5287,1,2010-02-14,191,仮払消費税等,高速代,0,75,1460243
15590,0001-20100214-51-2413-1-5287,3,2010-02-14,740,車両費,高速代,0,620,1459623
15591,0001-20100214-51-2413-1-5287,4,2010-02-14,191,仮払消費税等,高速代,0,30,1459593
15592,0001-20100214-51-2413-1-5287,5,2010-02-14,740,車両費,高速代,0,810,1458783
15593,0001-20100214-51-2413-1-5287,6,2010-02-14,191,仮払消費税等,高速代,0,40,1458743
15594,0001-20100214-51-2413-1-5287,7,2010-02-14,740,車両費,高速代,0,1096,1457647
15595,0001-20100214-51-2413-1-5287,8,2010-02-14,191,仮払消費税等,高速代,0,54,1457593
15596,0001-20100214-51-2413-1-5287,9,2010-02-14,740,車両費,高速代,0,1096,1456497
15597,0001-20100214-51-2413-1-5287,10,2010-02-14,191,仮払消費税等,高速代,0,54,1456443
15598,0001-20100214-51-2413-1-5287,11,2010-02-14,740,車両費,高速代,0,1096,1455347
15599,0001-20100214-51-2413-1-5287,12,2010-02-14,191,仮払消費税等,高速代,0,54,1455293
15600,0001-20100214-51-2413-1-5287,13,2010-02-14,740,車両費,高速代,0,953,1454340
15601,0001-20100214-51-2413-1-5287,14,2010-02-14,191,仮払消費税等,高速代,0,47,1454293
15603,0001-20100214-70-2414-1-5289,0,2010-02-14,733,交際接待費,ゴルフプレー代,0,8191,1446102
15604,0001-20100214-70-2414-1-5289,1,2010-02-14,191,仮払消費税等,ゴルフプレー代,0,409,1445693
15611,0001-20100215-117-2425-1-5311,1,2010-02-15,742,諸会費,会費,0,20000,1425693
15618,0001-20100215-151-2427-1-5315,0,2010-02-15,733,交際接待費,飲食代　居酒屋ラッキー,0,12143,1413550
15619,0001-20100215-151-2427-1-5315,1,2010-02-15,191,仮払消費税等,飲食代　居酒屋ラッキー,0,607,1412943
15622,0001-20100215-158-2428-1-5317,0,2010-02-15,726,旅費交通費,出張旅費,0,13334,1399609
15623,0001-20100215-158-2428-1-5317,1,2010-02-15,191,仮払消費税等,出張旅費,0,666,1398943
15630,0001-20100215-57-2416-1-5293,0,2010-02-15,726,旅費交通費,JR代,0,65429,1333514
15631,0001-20100215-57-2416-1-5293,1,2010-02-15,191,仮払消費税等,JR代,0,3271,1330243
15635,0001-20100215-83-2417-1-5295,1,2010-02-15,721,雑給,2月給与その他 0060 パート･アルバイト,0,205380,1124863
15685,0001-20100216-11-2430-1-5321,0,2010-02-16,740,車両費,ガソリン代,0,3058,1121805
15686,0001-20100216-11-2430-1-5321,1,2010-02-16,191,仮払消費税等,ガソリン代,0,152,1121653
15689,0001-20100216-136-2433-1-5327,0,2010-02-16,791,雑費,ダスキン代,0,15715,1105938
15690,0001-20100216-136-2433-1-5327,1,2010-02-16,191,仮払消費税等,ダスキン代,0,785,1105153
15693,0001-20100216-148-2434-1-5329,0,2010-02-16,740,車両費,ガソリン代,0,3400,1101753
15694,0001-20100216-148-2434-1-5329,1,2010-02-16,191,仮払消費税等,ガソリン代,0,170,1101583
15709,0001-20100216-7-2429-1-5319,0,2010-02-16,733,交際接待費,昼食代　かりん2名,0,3572,1098011
15710,0001-20100216-7-2429-1-5319,1,2010-02-16,191,仮払消費税等,昼食代　かりん2名,0,178,1097833
15713,0001-20100216-79-2432-1-5325,0,2010-02-16,724,福利厚生費,景品代,0,37539,1060294
15714,0001-20100216-79-2432-1-5325,1,2010-02-16,191,仮払消費税等,景品代,0,1876,1058418
15717,0001-20100217-47-2436-1-5333,0,2010-02-17,740,車両費,ガソリン代,0,2420,1055998
15718,0001-20100217-47-2436-1-5333,1,2010-02-17,191,仮払消費税等,ガソリン代,0,120,1055878
15721,0001-20100217-52-2437-1-5335,0,2010-02-17,740,車両費,高速代,0,1096,1054782
15722,0001-20100217-52-2437-1-5335,1,2010-02-17,191,仮払消費税等,高速代,0,54,1054728
15724,0001-20100217-52-2437-1-5335,3,2010-02-17,740,車両費,高速代,0,1096,1053632
15725,0001-20100217-52-2437-1-5335,4,2010-02-17,191,仮払消費税等,高速代,0,54,1053578
15726,0001-20100217-52-2437-1-5335,5,2010-02-17,740,車両費,高速代,0,1429,1052149
15727,0001-20100217-52-2437-1-5335,6,2010-02-17,191,仮払消費税等,高速代,0,71,1052078
15729,0001-20100217-74-2438-1-5337,0,2010-02-17,733,交際接待費,食事代　レストランファミリー5名,0,8220,1043858
15730,0001-20100217-74-2438-1-5337,1,2010-02-17,191,仮払消費税等,食事代　レストランファミリー5名,0,410,1043448
15733,0001-20100218-159-2439-1-5339,0,2010-02-18,726,旅費交通費,タクシー代,0,7239,1036209
15734,0001-20100218-159-2439-1-5339,1,2010-02-18,191,仮払消費税等,タクシー代,0,361,1035848
15737,0001-20100219-103-2442-1-5345,0,2010-02-19,733,交際接待費,食事代　弁当差し入れ　ベントース,0,2048,1033800
15738,0001-20100219-103-2442-1-5345,1,2010-02-19,191,仮払消費税等,食事代　弁当差し入れ　ベントース,0,102,1033698
15741,0001-20100219-138-2443-1-5347,0,2010-02-19,740,車両費,高速代,0,7187,1026511
15742,0001-20100219-138-2443-1-5347,1,2010-02-19,191,仮払消費税等,高速代,0,359,1026152
15744,0001-20100219-138-2443-1-5347,3,2010-02-19,740,車両費,駐車代,0,3086,1023066
15745,0001-20100219-138-2443-1-5347,4,2010-02-19,191,仮払消費税等,駐車代,0,154,1022912
15746,0001-20100219-138-2443-1-5347,5,2010-02-19,740,車両費,高速代,0,305,1022607
15747,0001-20100219-138-2443-1-5347,6,2010-02-19,191,仮払消費税等,高速代,0,15,1022592
15748,0001-20100219-138-2443-1-5347,7,2010-02-19,740,車両費,高速代,0,8329,1014263
15749,0001-20100219-138-2443-1-5347,8,2010-02-19,191,仮払消費税等,高速代,0,416,1013847
15750,0001-20100219-138-2443-1-5347,9,2010-02-19,740,車両費,高速代,0,5181,1008666
15751,0001-20100219-138-2443-1-5347,10,2010-02-19,191,仮払消費税等,高速代,0,259,1008407
15753,0001-20100219-160-2444-1-5349,0,2010-02-19,726,旅費交通費,出張旅費,0,66381,942026
15754,0001-20100219-160-2444-1-5349,1,2010-02-19,191,仮払消費税等,出張旅費,0,3319,938707
15757,0001-20100219-45-2440-1-5341,0,2010-02-19,733,交際接待費,飲食代　居酒屋旬5名,0,19991,918716
15758,0001-20100219-45-2440-1-5341,1,2010-02-19,191,仮払消費税等,飲食代　居酒屋旬5名,0,999,917717
15760,0001-20100219-45-2440-1-5341,3,2010-02-19,733,交際接待費,飲食代　スナック新世界,0,28362,889355
15761,0001-20100219-45-2440-1-5341,4,2010-02-19,191,仮払消費税等,飲食代　スナック新世界,0,1418,887937
15763,0001-20100219-59-2441-1-5343,0,2010-02-19,726,旅費交通費,旅費,0,43429,844508
15764,0001-20100219-59-2441-1-5343,1,2010-02-19,191,仮払消費税等,旅費,0,2171,842337
15771,0001-20100220-101-2458-1-5377,4,2010-02-20,152,売掛金,10年2月20日伝票No445株式会社　斉藤,1391496,0,2233833
15818,0001-20100220-144-2467-1-5395,0,2010-02-20,740,車両費,ガソリン代,0,4286,2229547
15819,0001-20100220-144-2467-1-5395,1,2010-02-20,191,仮払消費税等,ガソリン代,0,214,2229333
15821,0001-20100220-144-2467-1-5395,3,2010-02-20,740,車両費,ガソリン代,0,5919,2223414
15822,0001-20100220-144-2467-1-5395,4,2010-02-20,191,仮払消費税等,ガソリン代,0,295,2223119
15824,0001-20100220-153-2468-1-5397,0,2010-02-20,733,交際接待費,食事代　和食処川よし2名,0,9486,2213633
15825,0001-20100220-153-2468-1-5397,1,2010-02-20,191,仮払消費税等,食事代　和食処川よし2名,0,474,2213159
15829,0001-20100220-163-2469-1-5399,1,2010-02-20,742,諸会費,会費,0,18000,2195159
15855,0001-20100220-48-2448-1-5357,0,2010-02-20,740,車両費,ガソリン代,0,4099,2191060
15856,0001-20100220-48-2448-1-5357,1,2010-02-20,191,仮払消費税等,ガソリン代,0,204,2190856
15859,0001-20100220-53-2449-1-5359,0,2010-02-20,740,車両費,高速代,0,381,2190475
15860,0001-20100220-53-2449-1-5359,1,2010-02-20,191,仮払消費税等,高速代,0,19,2190456
15862,0001-20100220-53-2449-1-5359,3,2010-02-20,740,車両費,高速代,0,1000,2189456
15863,0001-20100220-53-2449-1-5359,4,2010-02-20,191,仮払消費税等,高速代,0,50,2189406
15864,0001-20100220-53-2449-1-5359,5,2010-02-20,740,車両費,高速代,0,1000,2188406
15865,0001-20100220-53-2449-1-5359,6,2010-02-20,191,仮払消費税等,高速代,0,50,2188356
15929,0001-20100221-25-2473-1-5407,0,2010-02-21,726,旅費交通費,旅費,0,53334,2135022
15930,0001-20100221-25-2473-1-5407,1,2010-02-21,191,仮払消費税等,旅費,0,2666,2132356
15933,0001-20100221-27-2474-1-5409,0,2010-02-21,726,旅費交通費,旅費,0,41905,2090451
15934,0001-20100221-27-2474-1-5409,1,2010-02-21,191,仮払消費税等,旅費,0,2095,2088356
15936,0001-20100221-27-2474-1-5409,3,2010-02-21,726,旅費交通費,旅費,0,28381,2059975
15937,0001-20100221-27-2474-1-5409,4,2010-02-21,191,仮払消費税等,旅費,0,1419,2058556
15938,0001-20100221-27-2474-1-5409,5,2010-02-21,726,旅費交通費,旅費,0,30077,2028479
15939,0001-20100221-27-2474-1-5409,6,2010-02-21,191,仮払消費税等,旅費,0,1503,2026976
15941,0001-20100221-6-2471-1-5403,0,2010-02-21,732,広告宣伝費,広告料,0,4762,2022214
15942,0001-20100221-6-2471-1-5403,1,2010-02-21,191,仮払消費税等,広告料,0,238,2021976
15945,0001-20100221-8-2472-1-5405,0,2010-02-21,733,交際接待費,定例ミーティング会費,0,19048,2002928
15946,0001-20100221-8-2472-1-5405,1,2010-02-21,191,仮払消費税等,定例ミーティング会費,0,952,2001976
15953,0001-20100222-12-2477-1-5415,0,2010-02-22,740,車両費,ガソリン代,0,3810,1998166
15954,0001-20100222-12-2477-1-5415,1,2010-02-22,191,仮払消費税等,ガソリン代,0,190,1997976
15956,0001-20100222-12-2477-1-5415,3,2010-02-22,740,車両費,ガソリン代,0,5715,1992261
15957,0001-20100222-12-2477-1-5415,4,2010-02-22,191,仮払消費税等,ガソリン代,0,285,1991976
15959,0001-20100222-155-2480-1-5421,0,2010-02-22,740,車両費,ガソリン代,0,5926,1986050
15960,0001-20100222-155-2480-1-5421,1,2010-02-22,191,仮払消費税等,ガソリン代,0,296,1985754
15963,0001-20100222-166-2481-1-5423,0,2010-02-22,791,雑費,ダスキン代,0,1800,1983954
15964,0001-20100222-166-2481-1-5423,1,2010-02-22,191,仮払消費税等,ダスキン代,0,90,1983864
15967,0001-20100222-90-2478-1-5417,0,2010-02-22,791,雑費,ダスキン代,0,10000,1973864
15968,0001-20100222-90-2478-1-5417,1,2010-02-22,191,仮払消費税等,ダスキン代,0,500,1973364
15975,0001-20100223-140-2489-1-5439,0,2010-02-23,726,旅費交通費,旅費,0,7048,1966316
15976,0001-20100223-140-2489-1-5439,1,2010-02-23,191,仮払消費税等,旅費,0,352,1965964
15979,0001-20100223-156-2490-1-5441,0,2010-02-23,726,旅費交通費,出張旅費,0,9048,1956916
15980,0001-20100223-156-2490-1-5441,1,2010-02-23,191,仮払消費税等,出張旅費,0,452,1956464
15983,0001-20100223-26-2484-1-5429,0,2010-02-23,726,旅費交通費,旅費,0,10477,1945987
15984,0001-20100223-26-2484-1-5429,1,2010-02-23,191,仮払消費税等,旅費,0,523,1945464
15995,0001-20100223-54-2486-1-5433,0,2010-02-23,740,車両費,高速代,0,1810,1943654
15996,0001-20100223-54-2486-1-5433,1,2010-02-23,191,仮払消費税等,高速代,0,90,1943564
15998,0001-20100223-54-2486-1-5433,3,2010-02-23,740,車両費,高速代,0,2572,1940992
15999,0001-20100223-54-2486-1-5433,4,2010-02-23,191,仮払消費税等,高速代,0,128,1940864
16120,0001-20100223-9-2483-1-5427,0,2010-02-23,733,交際接待費,香典代,0,10000,1930864
16122,0001-20100223-9-2483-1-5427,2,2010-02-23,733,交際接待費,花代,0,12000,1918864
16123,0001-20100223-9-2483-1-5427,3,2010-02-23,191,仮払消費税等,花代,0,600,1918264
16125,0001-20100224-104-2495-1-5451,0,2010-02-24,733,交際接待費,コーヒー代3名,0,1800,1916464
16126,0001-20100224-104-2495-1-5451,1,2010-02-24,191,仮払消費税等,コーヒー代3名,0,90,1916374
16143,0001-20100224-75-2491-1-5443,0,2010-02-24,733,交際接待費,コーヒー代2名,0,1200,1915174
16144,0001-20100224-75-2491-1-5443,1,2010-02-24,191,仮払消費税等,コーヒー代2名,0,60,1915114
16151,0001-20100224-83-2493-1-5447,0,2010-02-24,740,車両費,車両管理費,0,36858,1878256
16152,0001-20100224-83-2493-1-5447,1,2010-02-24,191,仮払消費税等,車両管理費,0,1842,1876414
16192,0001-20100225-121-2508-1-5477,0,2010-02-25,724,福利厚生費,お茶代,0,9048,1867366
16193,0001-20100225-121-2508-1-5477,1,2010-02-25,191,仮払消費税等,お茶代,0,452,1866914
16196,0001-20100225-24-2499-1-5459,0,2010-02-25,726,旅費交通費,JR回数券,0,53191,1813723
16197,0001-20100225-24-2499-1-5459,1,2010-02-25,191,仮払消費税等,JR回数券,0,2659,1811064
16200,0001-20100225-35-2500-1-5461,0,2010-02-25,739,新聞図書費,新聞代,0,3739,1807325
16201,0001-20100225-35-2500-1-5461,1,2010-02-25,191,仮払消費税等,新聞代,0,186,1807139
16208,0001-20100225-60-2502-1-5465,0,2010-02-25,726,旅費交通費,旅費,0,10000,1797139
16209,0001-20100225-60-2502-1-5465,1,2010-02-25,191,仮払消費税等,旅費,0,500,1796639
16222,0001-20100226-114-2516-1-5493,0,2010-02-26,739,新聞図書費,新聞代,0,2540,1794099
16223,0001-20100226-114-2516-1-5493,1,2010-02-26,191,仮払消費税等,新聞代,0,126,1793973
16225,0001-20100226-114-2516-1-5493,3,2010-02-26,739,新聞図書費,新聞代,0,2864,1791109
16226,0001-20100226-114-2516-1-5493,4,2010-02-26,191,仮払消費税等,新聞代,0,143,1790966
16237,0001-20100226-170-2519-1-5499,0,2010-02-26,739,新聞図書費,新聞代,0,2864,1788102
16238,0001-20100226-170-2519-1-5499,1,2010-02-26,191,仮払消費税等,新聞代,0,143,1787959
16253,0001-20100226-72-2511-1-5483,0,2010-02-26,739,新聞図書費,新聞代,0,2864,1785095
16254,0001-20100226-72-2511-1-5483,1,2010-02-26,191,仮払消費税等,新聞代,0,143,1784952
16256,0001-20100226-72-2511-1-5483,3,2010-02-26,739,新聞図書費,新聞代,0,2815,1782137
16257,0001-20100226-72-2511-1-5483,4,2010-02-26,191,仮払消費税等,新聞代,0,140,1781997
16258,0001-20100226-72-2511-1-5483,5,2010-02-26,739,新聞図書費,新聞代,0,3399,1778598
16259,0001-20100226-72-2511-1-5483,6,2010-02-26,191,仮払消費税等,新聞代,0,169,1778429
16261,0001-20100226-82-2512-1-5485,0,2010-02-26,726,旅費交通費,タクシー代,0,4286,1774143
16262,0001-20100226-82-2512-1-5485,1,2010-02-26,191,仮払消費税等,タクシー代,0,214,1773929
16265,0001-20100226-88-2513-1-5487,0,2010-02-26,739,新聞図書費,新聞代,0,3399,1770530
16266,0001-20100226-88-2513-1-5487,1,2010-02-26,191,仮払消費税等,新聞代,0,169,1770361
16269,0001-20100227-15-2520-1-5501,0,2010-02-27,740,車両費,高速代,0,2000,1768361
16270,0001-20100227-15-2520-1-5501,1,2010-02-27,191,仮払消費税等,高速代,0,100,1768261
16284,0001-20100227-39-2522-1-5505,0,2010-02-27,724,福利厚生費,会費,0,8572,1759689
16285,0001-20100227-39-2522-1-5505,1,2010-02-27,191,仮払消費税等,会費,0,428,1759261
16288,0001-20100227-77-2523-1-5507,0,2010-02-27,740,車両費,ガソリン代,0,4893,1754368
16289,0001-20100227-77-2523-1-5507,1,2010-02-27,191,仮払消費税等,ガソリン代,0,244,1754124
16291,0001-20100227-77-2523-1-5507,3,2010-02-27,740,車両費,洗車代,0,1143,1752981
16292,0001-20100227-77-2523-1-5507,4,2010-02-27,191,仮払消費税等,洗車代,0,57,1752924
16298,0001-20100228-100-2546-1-5553,0,2010-02-28,724,福利厚生費,会費,0,5715,1747209
16299,0001-20100228-100-2546-1-5553,1,2010-02-28,191,仮払消費税等,会費,0,285,1746924
16316,0001-20100228-108-2528-1-5517,0,2010-02-28,733,交際接待費,飲食代　ホテルラフォーネ3名,0,20315,1726609
16317,0001-20100228-108-2528-1-5517,1,2010-02-28,191,仮払消費税等,飲食代　ホテルラフォーネ3名,0,1015,1725594
16442,0001-20100228-118-2555-1-5571,1,2010-02-28,152,売掛金,10年2月28日伝票No454合同会社　エイム商事,187387,0,1912981
16657,0001-20100228-49-2535-1-5531,3,2010-02-28,740,車両費,ガソリン代,0,2626,1910355
16658,0001-20100228-49-2535-1-5531,4,2010-02-28,191,仮払消費税等,ガソリン代,0,131,1910224
16660,0001-20100228-49-2535-1-5531,6,2010-02-28,740,車両費,ガソリン代,0,5729,1904495
16661,0001-20100228-49-2535-1-5531,7,2010-02-28,191,仮払消費税等,ガソリン代,0,286,1904209
16669,0001-20100228-55-2536-1-5533,0,2010-02-28,740,車両費,車両管理費,0,23810,1880399
16670,0001-20100228-55-2536-1-5533,1,2010-02-28,191,仮払消費税等,車両管理費,0,1190,1879209
16672,0001-20100228-55-2536-1-5533,3,2010-02-28,740,車両費,車両管理費,0,26667,1852542
16673,0001-20100228-55-2536-1-5533,4,2010-02-28,191,仮払消費税等,車両管理費,0,1333,1851209
16674,0001-20100228-55-2536-1-5533,5,2010-02-28,740,車両費,高速代,0,7667,1843542
16675,0001-20100228-55-2536-1-5533,6,2010-02-28,191,仮払消費税等,高速代,0,383,1843159
16689,0001-20100228-67-2526-1-5513,1,2010-02-28,742,諸会費,会費支払い,0,30000,1813159
,,,2010-02,,※※月計※※,,2078883,1866939,
16744,0001-20100301-66-2580-1-5621,0,2010-03-01,791,雑費,ティッシュ他,0,4094,1809065
16745,0001-20100301-66-2580-1-5621,1,2010-03-01,191,仮払消費税等,ティッシュ他,0,204,1808861
16748,0001-20100302-164-2581-1-5623,0,2010-03-02,754,事務用消耗品費,事務用品,0,7000,1801861
16749,0001-20100302-164-2581-1-5623,1,2010-03-02,191,仮払消費税等,事務用品,0,350,1801511
16756,0001-20100303-142-2586-1-5633,0,2010-03-03,740,車両費,高速代,0,220,1801291
16757,0001-20100303-142-2586-1-5633,1,2010-03-03,191,仮払消費税等,高速代,0,10,1801281
16759,0001-20100303-142-2586-1-5633,3,2010-03-03,740,車両費,ガソリン代,0,3338,1797943
16760,0001-20100303-142-2586-1-5633,4,2010-03-03,191,仮払消費税等,ガソリン代,0,166,1797777
16761,0001-20100303-142-2586-1-5633,5,2010-03-03,740,車両費,高速代,0,5228,1792549
16762,0001-20100303-142-2586-1-5633,6,2010-03-03,191,仮払消費税等,高速代,0,261,1792288
16763,0001-20100303-142-2586-1-5633,7,2010-03-03,740,車両費,高速代,0,2461,1789827
16764,0001-20100303-142-2586-1-5633,8,2010-03-03,191,仮払消費税等,高速代,0,123,1789704
16765,0001-20100303-142-2586-1-5633,9,2010-03-03,740,車両費,高速代,0,3373,1786331
16766,0001-20100303-142-2586-1-5633,10,2010-03-03,191,仮払消費税等,高速代,0,168,1786163
16767,0001-20100303-142-2586-1-5633,11,2010-03-03,740,車両費,高速代,0,8105,1778058
16768,0001-20100303-142-2586-1-5633,12,2010-03-03,191,仮払消費税等,高速代,0,405,1777653
16770,0001-20100303-19-2582-1-5625,0,2010-03-03,726,旅費交通費,旅費,0,36572,1741081
16771,0001-20100303-19-2582-1-5625,1,2010-03-03,191,仮払消費税等,旅費,0,1828,1739253
16774,0001-20100303-41-2583-1-5627,0,2010-03-03,733,交際接待費,結婚式会費,0,14286,1724967
16775,0001-20100303-41-2583-1-5627,1,2010-03-03,191,仮払消費税等,結婚式会費,0,714,1724253
16777,0001-20100303-41-2583-1-5627,3,2010-03-03,733,交際接待費,祝い金,0,9524,1714729
16778,0001-20100303-41-2583-1-5627,4,2010-03-03,191,仮払消費税等,祝い金,0,476,1714253
16780,0001-20100303-56-2584-1-5629,0,2010-03-03,726,旅費交通費,旅費,0,40610,1673643
16781,0001-20100303-56-2584-1-5629,1,2010-03-03,191,仮払消費税等,旅費,0,2030,1671613
16790,0001-20100305-42-2587-1-5635,0,2010-03-05,733,交際接待費,食事代　トン吉2名,0,4296,1667317
16791,0001-20100305-42-2587-1-5635,1,2010-03-05,191,仮払消費税等,食事代　トン吉2名,0,214,1667103
16794,0001-20100305-43-2588-1-5637,0,2010-03-05,733,交際接待費,手土産代　五越百貨店,0,7267,1659836
16795,0001-20100305-43-2588-1-5637,1,2010-03-05,191,仮払消費税等,手土産代　五越百貨店,0,363,1659473
16798,0001-20100305-58-2589-1-5639,0,2010-03-05,726,旅費交通費,旅費,0,66477,1592996
16799,0001-20100305-58-2589-1-5639,1,2010-03-05,191,仮払消費税等,旅費,0,3323,1589673
16823,0001-20100306-110-2596-1-5653,0,2010-03-06,726,旅費交通費,タクシー代,0,2181,1587492
16824,0001-20100306-110-2596-1-5653,1,2010-03-06,191,仮払消費税等,タクシー代,0,109,1587383
16831,0001-20100306-22-2595-1-5651,0,2010-03-06,726,旅費交通費,旅費,0,31334,1556049
16832,0001-20100306-22-2595-1-5651,1,2010-03-06,191,仮払消費税等,旅費,0,1566,1554483
16835,0001-20100306-7-2594-1-5649,0,2010-03-06,733,交際接待費,飲食代　居酒屋いろは7名,0,20800,1533683
16836,0001-20100306-7-2594-1-5649,1,2010-03-06,191,仮払消費税等,飲食代　居酒屋いろは7名,0,1040,1532643
16839,0001-20100307-10-2598-1-5657,0,2010-03-07,740,車両費,駐車代,0,286,1532357
16840,0001-20100307-10-2598-1-5657,1,2010-03-07,191,仮払消費税等,駐車代,0,14,1532343
16843,0001-20100307-102-2603-1-5667,0,2010-03-07,733,交際接待費,手土産代　阿部商店,0,2000,1530343
16844,0001-20100307-102-2603-1-5667,1,2010-03-07,191,仮払消費税等,手土産代　阿部商店,0,100,1530243
16847,0001-20100307-161-2604-1-5669,0,2010-03-07,726,旅費交通費,旅費,0,5267,1524976
16848,0001-20100307-161-2604-1-5669,1,2010-03-07,191,仮払消費税等,旅費,0,263,1524713
16851,0001-20100307-69-2599-1-5659,0,2010-03-07,791,雑費,トイレットペーパー代,0,1332,1523381
16852,0001-20100307-69-2599-1-5659,1,2010-03-07,191,仮払消費税等,トイレットペーパー代,0,66,1523315
16855,0001-20100307-77-2600-1-5661,0,2010-03-07,726,旅費交通費,旅費,0,33334,1489981
16856,0001-20100307-77-2600-1-5661,1,2010-03-07,191,仮払消費税等,旅費,0,1666,1488315
16859,0001-20100307-78-2601-1-5663,0,2010-03-07,726,旅費交通費,ＪＲ代,0,7143,1481172
16860,0001-20100307-78-2601-1-5663,1,2010-03-07,191,仮払消費税等,ＪＲ代,0,357,1480815
16863,0001-20100307-79-2602-1-5665,0,2010-03-07,726,旅費交通費,タクシー代,0,2191,1478624
16864,0001-20100307-79-2602-1-5665,1,2010-03-07,191,仮払消費税等,タクシー代,0,109,1478515
16867,0001-20100308-151-2606-1-5673,0,2010-03-08,733,交際接待費,ゴルフプレー代,0,8000,1470515
16868,0001-20100308-151-2606-1-5673,1,2010-03-08,191,仮払消費税等,ゴルフプレー代,0,400,1470115
16871,0001-20100308-50-2605-1-5671,0,2010-03-08,740,車両費,高速代,0,1143,1468972
16872,0001-20100308-50-2605-1-5671,1,2010-03-08,191,仮払消費税等,高速代,0,57,1468915
16875,0001-20100309-20-2607-1-5675,0,2010-03-09,726,旅費交通費,旅費,0,48762,1420153
16876,0001-20100309-20-2607-1-5675,1,2010-03-09,191,仮払消費税等,旅費,0,2438,1417715
16879,0001-20100310-11-2608-1-5677,0,2010-03-10,740,車両費,ガソリン代,0,4412,1413303
16880,0001-20100310-11-2608-1-5677,1,2010-03-10,191,仮払消費税等,ガソリン代,0,220,1413083
16894,0001-20100310-143-2625-1-5711,0,2010-03-10,740,車両費,点検作業料,0,11905,1401178
16895,0001-20100310-143-2625-1-5711,1,2010-03-10,191,仮払消費税等,点検作業料,0,595,1400583
16898,0001-20100310-150-2626-1-5713,0,2010-03-10,733,交際接待費,ゴルフプレー代,0,8000,1392583
16899,0001-20100310-150-2626-1-5713,1,2010-03-10,191,仮払消費税等,ゴルフプレー代,0,400,1392183
16902,0001-20100310-162-2627-1-5715,0,2010-03-10,734,会議費,会議　食事代,0,23805,1368378
16903,0001-20100310-162-2627-1-5715,1,2010-03-10,191,仮払消費税等,会議　食事代,0,1190,1367188
16934,0001-20100310-57-2610-1-5681,0,2010-03-10,726,旅費交通費,JR代,0,96191,1270997
16935,0001-20100310-57-2610-1-5681,1,2010-03-10,191,仮払消費税等,JR代,0,4809,1266188
16970,0001-20100310-78-2616-1-5693,0,2010-03-10,740,車両費,ガソリン代,0,5623,1260565
16971,0001-20100310-78-2616-1-5693,1,2010-03-10,191,仮払消費税等,ガソリン代,0,281,1260284
16973,0001-20100310-78-2616-1-5693,3,2010-03-10,740,車両費,高速代,0,1715,1258569
16974,0001-20100310-78-2616-1-5693,4,2010-03-10,191,仮払消費税等,高速代,0,85,1258484
17018,0001-20100312-68-2632-1-5725,0,2010-03-12,791,雑費,電池代,0,600,1257884
17019,0001-20100312-68-2632-1-5725,1,2010-03-12,191,仮払消費税等,電池代,0,30,1257854
17022,0001-20100312-73-2633-1-5727,0,2010-03-12,733,交際接待費,飲食代　居酒屋栗の木2名,0,9286,1248568
17023,0001-20100312-73-2633-1-5727,1,2010-03-12,191,仮払消費税等,飲食代　居酒屋栗の木2名,0,464,1248104
17026,0001-20100312-86-2634-1-5729,0,2010-03-12,727,通信費,切手代,0,7620,1240484
17027,0001-20100312-86-2634-1-5729,1,2010-03-12,191,仮払消費税等,切手代,0,380,1240104
17030,0001-20100313-144-2636-1-5733,0,2010-03-13,740,車両費,ガソリン代,0,2382,1237722
17031,0001-20100313-144-2636-1-5733,1,2010-03-13,191,仮払消費税等,ガソリン代,0,119,1237603
17033,0001-20100313-144-2636-1-5733,3,2010-03-13,740,車両費,ガソリン代,0,7487,1230116
17034,0001-20100313-144-2636-1-5733,4,2010-03-13,191,仮払消費税等,ガソリン代,0,374,1229742
17035,0001-20100313-144-2636-1-5733,5,2010-03-13,740,車両費,高速代,0,7662,1222080
17036,0001-20100313-144-2636-1-5733,6,2010-03-13,191,仮払消費税等,高速代,0,383,1221697
17038,0001-20100313-158-2637-1-5735,0,2010-03-13,726,旅費交通費,航空券,0,54286,1167411
17039,0001-20100313-158-2637-1-5735,1,2010-03-13,191,仮払消費税等,航空券,0,2714,1164697
17042,0001-20100313-21-2635-1-5731,0,2010-03-13,726,旅費交通費,JR代,0,85243,1079454
17043,0001-20100313-21-2635-1-5731,1,2010-03-13,191,仮払消費税等,JR代,0,4262,1075192
17046,0001-20100314-17-2638-1-5737,0,2010-03-14,740,車両費,ウォッシャー液,0,351,1074841
17047,0001-20100314-17-2638-1-5737,1,2010-03-14,191,仮払消費税等,ウォッシャー液,0,17,1074824
17050,0001-20100314-46-2639-1-5739,0,2010-03-14,740,車両費,ガソリン代,0,2341,1072483
17051,0001-20100314-46-2639-1-5739,1,2010-03-14,191,仮払消費税等,ガソリン代,0,117,1072366
17053,0001-20100314-46-2639-1-5739,3,2010-03-14,740,車両費,ガソリン代,0,4767,1067599
17054,0001-20100314-46-2639-1-5739,4,2010-03-14,191,仮払消費税等,ガソリン代,0,238,1067361
17055,0001-20100314-46-2639-1-5739,5,2010-03-14,740,車両費,ガソリン代,0,4880,1062481
17056,0001-20100314-46-2639-1-5739,6,2010-03-14,191,仮払消費税等,ガソリン代,0,244,1062237
17058,0001-20100314-51-2640-1-5741,0,2010-03-14,740,車両費,高速代,0,1505,1060732
17059,0001-20100314-51-2640-1-5741,1,2010-03-14,191,仮払消費税等,高速代,0,75,1060657
17061,0001-20100314-51-2640-1-5741,3,2010-03-14,740,車両費,高速代,0,620,1060037
17062,0001-20100314-51-2640-1-5741,4,2010-03-14,191,仮払消費税等,高速代,0,30,1060007
17063,0001-20100314-51-2640-1-5741,5,2010-03-14,740,車両費,高速代,0,810,1059197
17064,0001-20100314-51-2640-1-5741,6,2010-03-14,191,仮払消費税等,高速代,0,40,1059157
17065,0001-20100314-51-2640-1-5741,7,2010-03-14,740,車両費,高速代,0,1096,1058061
17066,0001-20100314-51-2640-1-5741,8,2010-03-14,191,仮払消費税等,高速代,0,54,1058007
17067,0001-20100314-51-2640-1-5741,9,2010-03-14,740,車両費,高速代,0,1096,1056911
17068,0001-20100314-51-2640-1-5741,10,2010-03-14,191,仮払消費税等,高速代,0,54,1056857
17069,0001-20100314-51-2640-1-5741,11,2010-03-14,740,車両費,高速代,0,1096,1055761
17070,0001-20100314-51-2640-1-5741,12,2010-03-14,191,仮払消費税等,高速代,0,54,1055707
17071,0001-20100314-51-2640-1-5741,13,2010-03-14,740,車両費,高速代,0,953,1054754
17072,0001-20100314-51-2640-1-5741,14,2010-03-14,191,仮払消費税等,高速代,0,47,1054707
17093,0001-20100315-59-2644-1-5749,0,2010-03-15,726,旅費交通費,旅費,0,42858,1011849
17094,0001-20100315-59-2644-1-5749,1,2010-03-15,191,仮払消費税等,旅費,0,2142,1009707
17096,0001-20100315-59-2644-1-5749,3,2010-03-15,726,旅費交通費,ＪＲ代,0,30477,979230
17097,0001-20100315-59-2644-1-5749,4,2010-03-15,191,仮払消費税等,ＪＲ代,0,1523,977707
17099,0001-20100315-74-2645-1-5751,0,2010-03-15,733,交際接待費,飲食代　スナックかりん,0,20620,957087
17100,0001-20100315-74-2645-1-5751,1,2010-03-15,191,仮払消費税等,飲食代　スナックかりん,0,1030,956057
17104,0001-20100315-82-2646-1-5753,1,2010-03-15,721,雑給,3月給与その他 0060 パート･アルバイト,0,258617,697440
17162,0001-20100316-103-2655-1-5771,0,2010-03-16,733,交際接待費,食事代　串揚げ一心2名,0,5410,692030
17163,0001-20100316-103-2655-1-5771,1,2010-03-16,191,仮払消費税等,食事代　串揚げ一心2名,0,270,691760
17167,0001-20100316-117-2656-1-5773,1,2010-03-16,742,諸会費,会費,0,20000,671760
17169,0001-20100316-136-2657-1-5775,0,2010-03-16,791,雑費,ダスキン代,0,15715,656045
17170,0001-20100316-136-2657-1-5775,1,2010-03-16,191,仮払消費税等,ダスキン代,0,785,655260
17173,0001-20100316-148-2658-1-5777,0,2010-03-16,740,車両費,ガソリン代,0,5319,649941
17174,0001-20100316-148-2658-1-5777,1,2010-03-16,191,仮払消費税等,ガソリン代,0,265,649676
17177,0001-20100316-149-2659-1-5779,0,2010-03-16,733,交際接待費,手土産代　五越百貨店,0,3496,646180
17178,0001-20100316-149-2659-1-5779,1,2010-03-16,191,仮払消費税等,手土産代　五越百貨店,0,174,646006
17180,0001-20100316-149-2659-1-5779,3,2010-03-16,733,交際接待費,コーヒー代他2名,0,2324,643682
17181,0001-20100316-149-2659-1-5779,4,2010-03-16,191,仮払消費税等,コーヒー代他2名,0,116,643566
17183,0001-20100317-23-2660-1-5781,0,2010-03-17,726,旅費交通費,旅費,0,54096,589470
17184,0001-20100317-23-2660-1-5781,1,2010-03-17,191,仮払消費税等,旅費,0,2704,586766
17186,0001-20100317-23-2660-1-5781,3,2010-03-17,726,旅費交通費,旅費,0,40000,546766
17187,0001-20100317-23-2660-1-5781,4,2010-03-17,191,仮払消費税等,旅費,0,2000,544766
17188,0001-20100317-23-2660-1-5781,5,2010-03-17,726,旅費交通費,旅費,0,56953,487813
17189,0001-20100317-23-2660-1-5781,6,2010-03-17,191,仮払消費税等,旅費,0,2847,484966
17191,0001-20100317-47-2661-1-5783,0,2010-03-17,740,車両費,ガソリン代,0,2420,482546
17192,0001-20100317-47-2661-1-5783,1,2010-03-17,191,仮払消費税等,ガソリン代,0,120,482426
17195,0001-20100317-52-2662-1-5785,0,2010-03-17,740,車両費,高速代,0,1096,481330
17196,0001-20100317-52-2662-1-5785,1,2010-03-17,191,仮払消費税等,高速代,0,54,481276
17198,0001-20100317-52-2662-1-5785,3,2010-03-17,740,車両費,高速代,0,1096,480180
17199,0001-20100317-52-2662-1-5785,4,2010-03-17,191,仮払消費税等,高速代,0,54,480126
17200,0001-20100317-52-2662-1-5785,5,2010-03-17,740,車両費,高速代,0,1429,478697
17201,0001-20100317-52-2662-1-5785,6,2010-03-17,191,仮払消費税等,高速代,0,71,478626
17203,0001-20100317-94-2663-1-5787,0,2010-03-17,791,雑費,トイレットペーパー他,0,2980,475646
17204,0001-20100317-94-2663-1-5787,1,2010-03-17,191,仮払消費税等,トイレットペーパー他,0,148,475498
17207,0001-20100318-152-2664-1-5789,0,2010-03-18,733,交際接待費,飲食代　バー湯の瀬2名,0,9000,466498
17208,0001-20100318-152-2664-1-5789,1,2010-03-18,191,仮払消費税等,飲食代　バー湯の瀬2名,0,450,466048
17212,0001-20100318-153-2665-1-5791,1,2010-03-18,733,交際接待費,香典代,0,10000,456048
17214,0001-20100319-160-2669-1-5799,0,2010-03-19,726,旅費交通費,出張旅費,0,56858,399190
17215,0001-20100319-160-2669-1-5799,1,2010-03-19,191,仮払消費税等,出張旅費,0,2842,396348
17218,0001-20100319-71-2667-1-5795,0,2010-03-19,733,交際接待費,ゴルフプレー代2名,0,26667,369681
17219,0001-20100319-71-2667-1-5795,1,2010-03-19,191,仮払消費税等,ゴルフプレー代2名,0,1333,368348
17222,0001-20100319-8-2666-1-5793,0,2010-03-19,733,交際接待費,定例ミーティング会費,0,19048,349300
17223,0001-20100319-8-2666-1-5793,1,2010-03-19,191,仮払消費税等,定例ミーティング会費,0,952,348348
17226,0001-20100319-80-2668-1-5797,0,2010-03-19,726,旅費交通費,旅費,0,11429,336919
17227,0001-20100319-80-2668-1-5797,1,2010-03-19,191,仮払消費税等,旅費,0,571,336348
17231,0001-20100320-100-2681-1-5823,1,2010-03-20,152,売掛金,10年3月20日伝票No471株式会社　斉藤,847329,0,1183677
17289,0001-20100320-141-2692-1-5845,0,2010-03-20,726,旅費交通費,JR代,0,50477,1133200
17290,0001-20100320-141-2692-1-5845,1,2010-03-20,191,仮払消費税等,JR代,0,2523,1130677
17300,0001-20100320-156-2694-1-5849,0,2010-03-20,726,旅費交通費,出張旅費,0,15239,1115438
17301,0001-20100320-156-2694-1-5849,1,2010-03-20,191,仮払消費税等,出張旅費,0,761,1114677
17304,0001-20100320-159-2695-1-5851,0,2010-03-20,726,旅費交通費,タクシー代,0,8381,1106296
17305,0001-20100320-159-2695-1-5851,1,2010-03-20,191,仮払消費税等,タクシー代,0,419,1105877
17308,0001-20100320-165-2696-1-5853,0,2010-03-20,791,雑費,懇親会会費,0,9524,1096353
17309,0001-20100320-165-2696-1-5853,1,2010-03-20,191,仮払消費税等,懇親会会費,0,476,1095877
17316,0001-20100320-45-2671-1-5803,0,2010-03-20,733,交際接待費,コーヒー代2名,0,1200,1094677
17317,0001-20100320-45-2671-1-5803,1,2010-03-20,191,仮払消費税等,コーヒー代2名,0,60,1094617
17320,0001-20100320-48-2672-1-5805,0,2010-03-20,740,車両費,ガソリン代,0,4099,1090518
17321,0001-20100320-48-2672-1-5805,1,2010-03-20,191,仮払消費税等,ガソリン代,0,204,1090314
17324,0001-20100320-53-2673-1-5807,0,2010-03-20,740,車両費,高速代,0,381,1089933
17325,0001-20100320-53-2673-1-5807,1,2010-03-20,191,仮払消費税等,高速代,0,19,1089914
17327,0001-20100320-53-2673-1-5807,3,2010-03-20,740,車両費,高速代,0,1000,1088914
17328,0001-20100320-53-2673-1-5807,4,2010-03-20,191,仮払消費税等,高速代,0,50,1088864
17329,0001-20100320-53-2673-1-5807,5,2010-03-20,740,車両費,高速代,0,1000,1087864
17330,0001-20100320-53-2673-1-5807,6,2010-03-20,191,仮払消費税等,高速代,0,50,1087814
17354,0001-20100320-79-2678-1-5817,0,2010-03-20,724,福利厚生費,景品代,0,93822,993992
17355,0001-20100320-79-2678-1-5817,1,2010-03-20,191,仮払消費税等,景品代,0,4691,989301
17375,0001-20100321-163-2703-1-5867,1,2010-03-21,742,諸会費,会費,0,18000,971301
17385,0001-20100321-25-2698-1-5857,0,2010-03-21,726,旅費交通費,旅費,0,53334,917967
17386,0001-20100321-25-2698-1-5857,1,2010-03-21,191,仮払消費税等,旅費,0,2666,915301
17397,0001-20100321-6-2697-1-5855,0,2010-03-21,732,広告宣伝費,広告料,0,4762,910539
17398,0001-20100321-6-2697-1-5855,1,2010-03-21,191,仮払消費税等,広告料,0,238,910301
17419,0001-20100322-107-2710-1-5881,0,2010-03-22,733,交際接待費,お見舞い,0,9524,900777
17420,0001-20100322-107-2710-1-5881,1,2010-03-22,191,仮払消費税等,お見舞い,0,476,900301
17429,0001-20100322-166-2712-1-5885,0,2010-03-22,791,雑費,ダスキン代,0,1800,898501
17430,0001-20100322-166-2712-1-5885,1,2010-03-22,191,仮払消費税等,ダスキン代,0,90,898411
17433,0001-20100322-24-2706-1-5873,0,2010-03-22,726,旅費交通費,JR回数券,0,87620,810791
17434,0001-20100322-24-2706-1-5873,1,2010-03-22,191,仮払消費税等,JR回数券,0,4380,806411
17441,0001-20100322-74-2707-1-5875,0,2010-03-22,740,車両費,ガソリン代,0,6771,799640
17442,0001-20100322-74-2707-1-5875,1,2010-03-22,191,仮払消費税等,ガソリン代,0,338,799302
17444,0001-20100322-74-2707-1-5875,3,2010-03-22,740,車両費,高速代,0,5143,794159
17445,0001-20100322-74-2707-1-5875,4,2010-03-22,191,仮払消費税等,高速代,0,257,793902
17447,0001-20100322-90-2708-1-5877,0,2010-03-22,791,雑費,ダスキン代,0,9048,784854
17448,0001-20100322-90-2708-1-5877,1,2010-03-22,191,仮払消費税等,ダスキン代,0,452,784402
17455,0001-20100323-12-2713-1-5887,0,2010-03-23,740,車両費,ガソリン代,0,3298,781104
17456,0001-20100323-12-2713-1-5887,1,2010-03-23,191,仮払消費税等,ガソリン代,0,164,780940
17458,0001-20100323-12-2713-1-5887,3,2010-03-23,740,車両費,駐車代,0,762,780178
17459,0001-20100323-12-2713-1-5887,4,2010-03-23,191,仮払消費税等,駐車代,0,38,780140
17461,0001-20100323-140-2718-1-5897,0,2010-03-23,726,旅費交通費,旅費,0,11715,768425
17462,0001-20100323-140-2718-1-5897,1,2010-03-23,191,仮払消費税等,旅費,0,585,767840
17469,0001-20100323-54-2715-1-5891,0,2010-03-23,740,車両費,高速代,0,1810,766030
17470,0001-20100323-54-2715-1-5891,1,2010-03-23,191,仮払消費税等,高速代,0,90,765940
17472,0001-20100323-54-2715-1-5891,3,2010-03-23,740,車両費,高速代,0,2572,763368
17473,0001-20100323-54-2715-1-5891,4,2010-03-23,191,仮払消費税等,高速代,0,128,763240
17475,0001-20100323-75-2716-1-5893,0,2010-03-23,740,車両費,ガソリン代,0,5686,757554
17476,0001-20100323-75-2716-1-5893,1,2010-03-23,191,仮払消費税等,ガソリン代,0,284,757270
17594,0001-20100324-108-2723-1-5907,0,2010-03-24,733,交際接待費,食事代,0,1296,755974
17595,0001-20100324-108-2723-1-5907,1,2010-03-24,191,仮払消費税等,食事代,0,64,755910
17611,0001-20100324-26-2719-1-5899,0,2010-03-24,726,旅費交通費,旅費,0,29524,726386
17612,0001-20100324-26-2719-1-5899,1,2010-03-24,191,仮払消費税等,旅費,0,1476,724910
17664,0001-20100325-121-2734-1-5929,0,2010-03-25,724,福利厚生費,お茶代,0,15715,709195
17665,0001-20100325-121-2734-1-5929,1,2010-03-25,191,仮払消費税等,お茶代,0,785,708410
17673,0001-20100325-138-2736-1-5933,0,2010-03-25,740,車両費,高速代,0,4351,704059
17674,0001-20100325-138-2736-1-5933,1,2010-03-25,191,仮払消費税等,高速代,0,217,703842
17676,0001-20100325-138-2736-1-5933,3,2010-03-25,740,車両費,ガソリン代,0,3408,700434
17677,0001-20100325-138-2736-1-5933,4,2010-03-25,191,仮払消費税等,ガソリン代,0,170,700264
17678,0001-20100325-138-2736-1-5933,5,2010-03-25,740,車両費,高速代,0,5686,694578
17679,0001-20100325-138-2736-1-5933,6,2010-03-25,191,仮払消費税等,高速代,0,284,694294
17680,0001-20100325-138-2736-1-5933,7,2010-03-25,740,車両費,高速代,0,4287,690007
17681,0001-20100325-138-2736-1-5933,8,2010-03-25,191,仮払消費税等,高速代,0,214,689793
17682,0001-20100325-138-2736-1-5933,9,2010-03-25,740,車両費,高速代,0,2569,687224
17683,0001-20100325-138-2736-1-5933,10,2010-03-25,191,仮払消費税等,高速代,0,128,687096
17684,0001-20100325-138-2736-1-5933,11,2010-03-25,740,車両費,高速代,0,1096,686000
17685,0001-20100325-138-2736-1-5933,12,2010-03-25,191,仮払消費税等,高速代,0,54,685946
17686,0001-20100325-138-2736-1-5933,13,2010-03-25,740,車両費,駐車代,0,3372,682574
17687,0001-20100325-138-2736-1-5933,14,2010-03-25,191,仮払消費税等,駐車代,0,168,682406
17690,0001-20100325-173-2737-1-5935,1,2010-03-25,738,租税公課,収入印紙代,0,24000,658406
17696,0001-20100326-105-2745-1-5951,0,2010-03-26,733,交際接待費,飲食代　居酒屋ラッキー4名,0,11862,646544
17697,0001-20100326-105-2745-1-5951,1,2010-03-26,191,仮払消費税等,飲食代　居酒屋ラッキー4名,0,593,645951
17699,0001-20100326-105-2745-1-5951,3,2010-03-26,733,交際接待費,飲食代　スナック北新地,0,25086,620865
17700,0001-20100326-105-2745-1-5951,4,2010-03-26,191,仮払消費税等,飲食代　スナック北新地,0,1254,619611
17718,0001-20100326-35-2738-1-5937,0,2010-03-26,739,新聞図書費,新聞代,0,3739,615872
17719,0001-20100326-35-2738-1-5937,1,2010-03-26,191,仮払消費税等,新聞代,0,186,615686
17736,0001-20100326-75-2742-1-5945,0,2010-03-26,733,交際接待費,コーヒー代2名,0,1200,614486
17737,0001-20100326-75-2742-1-5945,1,2010-03-26,191,仮払消費税等,コーヒー代2名,0,60,614426
17740,0001-20100326-76-2743-1-5947,0,2010-03-26,740,車両費,ガソリン代,0,4961,609465
17741,0001-20100326-76-2743-1-5947,1,2010-03-26,191,仮払消費税等,ガソリン代,0,248,609217
17743,0001-20100326-76-2743-1-5947,3,2010-03-26,740,車両費,駐車代,0,572,608645
17744,0001-20100326-76-2743-1-5947,4,2010-03-26,191,仮払消費税等,駐車代,0,28,608617
17746,0001-20100326-88-2744-1-5949,0,2010-03-26,739,新聞図書費,新聞代,0,3399,605218
17747,0001-20100326-88-2744-1-5949,1,2010-03-26,191,仮払消費税等,新聞代,0,169,605049
17750,0001-20100327-114-2755-1-5971,0,2010-03-27,739,新聞図書費,新聞代,0,2540,602509
17751,0001-20100327-114-2755-1-5971,1,2010-03-27,191,仮払消費税等,新聞代,0,126,602383
17753,0001-20100327-114-2755-1-5971,3,2010-03-27,739,新聞図書費,新聞代,0,2864,599519
17754,0001-20100327-114-2755-1-5971,4,2010-03-27,191,仮払消費税等,新聞代,0,143,599376
17756,0001-20100327-14-2749-1-5959,0,2010-03-27,740,車両費,ガソリン代,0,2858,596518
17757,0001-20100327-14-2749-1-5959,1,2010-03-27,191,仮払消費税等,ガソリン代,0,142,596376
17769,0001-20100327-60-2752-1-5965,0,2010-03-27,726,旅費交通費,旅費,0,10667,585709
17770,0001-20100327-60-2752-1-5965,1,2010-03-27,191,仮払消費税等,旅費,0,533,585176
17773,0001-20100327-72-2753-1-5967,0,2010-03-27,739,新聞図書費,新聞代,0,2864,582312
17774,0001-20100327-72-2753-1-5967,1,2010-03-27,191,仮払消費税等,新聞代,0,143,582169
17776,0001-20100327-72-2753-1-5967,3,2010-03-27,739,新聞図書費,新聞代,0,2815,579354
17777,0001-20100327-72-2753-1-5967,4,2010-03-27,191,仮払消費税等,新聞代,0,140,579214
17778,0001-20100327-72-2753-1-5967,5,2010-03-27,739,新聞図書費,新聞代,0,3399,575815
17779,0001-20100327-72-2753-1-5967,6,2010-03-27,191,仮払消費税等,新聞代,0,169,575646
17801,0001-20100328-170-2760-1-5981,0,2010-03-28,739,新聞図書費,新聞代,0,2864,572782
17802,0001-20100328-170-2760-1-5981,1,2010-03-28,191,仮払消費税等,新聞代,0,143,572639
17805,0001-20100328-39-2757-1-5975,0,2010-03-28,724,福利厚生費,会費,0,8572,564067
17806,0001-20100328-39-2757-1-5975,1,2010-03-28,191,仮払消費税等,会費,0,428,563639
17809,0001-20100328-81-2758-1-5977,0,2010-03-28,726,旅費交通費,ＪＲ代,0,9334,554305
17810,0001-20100328-81-2758-1-5977,1,2010-03-28,191,仮払消費税等,ＪＲ代,0,466,553839
17813,0001-20100328-9-2756-1-5973,0,2010-03-28,733,交際接待費,手土産代　総合経営,0,5000,548839
17814,0001-20100328-9-2756-1-5973,1,2010-03-28,191,仮払消費税等,手土産代　総合経営,0,250,548589
17817,0001-20100329-27-2761-1-5983,0,2010-03-29,726,旅費交通費,旅費,0,44324,504265
17818,0001-20100329-27-2761-1-5983,1,2010-03-29,191,仮払消費税等,旅費,0,2216,502049
17820,0001-20100329-27-2761-1-5983,3,2010-03-29,726,旅費交通費,旅費,0,56000,446049
17821,0001-20100329-27-2761-1-5983,4,2010-03-29,191,仮払消費税等,旅費,0,2800,443249
17822,0001-20100329-27-2761-1-5983,5,2010-03-29,726,旅費交通費,旅費,0,30858,412391
17823,0001-20100329-27-2761-1-5983,6,2010-03-29,191,仮払消費税等,旅費,0,1542,410849
17825,0001-20100329-83-2762-1-5985,0,2010-03-29,740,車両費,車両管理費,0,49048,361801
17826,0001-20100329-83-2762-1-5985,1,2010-03-29,191,仮払消費税等,車両管理費,0,2452,359349
17843,0001-20100330-155-2765-1-5991,0,2010-03-30,740,車両費,ガソリン代,0,6801,352548
17844,0001-20100330-155-2765-1-5991,1,2010-03-30,191,仮払消費税等,ガソリン代,0,340,352208
17846,0001-20100330-155-2765-1-5991,3,2010-03-30,740,車両費,高速代,0,1143,351065
17847,0001-20100330-155-2765-1-5991,4,2010-03-30,191,仮払消費税等,高速代,0,57,351008
17853,0001-20100331-100-2785-1-6031,0,2010-03-31,724,福利厚生費,会費,0,5715,345293
17854,0001-20100331-100-2785-1-6031,1,2010-03-31,191,仮払消費税等,会費,0,285,345008
17978,0001-20100331-117-2793-1-6047,1,2010-03-31,152,売掛金,10年3月31日伝票No480合同会社　エイム商事,528830,0,873838
18092,0001-20100331-13-2768-1-5997,0,2010-03-31,740,車両費,ガソリン代,0,9524,864314
18093,0001-20100331-13-2768-1-5997,1,2010-03-31,191,仮払消費税等,ガソリン代,0,476,863838
18183,0001-20100331-15-2769-1-5999,0,2010-03-31,740,車両費,洗車代,0,2858,860980
18184,0001-20100331-15-2769-1-5999,1,2010-03-31,191,仮払消費税等,洗車代,0,142,860838
18231,0001-20100331-49-2772-1-6005,3,2010-03-31,740,車両費,ガソリン代,0,2626,858212
18232,0001-20100331-49-2772-1-6005,4,2010-03-31,191,仮払消費税等,ガソリン代,0,131,858081
18234,0001-20100331-49-2772-1-6005,6,2010-03-31,740,車両費,ガソリン代,0,5729,852352
18235,0001-20100331-49-2772-1-6005,7,2010-03-31,191,仮払消費税等,ガソリン代,0,286,852066
18243,0001-20100331-55-2773-1-6007,0,2010-03-31,740,車両費,車両管理費,0,23810,828256
18244,0001-20100331-55-2773-1-6007,1,2010-03-31,191,仮払消費税等,車両管理費,0,1190,827066
18246,0001-20100331-55-2773-1-6007,3,2010-03-31,740,車両費,車両管理費,0,26667,800399
18247,0001-20100331-55-2773-1-6007,4,2010-03-31,191,仮払消費税等,車両管理費,0,1333,799066
18248,0001-20100331-55-2773-1-6007,5,2010-03-31,740,車両費,高速代,0,7667,791399
18249,0001-20100331-55-2773-1-6007,6,2010-03-31,191,仮払消費税等,高速代,0,383,791016
18272,0001-20100331-67-2777-1-6015,1,2010-03-31,742,諸会費,会費支払い,0,30000,761016
,,,2010-03,,※※月計※※,会費支払い,1376159,2428302,761016
