num,GL02,GL02-GL55,date,contra_acct,contra_acct_name,note,dbt_amount,cdt_amount,balance
,,,,191,仮払消費税等,,33598743,0,33598743
3,0001-20090401-18-1-1-463,1,2009-04-01,111,現金,旅費,928,0,928
7,0001-20090401-246-2-1-465,1,2009-04-01,111,現金,旅費,476,0,1404
11,0001-20090402-122-5-1-471,1,2009-04-02,111,現金,証明書発行手数料,50,0,1454
15,0001-20090402-142-6-1-473,1,2009-04-02,111,現金,高速代,122,0,1576
18,0001-20090402-142-6-1-473,4,2009-04-02,111,現金,駐車代,29,0,1605
20,0001-20090402-142-6-1-473,6,2009-04-02,111,現金,ガソリン代,230,0,1835
22,0001-20090402-142-6-1-473,8,2009-04-02,111,現金,洗車券代,285,0,2120
25,0001-20090402-19-3-1-467,1,2009-04-02,111,現金,旅費,523,0,2643
29,0001-20090402-68-4-1-469,1,2009-04-02,111,現金,トイレットペーパー他,141,0,2784
33,0001-20090403-134-8-1-477,1,2009-04-03,111,現金,用紙,742,0,3526
40,0001-20090404-310-9-1-479,1,2009-04-04,111,現金,ガソリン代,324,0,3850
43,0001-20090404-310-9-1-479,4,2009-04-04,111,現金,高速代,485,0,4335
45,0001-20090404-310-9-1-479,6,2009-04-04,111,現金,駐車代,60,0,4395
48,0001-20090405-133-11-1-483,1,2009-04-05,131,普通預金,税理士報酬,6652,0,11047
54,0001-20090405-139-12-1-485,1,2009-04-05,322,未払金,制服代,2649,0,13696
62,0001-20090405-254-13-1-487,3,2009-04-05,152,売掛金,09年4月5日伝票No190株式会社　渡辺産業,30,0,13726
70,0001-20090405-255-14-1-489,3,2009-04-05,152,売掛金,09年4月5日伝票No191佐々木販売株式会社,22,0,13748
78,0001-20090405-256-15-1-491,3,2009-04-05,152,売掛金,09年4月5日伝票No192岩下物産株式会社,35,0,13783
82,0001-20090405-76-10-1-481,1,2009-04-05,322,未払金,制服代,2666,0,16449
86,0001-20090406-10-16-1-493,1,2009-04-06,111,現金,ガソリン代,201,0,16650
90,0001-20090406-106-19-1-499,1,2009-04-06,111,現金,食事代　ホテルララダ2名,268,0,16918
93,0001-20090406-106-19-1-499,4,2009-04-06,111,現金,飲食代　スナック北新地,1532,0,18450
96,0001-20090406-110-20-1-501,1,2009-04-06,111,現金,タクシー代,109,0,18559
100,0001-20090406-123-21-1-503,1,2009-04-06,111,現金,切手代,1904,0,20463
107,0001-20090406-147-23-1-507,1,2009-04-06,322,未払金,ガソリン代,244,0,20707
111,0001-20090406-156-24-1-509,1,2009-04-06,111,現金,出張旅費,357,0,21064
115,0001-20090406-236-25-1-511,1,2009-04-06,111,現金,ゴルフプレー代2名,1261,0,22325
126,0001-20090406-42-17-1-495,1,2009-04-06,111,現金,昼食代　フロンティホテル,221,0,22546
130,0001-20090406-84-18-1-497,1,2009-04-06,111,現金,切手代,3333,0,25879
134,0001-20090407-102-35-1-531,1,2009-04-07,111,現金,手土産代　阿部商店,50,0,25929
138,0001-20090407-20-27-1-515,1,2009-04-07,111,現金,旅費,1857,0,27786
142,0001-20090407-21-28-1-517,1,2009-04-07,111,現金,JR代,3309,0,31095
146,0001-20090407-22-29-1-519,1,2009-04-07,111,現金,旅費,2380,0,33475
150,0001-20090407-43-30-1-521,1,2009-04-07,111,現金,手土産代　阿部商事,315,0,33790
154,0001-20090407-56-31-1-523,1,2009-04-07,111,現金,旅費,1023,0,34813
158,0001-20090407-57-32-1-525,1,2009-04-07,111,現金,JR代,4657,0,39470
162,0001-20090407-58-33-1-527,1,2009-04-07,111,現金,旅費,3333,0,42803
166,0001-20090407-69-34-1-529,1,2009-04-07,111,現金,お茶代,66,0,42869
169,0001-20090407-69-34-1-529,4,2009-04-07,111,現金,コーヒー代,141,0,43010
172,0001-20090408-143-37-1-535,1,2009-04-08,111,現金,ガソリン代,339,0,43349
176,0001-20090408-50-36-1-533,1,2009-04-08,111,現金,高速代,57,0,43406
180,0001-20090410-112-40-1-541,1,2009-04-10,131,普通預金,電話代,11753,0,55159
186,0001-20090410-129-41-1-543,1,2009-04-10,131,普通預金,家賃支払い,19000,0,74159
192,0001-20090410-149-42-1-545,1,2009-04-10,111,現金,食事代　うどん亭4名,274,0,74433
196,0001-20090410-157-43-1-547,1,2009-04-10,131,普通預金,航空券代,1057,0,75490
202,0001-20090410-162-44-1-549,1,2009-04-10,111,現金,会議　食事代,1190,0,76680
206,0001-20090410-167-45-1-551,1,2009-04-10,131,普通預金,家賃支払い,30000,0,106680
211,0001-20090410-167-45-1-551,4,2009-04-10,131,普通預金,電話代,7905,0,114585
217,0001-20090410-168-46-1-553,1,2009-04-10,322,未払金,有線,300,0,114885
220,0001-20090410-168-46-1-553,4,2009-04-10,322,未払金,警備料,2142,0,117027
233,0001-20090410-232-48-1-557,1,2009-04-10,131,普通預金,家賃支払,60000,0,177027
239,0001-20090410-233-49-1-559,1,2009-04-10,131,普通預金,家賃支払,40000,0,217027
245,0001-20090410-234-50-1-561,1,2009-04-10,322,未払金,有線,250,0,217277
248,0001-20090410-234-50-1-561,4,2009-04-10,322,未払金,警備料,1714,0,218991
251,0001-20090410-248-51-1-563,1,2009-04-10,111,現金,旅費,497,0,219488
259,0001-20090410-257-52-1-565,3,2009-04-10,152,売掛金,09年4月10日伝票No193株式会社　ミナミ,35,0,219523
273,0001-20090410-260-55-1-571,3,2009-04-10,152,売掛金,09年4月10日伝票No494株式会社　藤田東京本社,40,0,219563
290,0001-20090410-33-38-1-537,1,2009-04-10,131,普通預金,家賃支払い,15238,0,234801
295,0001-20090410-33-38-1-537,4,2009-04-10,131,普通預金,電話代,7815,0,242616
301,0001-20090410-85-39-1-539,1,2009-04-10,131,普通預金,電話代,6151,0,248767
318,0001-20090411-73-59-1-579,1,2009-04-11,111,現金,飲食代　居酒屋富士6名,1263,0,250030
322,0001-20090411-74-60-1-581,1,2009-04-11,111,現金,飲食代　スナック新世界6名,1857,0,251887
326,0001-20090412-155-62-1-585,1,2009-04-12,111,現金,ガソリン代,225,0,252112
329,0001-20090412-155-62-1-585,4,2009-04-12,111,現金,駐車代,28,0,252140
332,0001-20090412-249-63-1-587,1,2009-04-12,111,現金,旅費,514,0,252654
335,0001-20090412-249-63-1-587,4,2009-04-12,111,現金,タクシー代,238,0,252892
338,0001-20090412-311-64-1-589,1,2009-04-12,111,現金,タイヤ交換,3523,0,256415
342,0001-20090413-11-65-1-591,1,2009-04-13,111,現金,ガソリン代,152,0,256567
346,0001-20090413-144-67-1-595,1,2009-04-13,111,現金,ウォッシャー液代,28,0,256595
349,0001-20090413-144-67-1-595,4,2009-04-13,111,現金,高速代,114,0,256709
351,0001-20090413-144-67-1-595,6,2009-04-13,111,現金,ガソリン代,291,0,257000
354,0001-20090413-150-68-1-597,1,2009-04-13,111,現金,ゴルフプレー代,666,0,257666
358,0001-20090413-158-69-1-599,1,2009-04-13,111,現金,出張旅費,714,0,258380
362,0001-20090413-17-66-1-593,1,2009-04-13,111,現金,ウォッシャー液,17,0,258397
365,0001-20090413-17-66-1-593,4,2009-04-13,111,現金,駐車代,38,0,258435
368,0001-20090414-23-70-1-601,1,2009-04-14,111,現金,旅費,1333,0,259768
371,0001-20090414-23-70-1-601,4,2009-04-14,111,現金,旅費,1476,0,261244
373,0001-20090414-23-70-1-601,6,2009-04-14,111,現金,旅費,1833,0,263077
376,0001-20090414-46-71-1-603,1,2009-04-14,111,現金,ガソリン代,117,0,263194
379,0001-20090414-46-71-1-603,4,2009-04-14,111,現金,駐車代,88,0,263282
381,0001-20090414-46-71-1-603,6,2009-04-14,111,現金,高速代,152,0,263434
384,0001-20090414-51-72-1-605,1,2009-04-14,111,現金,高速代,75,0,263509
387,0001-20090414-51-72-1-605,4,2009-04-14,111,現金,駐車代,30,0,263539
389,0001-20090414-51-72-1-605,6,2009-04-14,111,現金,駐車代,40,0,263579
391,0001-20090414-51-72-1-605,8,2009-04-14,111,現金,高速代,54,0,263633
402,0001-20090415-151-77-1-615,1,2009-04-15,111,現金,飲食代　居酒屋バージョイ,837,0,264470
405,0001-20090415-151-77-1-615,4,2009-04-15,111,現金,飲食代　ハプコミック,1050,0,265520
408,0001-20090415-243-78-1-617,1,2009-04-15,111,現金,ガソリン代,297,0,265817
425,0001-20090415-263-80-1-621,3,2009-04-15,152,売掛金,09年4月15日伝票No195五越株式会社,40,0,265857
433,0001-20090415-264-81-1-623,3,2009-04-15,152,売掛金,09年4月15日伝票No196株式会社　エントリー,40,0,265897
441,0001-20090415-265-82-1-625,3,2009-04-15,152,売掛金,09年4月15日伝票No197高橋物産株式会社,40,0,265937
454,0001-20090415-267-84-1-629,3,2009-04-15,152,売掛金,09年4月15日伝票No199株式会社　久城商事,30,0,265967
463,0001-20090415-4-73-1-607,1,2009-04-15,322,未払金,広告費,1500,0,267467
467,0001-20090415-79-74-1-609,1,2009-04-15,111,現金,景品代,2165,0,269632
471,0001-20090416-103-87-1-635,1,2009-04-16,111,現金,コーヒー代5名,127,0,269759
475,0001-20090416-136-88-1-637,1,2009-04-16,111,現金,ダスキン代,785,0,270544
479,0001-20090416-61-86-1-633,1,2009-04-16,131,普通預金,電話代,8063,0,278607
485,0001-20090417-12-89-1-639,1,2009-04-17,111,現金,ガソリン代,222,0,278829
488,0001-20090417-12-89-1-639,4,2009-04-17,111,現金,高速代,28,0,278857
490,0001-20090417-12-89-1-639,6,2009-04-17,111,現金,駐車代,57,0,278914
493,0001-20090417-47-90-1-641,1,2009-04-17,111,現金,ガソリン代,120,0,279034
497,0001-20090417-52-91-1-643,1,2009-04-17,111,現金,ガソリン代,109,0,279143
500,0001-20090417-52-91-1-643,4,2009-04-17,111,現金,高速代,54,0,279197
502,0001-20090417-52-91-1-643,6,2009-04-17,111,現金,駐車代,57,0,279254
505,0001-20090418-237-92-1-645,1,2009-04-18,111,現金,ゴルフプレー代,571,0,279825
509,0001-20090419-244-93-1-647,1,2009-04-19,111,現金,ガソリン代,336,0,280161
520,0001-20090420-101-109-1-679,1,2009-04-20,322,未払金,広告料,2500,0,282661
524,0001-20090420-118-110-1-681,1,2009-04-20,322,未払金,コピー代,333,0,282994
528,0001-20090420-132-111-1-683,1,2009-04-20,131,普通預金,電気代,5678,0,288672
533,0001-20090420-132-111-1-683,4,2009-04-20,131,普通預金,水道代,311,0,288983
536,0001-20090420-135-112-1-685,1,2009-04-20,322,未払金,事務用品,148,0,289131
546,0001-20090420-153-114-1-689,1,2009-04-20,111,現金,コーヒー代他2名,92,0,289223
553,0001-20090420-169-116-1-693,1,2009-04-20,131,普通預金,電気料,6024,0,295247
558,0001-20090420-169-116-1-693,4,2009-04-20,131,普通預金,水道料,265,0,295512
561,0001-20090420-235-117-1-695,1,2009-04-20,322,未払金,カウンター料金,300,0,295812
565,0001-20090420-24-97-1-655,1,2009-04-20,111,現金,JR回数券,3934,0,299746
569,0001-20090420-241-118-1-697,1,2009-04-20,322,未払金,ファイル等,1699,0,301445
572,0001-20090420-241-118-1-697,4,2009-04-20,322,未払金,飲料水,11952,0,313397
574,0001-20090420-241-118-1-697,6,2009-04-20,322,未払金,名刺代,3952,0,317349
581,0001-20090420-269-119-1-699,3,2009-04-20,152,売掛金,09年4月20日伝票No200株式会社　ＹＡＧ,35,0,317384
615,0001-20090420-31-98-1-657,1,2009-04-20,322,未払金,コピー代,127,0,317511
619,0001-20090420-34-99-1-659,1,2009-04-20,131,普通預金,電気代,4581,0,322092
624,0001-20090420-34-99-1-659,4,2009-04-20,131,普通預金,水道代,207,0,322299
627,0001-20090420-45-100-1-661,1,2009-04-20,111,現金,食事代　トン吉4名,393,0,322692
631,0001-20090420-48-101-1-663,1,2009-04-20,111,現金,ガソリン代,204,0,322896
635,0001-20090420-53-102-1-665,1,2009-04-20,111,現金,高速代,19,0,322915
638,0001-20090420-53-102-1-665,4,2009-04-20,111,現金,駐車代,100,0,323015
640,0001-20090420-53-102-1-665,6,2009-04-20,111,現金,ガソリン代,305,0,323320
643,0001-20090420-6-95-1-651,1,2009-04-20,111,現金,広告料,238,0,323558
647,0001-20090420-64-103-1-667,1,2009-04-20,131,普通預金,電気料,8732,0,332290
652,0001-20090420-64-103-1-667,4,2009-04-20,131,普通預金,水道料,449,0,332739
655,0001-20090420-7-96-1-653,1,2009-04-20,111,現金,食事代,71,0,332810
658,0001-20090420-7-96-1-653,4,2009-04-20,111,現金,食事代,58,0,332868
661,0001-20090420-71-104-1-669,1,2009-04-20,322,未払金,事務用品,122,0,332990
664,0001-20090420-71-104-1-669,4,2009-04-20,322,未払金,事務用品,808,0,333798
666,0001-20090420-71-104-1-669,6,2009-04-20,322,未払金,カウンター料金,1523,0,335321
669,0001-20090420-89-105-1-671,1,2009-04-20,131,普通預金,電気料,4119,0,339440
674,0001-20090420-89-105-1-671,4,2009-04-20,131,普通預金,水道料,187,0,339627
676,0001-20090420-89-105-1-671,6,2009-04-20,131,普通預金,ガス代,195,0,339822
679,0001-20090420-94-106-1-673,1,2009-04-20,322,未払金,有線,238,0,340060
683,0001-20090420-97-107-1-675,1,2009-04-20,322,未払金,コピー代,1863,0,341923
687,0001-20090420-98-108-1-677,1,2009-04-20,322,未払金,事務用品,750,0,342673
694,0001-20090421-160-129-1-719,1,2009-04-21,111,現金,出張旅費,3333,0,346006
698,0001-20090421-25-126-1-713,1,2009-04-21,111,現金,旅費,2666,0,348672
702,0001-20090421-59-127-1-715,1,2009-04-21,111,現金,旅費,1428,0,350100
706,0001-20090422-104-134-1-729,1,2009-04-22,111,現金,食事代　お好み焼きやきやき2名,158,0,350258
710,0001-20090422-105-135-1-731,1,2009-04-22,111,現金,飲食代　会費制2名,952,0,351210
713,0001-20090422-105-135-1-731,4,2009-04-22,111,現金,飲食代　梅田小路5名,1095,0,352305
715,0001-20090422-105-135-1-731,6,2009-04-22,111,現金,食事代　ホテルジャーマニー2名,142,0,352447
721,0001-20090422-152-137-1-735,1,2009-04-22,111,現金,飲食代　居酒屋くるみ3名,660,0,353107
725,0001-20090422-161-138-1-737,1,2009-04-22,111,現金,旅費,516,0,353623
729,0001-20090422-166-139-1-739,1,2009-04-22,111,現金,ダスキン代,90,0,353713
733,0001-20090422-245-140-1-741,1,2009-04-22,111,現金,駐車代,28,0,353741
736,0001-20090422-245-140-1-741,4,2009-04-22,111,現金,高速代,38,0,353779
738,0001-20090422-245-140-1-741,6,2009-04-22,111,現金,ガソリン代,261,0,354040
741,0001-20090422-3-130-1-721,1,2009-04-22,322,未払金,宿泊代,1424,0,355464
745,0001-20090422-38-131-1-723,1,2009-04-22,322,未払金,宿泊費,2293,0,357757
749,0001-20090422-90-132-1-725,1,2009-04-22,111,現金,ダスキン代,500,0,358257
753,0001-20090422-95-133-1-727,1,2009-04-22,322,未払金,清掃料,3413,0,361670
757,0001-20090423-140-146-1-753,1,2009-04-23,111,現金,旅費,492,0,362162
761,0001-20090423-141-147-1-755,1,2009-04-23,111,現金,JR代,3309,0,365471
765,0001-20090423-164-148-1-757,1,2009-04-23,111,現金,事務用品,75,0,365546
769,0001-20090423-26-141-1-743,1,2009-04-23,111,現金,旅費,523,0,366069
773,0001-20090423-28-142-1-745,1,2009-04-23,322,未払金,タクシー代,115,0,366184
777,0001-20090423-32-143-1-747,1,2009-04-23,322,未払金,事務用品費,88,0,366272
781,0001-20090423-54-144-1-749,1,2009-04-23,111,現金,高速代,90,0,366362
784,0001-20090423-54-144-1-749,4,2009-04-23,111,現金,駐車代,40,0,366402
787,0001-20090423-86-145-1-751,1,2009-04-23,111,現金,切手代,3333,0,369735
791,0001-20090424-108-150-1-761,1,2009-04-24,111,現金,コーヒー代,64,0,369799
795,0001-20090424-159-151-1-763,1,2009-04-24,111,現金,タクシー代,307,0,370106
799,0001-20090424-8-149-1-759,1,2009-04-24,111,現金,親睦会会費,1428,0,371534
802,0001-20090424-8-149-1-759,4,2009-04-24,111,現金,差し入れ,150,0,371684
805,0001-20090425-111-156-1-773,1,2009-04-25,322,未払金,タクシー代,590,0,372274
809,0001-20090425-113-157-1-775,1,2009-04-25,131,普通預金,携帯代,2787,0,375061
815,0001-20090425-114-158-1-777,1,2009-04-25,111,現金,新聞代,126,0,375187
818,0001-20090425-114-158-1-777,4,2009-04-25,111,現金,新聞代,143,0,375330
821,0001-20090425-121-159-1-779,1,2009-04-25,111,現金,お茶代,476,0,375806
830,0001-20090425-146-161-1-783,1,2009-04-25,322,未払金,業務委託費,7000,0,382806
834,0001-20090425-170-162-1-785,1,2009-04-25,111,現金,新聞代,143,0,382949
838,0001-20090425-171-163-1-787,1,2009-04-25,131,普通預金,携帯代,2004,0,384953
844,0001-20090425-172-164-1-789,1,2009-04-25,322,未払金,業務委託費支払い,6714,0,391667
848,0001-20090425-238-165-1-791,1,2009-04-25,111,現金,ゴルフプレー代,676,0,392343
974,0001-20090425-274-168-1-797,3,2009-04-25,152,売掛金,09年4月25日伝票No202株式会社　総合経営,35,0,392378
982,0001-20090425-275-169-1-799,3,2009-04-25,152,売掛金,09年4月25日伝票No203株式会社　小林マーケット,40,0,392418
986,0001-20090425-29-152-1-765,1,2009-04-25,131,普通預金,携帯電話代,3082,0,395500
992,0001-20090425-35-153-1-767,1,2009-04-25,111,現金,新聞代,186,0,395686
996,0001-20090425-87-154-1-769,1,2009-04-25,131,普通預金,携帯代,1819,0,397505
1002,0001-20090425-92-155-1-771,1,2009-04-25,322,未払金,コピー機修繕,857,0,398362
1006,0001-20090426-109-173-1-807,1,2009-04-26,322,未払金,ガソリン代,338,0,398700
1010,0001-20090426-120-174-1-809,1,2009-04-26,322,未払金,業務委託費,25000,0,423700
1014,0001-20090426-148-175-1-811,1,2009-04-26,111,現金,ガソリン代,275,0,423975
1017,0001-20090426-148-175-1-811,4,2009-04-26,111,現金,高速代,57,0,424032
1036,0001-20090426-62-170-1-801,1,2009-04-26,131,普通預金,携帯代,2588,0,426620
1042,0001-20090426-78-171-1-803,1,2009-04-26,322,未払金,業務委託費支払い,9000,0,435620
1046,0001-20090426-88-172-1-805,1,2009-04-26,111,現金,新聞代,169,0,435789
1050,0001-20090427-1-177-1-815,1,2009-04-27,322,未払金,運賃　佐川急便,4277,0,440066
1054,0001-20090427-13-179-1-819,1,2009-04-27,322,未払金,ガソリン代,599,0,440665
1058,0001-20090427-14-180-1-821,1,2009-04-27,111,現金,ガソリン代,142,0,440807
1062,0001-20090427-15-181-1-823,1,2009-04-27,111,現金,車両管理費,1190,0,441997
1071,0001-20090427-37-183-1-827,1,2009-04-27,322,未払金,業務委託費,60190,0,502187
1075,0001-20090427-39-184-1-829,1,2009-04-27,111,現金,会費,428,0,502615
1079,0001-20090427-72-185-1-831,1,2009-04-27,111,現金,新聞代,143,0,502758
1082,0001-20090427-72-185-1-831,4,2009-04-27,111,現金,新聞代,140,0,502898
1084,0001-20090427-72-185-1-831,6,2009-04-27,111,現金,新聞代,169,0,503067
1090,0001-20090428-27-186-1-833,1,2009-04-28,111,現金,旅費,1333,0,504400
1093,0001-20090428-27-186-1-833,4,2009-04-28,111,現金,旅費,1476,0,505876
1095,0001-20090428-27-186-1-833,6,2009-04-28,111,現金,旅費,1071,0,506947
1105,0001-20090428-93-187-1-835,1,2009-04-28,322,未払金,修繕費,850,0,507797
1109,0001-20090430-100-205-1-871,1,2009-04-30,111,現金,会費,285,0,508082
1118,0001-20090430-116-207-1-875,1,2009-04-30,131,普通預金,リース料,4000,0,512082
1127,0001-20090430-137-209-1-879,1,2009-04-30,322,未払金,有線,300,0,512382
1130,0001-20090430-137-209-1-879,4,2009-04-30,322,未払金,警備料,2142,0,514524
1132,0001-20090430-137-209-1-879,6,2009-04-30,131,普通預金,高速料,2538,0,517062
1137,0001-20090430-137-209-1-879,9,2009-04-30,322,未払金,清掃料,3500,0,520562
1141,0001-20090430-138-210-1-881,1,2009-04-30,111,現金,ガソリン代,170,0,520732
1144,0001-20090430-138-210-1-881,4,2009-04-30,111,現金,高速代,126,0,520858
1147,0001-20090430-145-211-1-883,1,2009-04-30,322,未払金,運賃,7266,0,528124
1151,0001-20090430-154-212-1-885,1,2009-04-30,322,未払金,お花代,600,0,528724
1187,0001-20090430-251-217-1-895,1,2009-04-30,111,現金,旅費,466,0,529190
1302,0001-20090430-281-223-1-907,3,2009-04-30,152,売掛金,09年4月30日伝票No204マークマーケット,40,0,529230
1310,0001-20090430-282-224-1-909,3,2009-04-30,152,売掛金,09年4月30日伝票No205株式会社　ＡＢＣ,40,0,529270
1317,0001-20090430-284-226-1-913,1,2009-04-30,312,買掛金,09年4月1日～09年4月30日分仕入,8855,0,538125
1320,0001-20090430-284-226-1-913,4,2009-04-30,312,買掛金,09年4月1日～09年4月30日分仕入,1128,0,539253
1324,0001-20090430-285-227-1-915,1,2009-04-30,312,買掛金,09年4月1日～09年4月30日分仕入,60164,0,599417
1327,0001-20090430-285-227-1-915,4,2009-04-30,312,買掛金,09年4月1日～09年4月30日分仕入,287189,0,886606
1330,0001-20090430-285-227-1-915,7,2009-04-30,312,買掛金,09年4月1日～09年4月30日分仕入,195684,0,1082290
1333,0001-20090430-285-227-1-915,10,2009-04-30,312,買掛金,09年4月1日～09年4月30日分仕入,15372,0,1097662
1336,0001-20090430-285-227-1-915,13,2009-04-30,312,買掛金,09年4月1日～09年4月30日分仕入,138792,0,1236454
1340,0001-20090430-285-227-1-915,17,2009-04-30,312,買掛金,09年4月1日～09年4月30日分仕入,123071,0,1359525
1342,0001-20090430-285-227-1-915,19,2009-04-30,312,買掛金,09年4月1日～09年4月30日分仕入,19481,0,1379006
1345,0001-20090430-285-227-1-915,22,2009-04-30,312,買掛金,09年4月1日～09年4月30日分仕入,3487,0,1382493
1348,0001-20090430-285-227-1-915,25,2009-04-30,312,買掛金,09年4月1日～09年4月30日分仕入,9024,0,1391517
1351,0001-20090430-285-227-1-915,28,2009-04-30,312,買掛金,09年4月1日～09年4月30日分仕入,1032,0,1392549
1355,0001-20090430-286-228-1-917,1,2009-04-30,312,買掛金,09年4月1日～09年4月30日分仕入,82513,0,1475062
1358,0001-20090430-286-228-1-917,4,2009-04-30,312,買掛金,09年4月1日～09年4月30日分仕入,52998,0,1528060
1361,0001-20090430-286-228-1-917,7,2009-04-30,312,買掛金,09年4月1日～09年4月30日分仕入,161293,0,1689353
1364,0001-20090430-286-228-1-917,10,2009-04-30,312,買掛金,09年4月1日～09年4月30日分仕入,7281,0,1696634
1367,0001-20090430-286-228-1-917,13,2009-04-30,312,買掛金,09年4月1日～09年4月30日分仕入,808,0,1697442
1370,0001-20090430-286-228-1-917,16,2009-04-30,312,買掛金,09年4月1日～09年4月30日分仕入,2030,0,1699472
1373,0001-20090430-286-228-1-917,19,2009-04-30,312,買掛金,09年4月1日～09年4月30日分仕入,561,0,1700033
1377,0001-20090430-287-229-1-919,1,2009-04-30,312,買掛金,09年4月1日～09年4月30日分仕入,43099,0,1743132
1380,0001-20090430-287-229-1-919,4,2009-04-30,312,買掛金,09年4月1日～09年4月30日分仕入,137701,0,1880833
1383,0001-20090430-287-229-1-919,7,2009-04-30,312,買掛金,09年4月1日～09年4月30日分仕入,1647,0,1882480
1386,0001-20090430-287-229-1-919,10,2009-04-30,312,買掛金,09年4月1日～09年4月30日分仕入,158098,0,2040578
1390,0001-20090430-287-229-1-919,14,2009-04-30,312,買掛金,09年4月1日～09年4月30日分仕入,164054,0,2204632
1392,0001-20090430-287-229-1-919,16,2009-04-30,312,買掛金,09年4月1日～09年4月30日分仕入,3384,0,2208016
1395,0001-20090430-287-229-1-919,19,2009-04-30,312,買掛金,09年4月1日～09年4月30日分仕入,13971,0,2221987
1398,0001-20090430-287-229-1-919,22,2009-04-30,312,買掛金,09年4月1日～09年4月30日分仕入,1070,0,2223057
1401,0001-20090430-287-229-1-919,25,2009-04-30,312,買掛金,09年4月1日～09年4月30日分仕入,1034,0,2224091
1405,0001-20090430-288-230-1-921,1,2009-04-30,312,買掛金,09年4月1日～09年4月30日分仕入,3542,0,2227633
1408,0001-20090430-288-230-1-921,4,2009-04-30,312,買掛金,09年4月1日～09年4月30日分仕入,1128,0,2228761
1491,0001-20090430-36-190-1-841,1,2009-04-30,322,未払金,運賃　ヤマト運輸,76817,0,2305578
1494,0001-20090430-36-190-1-841,4,2009-04-30,322,未払金,運賃　佐川急便,52059,0,2357637
1497,0001-20090430-40-191-1-843,1,2009-04-30,322,未払金,広告掲載,2380,0,2360017
1501,0001-20090430-49-192-1-845,1,2009-04-30,322,未払金,ガソリン代,7784,0,2367801
1504,0001-20090430-49-192-1-845,4,2009-04-30,111,現金,高速代,169,0,2367970
1507,0001-20090430-49-192-1-845,7,2009-04-30,111,現金,駐車代,38,0,2368008
1510,0001-20090430-5-189-1-839,1,2009-04-30,131,普通預金,広告費,2500,0,2370508
1516,0001-20090430-55-193-1-847,1,2009-04-30,111,現金,車両管理費,1190,0,2371698
1519,0001-20090430-55-193-1-847,4,2009-04-30,111,現金,車両管理費,1333,0,2373031
1522,0001-20090430-55-193-1-847,7,2009-04-30,111,現金,高速代,383,0,2373414
1526,0001-20090430-60-194-1-849,1,2009-04-30,111,現金,旅費,464,0,2373878
1535,0001-20090430-66-196-1-853,1,2009-04-30,131,普通預金,リース料,9992,0,2383870
1544,0001-20090430-70-198-1-857,1,2009-04-30,322,未払金,有線,300,0,2384170
1547,0001-20090430-70-198-1-857,4,2009-04-30,322,未払金,警備料,2619,0,2386789
1549,0001-20090430-70-198-1-857,6,2009-04-30,322,未払金,清掃料,3500,0,2390289
1553,0001-20090430-77-199-1-859,1,2009-04-30,322,未払金,運賃,8360,0,2398649
1557,0001-20090430-81-200-1-861,1,2009-04-30,322,未払金,お茶代,1000,0,2399649
1561,0001-20090430-82-201-1-863,1,2009-04-30,322,未払金,ガソリン代,1050,0,2400699
1565,0001-20090430-83-202-1-865,1,2009-04-30,111,現金,車両管理費,2380,0,2403079
1569,0001-20090430-96-203-1-867,1,2009-04-30,131,普通預金,警備料,1070,0,2404149
1575,0001-20090430-99-204-1-869,1,2009-04-30,322,未払金,運賃,27839,0,2431988
,,,2009-04,,※※月計※※,,2431988,0,
1579,0001-20090501-148-247-1-955,1,2009-05-01,322,未払金,制服代,2547,0,2434535
1583,0001-20090501-18-246-1-953,1,2009-05-01,111,現金,旅費,1180,0,2435715
1587,0001-20090502-122-248-1-957,1,2009-05-02,111,現金,証明書発行手数料,50,0,2435765
1594,0001-20090502-149-250-1-961,1,2009-05-02,322,未払金,制服代,3348,0,2439113
1598,0001-20090503-10-251-1-963,1,2009-05-03,111,現金,ガソリン代,173,0,2439286
1602,0001-20090503-19-252-1-965,1,2009-05-03,111,現金,旅費,714,0,2440000
1606,0001-20090505-139-258-1-977,1,2009-05-05,322,未払金,制服代,2649,0,2442649
1610,0001-20090505-56-253-1-967,1,2009-05-05,111,現金,旅費,1976,0,2444625
1614,0001-20090505-80-254-1-969,1,2009-05-05,111,現金,タクシー代,452,0,2445077
1622,0001-20090505-89-255-1-971,3,2009-05-05,152,売掛金,09年5月5日伝票No207株式会社　渡辺産業,22,0,2445099
1630,0001-20090505-90-256-1-973,3,2009-05-05,152,売掛金,09年5月5日伝票No208佐々木販売株式会社,30,0,2445129
1639,0001-20090506-106-261-1-983,1,2009-05-06,111,現金,食事代,683,0,2445812
1643,0001-20090506-110-262-1-985,1,2009-05-06,111,現金,タクシー代,156,0,2445968
1647,0001-20090506-133-263-1-987,1,2009-05-06,131,普通預金,税理士報酬,6652,0,2452620
1653,0001-20090506-20-259-1-979,1,2009-05-06,111,現金,旅費,1952,0,2454572
1657,0001-20090506-42-260-1-981,1,2009-05-06,111,現金,食事代　今井百貨店2名,792,0,2455364
1661,0001-20090507-102-269-1-999,1,2009-05-07,111,現金,差し入れ,50,0,2455414
1665,0001-20090507-158-270-1-1001,1,2009-05-07,111,現金,出張旅費,490,0,2455904
1669,0001-20090507-22-264-1-989,1,2009-05-07,111,現金,旅費,2380,0,2458284
1673,0001-20090507-57-265-1-991,1,2009-05-07,111,現金,JR代,4657,0,2462941
1677,0001-20090507-58-266-1-993,1,2009-05-07,111,現金,旅費,3333,0,2466274
1681,0001-20090507-69-267-1-995,1,2009-05-07,111,現金,洗剤代他,114,0,2466388
1685,0001-20090507-81-268-1-997,1,2009-05-07,111,現金,旅費,476,0,2466864
1689,0001-20090508-142-274-1-1009,1,2009-05-08,111,現金,駐車代,38,0,2466902
1692,0001-20090508-142-274-1-1009,4,2009-05-08,111,現金,ガソリン代,340,0,2467242
1695,0001-20090508-147-275-1-1011,1,2009-05-08,322,未払金,ガソリン代,316,0,2467558
1704,0001-20090508-17-271-1-1003,1,2009-05-08,111,現金,夏用ワイパー代,378,0,2467936
1707,0001-20090508-17-271-1-1003,4,2009-05-08,111,現金,ウォッシャー液,17,0,2467953
1713,0001-20090508-43-273-1-1007,1,2009-05-08,111,現金,コーヒー代2名,57,0,2468010
1717,0001-20090509-84-277-1-1015,1,2009-05-09,111,現金,切手代,2270,0,2470280
1726,0001-20090510-141-290-1-1041,1,2009-05-10,111,現金,JR代,2142,0,2472422
1730,0001-20090510-150-291-1-1043,1,2009-05-10,111,現金,飲食代　博多亭4名,1145,0,2473567
1736,0001-20090510-162-292-1-1045,1,2009-05-10,111,現金,会議　食事代,1500,0,2475067
1740,0001-20090510-168-293-1-1047,1,2009-05-10,322,未払金,有線,300,0,2475367
1743,0001-20090510-168-293-1-1047,4,2009-05-10,322,未払金,警備料,2142,0,2477509
1746,0001-20090510-21-278-1-1017,1,2009-05-10,111,現金,JR代,3923,0,2481432
1750,0001-20090510-46-279-1-1019,1,2009-05-10,111,現金,ガソリン代,142,0,2481574
1753,0001-20090510-46-279-1-1019,4,2009-05-10,111,現金,駐車代,71,0,2481645
1755,0001-20090510-46-279-1-1019,6,2009-05-10,111,現金,高速代,322,0,2481967
1768,0001-20090510-68-281-1-1023,1,2009-05-10,322,未払金,有線,250,0,2482217
1771,0001-20090510-68-281-1-1023,4,2009-05-10,322,未払金,警備料,1714,0,2483931
1774,0001-20090510-69-282-1-1025,1,2009-05-10,111,現金,ティッシュ他,46,0,2483977
1782,0001-20090510-92-283-1-1027,3,2009-05-10,152,売掛金,09年5月10日伝票No210株式会社　ミナミ,35,0,2484012
1796,0001-20090510-95-286-1-1033,3,2009-05-10,152,売掛金,09年5月10日伝票No495株式会社　藤田東京本社,40,0,2484052
1808,0001-20090511-112-301-1-1063,1,2009-05-11,131,普通預金,電話代,9350,0,2493402
1814,0001-20090511-129-302-1-1065,1,2009-05-11,131,普通預金,家賃支払い,19000,0,2512402
1820,0001-20090511-149-303-1-1067,1,2009-05-11,111,現金,コーヒー代2名,60,0,2512462
1824,0001-20090511-167-304-1-1069,1,2009-05-11,131,普通預金,家賃支払い,30000,0,2542462
1829,0001-20090511-167-304-1-1069,4,2009-05-11,131,普通預金,電話代,7307,0,2549769
1835,0001-20090511-33-294-1-1049,1,2009-05-11,131,普通預金,家賃支払い,15238,0,2565007
1840,0001-20090511-33-294-1-1049,4,2009-05-11,131,普通預金,電話代,8864,0,2573871
1846,0001-20090511-61-295-1-1051,1,2009-05-11,131,普通預金,電話代,8774,0,2582645
1857,0001-20090511-66-297-1-1055,1,2009-05-11,131,普通預金,家賃支払,60000,0,2642645
1863,0001-20090511-67-298-1-1057,1,2009-05-11,131,普通預金,家賃支払,40000,0,2682645
1869,0001-20090511-73-299-1-1059,1,2009-05-11,111,現金,食事代,1263,0,2683908
1873,0001-20090511-85-300-1-1061,1,2009-05-11,131,普通預金,電話代,4535,0,2688443
1882,0001-20090512-143-307-1-1075,1,2009-05-12,111,現金,点検作業料,1162,0,2689605
1886,0001-20090512-151-308-1-1077,1,2009-05-12,111,現金,飲食代　串揚げ千本2名,449,0,2690054
1889,0001-20090512-151-308-1-1077,4,2009-05-12,111,現金,飲食代　スナック北新地,1050,0,2691104
1892,0001-20090512-23-305-1-1071,1,2009-05-12,111,現金,旅費,785,0,2691889
1895,0001-20090512-23-305-1-1071,4,2009-05-12,111,現金,旅費,3385,0,2695274
1897,0001-20090512-23-305-1-1071,6,2009-05-12,111,現金,旅費,1895,0,2697169
1900,0001-20090513-103-310-1-1081,1,2009-05-13,111,現金,コーヒー代他3名,150,0,2697319
1904,0001-20090513-144-311-1-1083,1,2009-05-13,111,現金,ガソリン代,320,0,2697639
1908,0001-20090513-82-309-1-1079,1,2009-05-13,111,現金,旅費,390,0,2698029
1912,0001-20090514-156-312-1-1085,1,2009-05-14,111,現金,出張旅費,476,0,2698505
1920,0001-20090515-100-323-1-1107,3,2009-05-15,152,売掛金,09年5月15日伝票No214タワー株式会社,40,0,2698545
1928,0001-20090515-101-324-1-1109,3,2009-05-15,152,売掛金,09年5月15日伝票No215高橋物産株式会社,40,0,2698585
1942,0001-20090515-11-314-1-1089,1,2009-05-15,111,現金,ガソリン代,152,0,2698737
1954,0001-20090515-157-329-1-1119,1,2009-05-15,131,普通預金,航空券代,3795,0,2702532
1959,0001-20090515-157-329-1-1119,4,2009-05-15,131,普通預金,宿泊代,710,0,2703242
1962,0001-20090515-52-315-1-1091,1,2009-05-15,111,現金,駐車代,38,0,2703280
1965,0001-20090515-52-315-1-1091,4,2009-05-15,111,現金,高速代,109,0,2703389
1967,0001-20090515-52-315-1-1091,6,2009-05-15,111,現金,ガソリン代,306,0,2703695
1970,0001-20090515-61-316-1-1093,1,2009-05-15,322,未払金,広告費,1500,0,2705195
1974,0001-20090515-72-317-1-1095,1,2009-05-15,111,現金,ゴルフプレー代3名,1542,0,2706737
1978,0001-20090515-79-318-1-1097,1,2009-05-15,111,現金,景品代,2165,0,2708902
1992,0001-20090515-88-320-1-1101,3,2009-05-15,152,売掛金,09年5月15日伝票No217株式会社　久城商事,15,0,2708917
1996,0001-20090515-9-313-1-1087,1,2009-05-15,111,現金,手土産代　チェック,300,0,2709217
1999,0001-20090515-9-313-1-1087,4,2009-05-15,111,現金,お米券　チェック,1428,0,2710645
2006,0001-20090515-98-321-1-1103,3,2009-05-15,152,売掛金,09年5月15日伝票No212五越株式会社,40,0,2710685
2014,0001-20090515-99-322-1-1105,3,2009-05-15,152,売掛金,09年5月15日伝票No213株式会社　エントリー,40,0,2710725
2018,0001-20090516-136-331-1-1123,1,2009-05-16,111,現金,ダスキン代,785,0,2711510
2022,0001-20090516-44-330-1-1121,1,2009-05-16,111,現金,食事代　ホテルサンフラワー,280,0,2711790
2026,0001-20090517-94-332-1-1125,1,2009-05-17,322,未払金,印刷代,500,0,2712290
2030,0001-20090518-105-334-1-1129,1,2009-05-18,111,現金,飲食代　居酒屋ラオス,786,0,2713076
2034,0001-20090518-109-335-1-1131,1,2009-05-18,322,未払金,ガソリン代,312,0,2713388
2038,0001-20090518-153-336-1-1133,1,2009-05-18,111,現金,飲食代　居酒屋マーク,602,0,2713990
2042,0001-20090518-47-333-1-1127,1,2009-05-18,111,現金,高速代,120,0,2714110
2045,0001-20090518-47-333-1-1127,4,2009-05-18,111,現金,ガソリン代,238,0,2714348
2048,0001-20090519-6-337-1-1135,1,2009-05-19,111,現金,広告料,2057,0,2716405
2052,0001-20090520-101-349-1-1159,1,2009-05-20,322,未払金,広告料,2500,0,2718905
2063,0001-20090520-105-351-1-1163,3,2009-05-20,152,売掛金,09年5月20日伝票No219合同会社　たかだ,30,0,2718935
2071,0001-20090520-106-352-1-1165,3,2009-05-20,152,売掛金,09年5月20日伝票No220株式会社　ＹＡＧ,35,0,2718970
2090,0001-20090520-118-356-1-1173,1,2009-05-20,322,未払金,コピー代,384,0,2719354
2094,0001-20090520-119-357-1-1175,1,2009-05-20,322,未払金,事務用品,196,0,2719550
2098,0001-20090520-13-338-1-1137,1,2009-05-20,111,現金,ガソリン代,382,0,2719932
2115,0001-20090520-24-339-1-1139,1,2009-05-20,111,現金,JR回数券,3934,0,2723866
2119,0001-20090520-31-340-1-1141,1,2009-05-20,322,未払金,コピー代,164,0,2724030
2123,0001-20090520-53-341-1-1143,1,2009-05-20,111,現金,高速代,64,0,2724094
2127,0001-20090520-70-342-1-1145,1,2009-05-20,322,未払金,有線,238,0,2724332
2131,0001-20090520-71-343-1-1147,1,2009-05-20,322,未払金,事務用品,252,0,2724584
2134,0001-20090520-71-343-1-1147,4,2009-05-20,322,未払金,カウンター料金,1713,0,2726297
2136,0001-20090520-71-343-1-1147,6,2009-05-20,322,未払金,カウンター料金,300,0,2726597
2140,0001-20090520-76-344-1-1149,1,2009-05-20,322,未払金,ファイル等,1488,0,2728085
2143,0001-20090520-76-344-1-1149,4,2009-05-20,322,未払金,飲料水,9530,0,2737615
2145,0001-20090520-76-344-1-1149,6,2009-05-20,322,未払金,名刺代,2490,0,2740105
2148,0001-20090520-82-345-1-1151,1,2009-05-20,322,未払金,ガソリン代,943,0,2741048
2151,0001-20090520-82-345-1-1151,4,2009-05-20,322,未払金,ウォッシャー液,18,0,2741066
2154,0001-20090520-83-346-1-1153,1,2009-05-20,111,現金,旅費,314,0,2741380
2158,0001-20090520-97-347-1-1155,1,2009-05-20,322,未払金,コピー代,1910,0,2743290
2162,0001-20090520-98-348-1-1157,1,2009-05-20,322,未払金,事務用品,1837,0,2745127
2166,0001-20090521-132-365-1-1191,1,2009-05-21,131,普通預金,電気代,7825,0,2752952
2171,0001-20090521-132-365-1-1191,4,2009-05-21,131,普通預金,水道代,386,0,2753338
2174,0001-20090521-152-366-1-1193,1,2009-05-21,111,現金,食事代,800,0,2754138
2178,0001-20090521-160-367-1-1195,1,2009-05-21,111,現金,出張旅費,3333,0,2757471
2185,0001-20090521-169-369-1-1199,1,2009-05-21,131,普通預金,電気料,5495,0,2762966
2190,0001-20090521-169-369-1-1199,4,2009-05-21,131,普通預金,水道料,313,0,2763279
2193,0001-20090521-25-360-1-1181,1,2009-05-21,111,現金,旅費,2666,0,2765945
2197,0001-20090521-34-361-1-1183,1,2009-05-21,131,普通預金,電気代,4633,0,2770578
2202,0001-20090521-34-361-1-1183,4,2009-05-21,131,普通預金,水道代,295,0,2770873
2205,0001-20090521-59-362-1-1185,1,2009-05-21,111,現金,旅費,1904,0,2772777
2209,0001-20090521-64-363-1-1187,1,2009-05-21,131,普通預金,電気料,8159,0,2780936
2214,0001-20090521-64-363-1-1187,4,2009-05-21,131,普通預金,水道料,407,0,2781343
2217,0001-20090521-89-364-1-1189,1,2009-05-21,131,普通預金,電気料,4221,0,2785564
2222,0001-20090521-89-364-1-1189,4,2009-05-21,131,普通預金,水道料,284,0,2785848
2224,0001-20090521-89-364-1-1189,6,2009-05-21,131,普通預金,ガス代,265,0,2786113
2227,0001-20090522-104-376-1-1213,1,2009-05-22,111,現金,手土産代　五越百貨店,126,0,2786239
2231,0001-20090522-138-377-1-1215,1,2009-05-22,111,現金,ガソリン代,282,0,2786521
2234,0001-20090522-138-377-1-1215,4,2009-05-22,111,現金,高速代,244,0,2786765
2237,0001-20090522-165-378-1-1217,1,2009-05-22,111,現金,トイレットペーパー代,100,0,2786865
2241,0001-20090522-166-379-1-1219,1,2009-05-22,111,現金,ダスキン代,90,0,2786955
2245,0001-20090522-38-371-1-1203,1,2009-05-22,322,未払金,宿泊費,2523,0,2789478
2249,0001-20090522-7-370-1-1201,1,2009-05-22,111,現金,食事代　打合せ昼食　2名,261,0,2789739
2252,0001-20090522-7-370-1-1201,4,2009-05-22,111,現金,食事代　喫茶コーヒー代　4名,104,0,2789843
2255,0001-20090522-73-372-1-1205,1,2009-05-22,111,現金,ゴルフプレー代,457,0,2790300
2259,0001-20090522-74-373-1-1207,1,2009-05-22,111,現金,食事代　カナッシュ2名,277,0,2790577
2263,0001-20090522-90-374-1-1209,1,2009-05-22,111,現金,ダスキン代,500,0,2791077
2267,0001-20090522-95-375-1-1211,1,2009-05-22,322,未払金,清掃料,3413,0,2794490
2271,0001-20090523-121-384-1-1229,1,2009-05-23,111,現金,お茶代,571,0,2795061
2275,0001-20090523-140-385-1-1231,1,2009-05-23,111,現金,旅費,156,0,2795217
2279,0001-20090523-161-386-1-1233,1,2009-05-23,111,現金,旅費,859,0,2796076
2283,0001-20090523-26-380-1-1221,1,2009-05-23,111,現金,旅費,523,0,2796599
2287,0001-20090523-28-381-1-1223,1,2009-05-23,322,未払金,タクシー代,115,0,2796714
2291,0001-20090523-75-382-1-1225,1,2009-05-23,111,現金,飲食代　ダイニング旬6名,1025,0,2797739
2294,0001-20090523-75-382-1-1225,4,2009-05-23,111,現金,バーレジェンド6名,2229,0,2799968
2297,0001-20090523-78-383-1-1227,1,2009-05-23,111,現金,ガソリン代,305,0,2800273
2301,0001-20090524-108-388-1-1237,1,2009-05-24,111,現金,ゴルフプレー代2名,1120,0,2801393
2305,0001-20090524-120-389-1-1239,1,2009-05-24,322,未払金,業務委託費,20000,0,2821393
2309,0001-20090524-37-387-1-1235,1,2009-05-24,322,未払金,業務委託費,56785,0,2878178
2319,0001-20090525-111-398-1-1257,1,2009-05-25,322,未払金,タクシー代,679,0,2878857
2326,0001-20090525-111-398-1-1257,6,2009-05-25,152,売掛金,09年5月25日伝票No222株式会社　総合経営,35,0,2878892
2334,0001-20090525-112-399-1-1259,3,2009-05-25,152,売掛金,09年5月25日伝票No223株式会社　鎌田商店,30,0,2878922
2342,0001-20090525-113-400-1-1261,3,2009-05-25,152,売掛金,09年5月25日伝票No224株式会社　小林マーケット,40,0,2878962
2351,0001-20090525-172-402-1-1265,1,2009-05-25,322,未払金,業務委託費支払い,4476,0,2883438
2355,0001-20090525-29-392-1-1245,1,2009-05-25,131,普通預金,携帯電話代,3087,0,2886525
2361,0001-20090525-3-390-1-1241,1,2009-05-25,322,未払金,宿泊代,1809,0,2888334
2365,0001-20090525-8-391-1-1243,1,2009-05-25,111,現金,飲食代,202,0,2888536
2369,0001-20090525-84-393-1-1247,1,2009-05-25,111,現金,旅費,514,0,2889050
2373,0001-20090525-86-394-1-1249,1,2009-05-25,111,現金,切手代,380,0,2889430
2491,0001-20090525-92-395-1-1251,1,2009-05-25,322,未払金,コピー機修繕,5000,0,2894430
2495,0001-20090526-113-410-1-1281,1,2009-05-26,131,普通預金,携帯代,1869,0,2896299
2501,0001-20090526-14-403-1-1267,1,2009-05-26,111,現金,ガソリン代,200,0,2896499
2505,0001-20090526-146-411-1-1283,1,2009-05-26,322,未払金,業務委託費,7000,0,2903499
2509,0001-20090526-170-412-1-1285,1,2009-05-26,111,現金,新聞代,143,0,2903642
2513,0001-20090526-171-413-1-1287,1,2009-05-26,131,普通預金,携帯代,4118,0,2907760
2519,0001-20090526-27-404-1-1269,1,2009-05-26,111,現金,旅費,1361,0,2909121
2522,0001-20090526-27-404-1-1269,4,2009-05-26,111,現金,旅費,1571,0,2910692
2524,0001-20090526-27-404-1-1269,6,2009-05-26,111,現金,旅費,1071,0,2911763
2527,0001-20090526-35-405-1-1271,1,2009-05-26,111,現金,新聞代,186,0,2911949
2531,0001-20090526-72-406-1-1273,1,2009-05-26,111,現金,新聞代,143,0,2912092
2534,0001-20090526-72-406-1-1273,4,2009-05-26,111,現金,新聞代,140,0,2912232
2536,0001-20090526-72-406-1-1273,6,2009-05-26,111,現金,新聞代,169,0,2912401
2539,0001-20090526-78-407-1-1275,1,2009-05-26,322,未払金,業務委託費支払い,9000,0,2921401
2543,0001-20090526-83-408-1-1277,1,2009-05-26,111,現金,車両管理費,2142,0,2923543
2547,0001-20090526-87-409-1-1279,1,2009-05-26,131,普通預金,携帯代,2031,0,2925574
2553,0001-20090527-114-421-1-1303,1,2009-05-27,111,現金,新聞代,126,0,2925700
2556,0001-20090527-114-421-1-1303,4,2009-05-27,111,現金,新聞代,143,0,2925843
2559,0001-20090527-15-414-1-1289,1,2009-05-27,111,現金,タイヤ交換,3571,0,2929414
2568,0001-20090527-39-416-1-1293,1,2009-05-27,111,現金,会費,619,0,2930033
2572,0001-20090527-49-417-1-1295,1,2009-05-27,111,現金,ガソリン代,7142,0,2937175
2575,0001-20090527-49-417-1-1295,4,2009-05-27,131,普通預金,車両管理費,1628,0,2938803
2581,0001-20090527-62-418-1-1297,1,2009-05-27,131,普通預金,携帯代,3114,0,2941917
2587,0001-20090527-79-419-1-1299,1,2009-05-27,111,現金,ガソリン代,176,0,2942093
2591,0001-20090527-88-420-1-1301,1,2009-05-27,111,現金,新聞代,169,0,2942262
2595,0001-20090528-159-424-1-1309,1,2009-05-28,111,現金,ＪＲ代,781,0,2943043
2599,0001-20090528-32-422-1-1305,1,2009-05-28,322,未払金,事務用品費,164,0,2943207
2603,0001-20090528-93-423-1-1307,1,2009-05-28,322,未払金,修繕費,842,0,2944049
2623,0001-20090529-155-428-1-1317,1,2009-05-29,111,現金,車両管理費,324,0,2944373
2626,0001-20090529-155-428-1-1317,4,2009-05-29,111,現金,高速代,485,0,2944858
2628,0001-20090529-155-428-1-1317,6,2009-05-29,111,現金,駐車代,60,0,2944918
2631,0001-20090529-62-425-1-1311,1,2009-05-29,322,未払金,飲食代,1716,0,2946634
2635,0001-20090529-63-426-1-1313,1,2009-05-29,111,現金,会議　飲食代,1140,0,2947774
2639,0001-20090530-100-431-1-1323,1,2009-05-30,111,現金,会費,666,0,2948440
2648,0001-20090530-137-433-1-1327,1,2009-05-30,322,未払金,有線,300,0,2948740
2651,0001-20090530-137-433-1-1327,4,2009-05-30,322,未払金,警備料,2142,0,2950882
2653,0001-20090530-137-433-1-1327,6,2009-05-30,131,普通預金,高速料,2538,0,2953420
2658,0001-20090530-137-433-1-1327,9,2009-05-30,322,未払金,清掃料,3500,0,2956920
2662,0001-20090530-148-434-1-1329,1,2009-05-30,111,現金,ウォッシャー液他,30,0,2956950
2666,0001-20090530-164-435-1-1331,1,2009-05-30,111,現金,事務用品,253,0,2957203
2670,0001-20090530-70-429-1-1319,1,2009-05-30,322,未払金,有線,300,0,2957503
2673,0001-20090530-70-429-1-1319,4,2009-05-30,322,未払金,警備料,2619,0,2960122
2675,0001-20090530-70-429-1-1319,6,2009-05-30,111,現金,高速料,3491,0,2963613
2678,0001-20090530-70-429-1-1319,9,2009-05-30,322,未払金,清掃料,3500,0,2967113
2682,0001-20090530-96-430-1-1321,1,2009-05-30,131,普通預金,警備料,1070,0,2968183
2688,0001-20090531-1-436-1-1333,1,2009-05-31,322,未払金,運賃　佐川急便,4244,0,2972427
2769,0001-20090531-116-453-1-1367,22,2009-05-31,131,普通預金,リース料,4000,0,2976427
2832,0001-20090531-119-456-1-1373,3,2009-05-31,152,売掛金,09年5月31日伝票No225マークマーケット,40,0,2976467
2840,0001-20090531-120-457-1-1375,3,2009-05-31,152,売掛金,09年5月31日伝票No226株式会社　ＡＢＣ,40,0,2976507
2851,0001-20090531-122-459-1-1379,3,2009-05-31,152,売掛金,09年5月31日伝票No228株式会社　畠山商事,30,0,2976537
2859,0001-20090531-123-460-1-1381,3,2009-05-31,152,売掛金,09年5月31日伝票No229株式会社　千代サービス,10,0,2976547
2866,0001-20090531-125-462-1-1385,1,2009-05-31,312,買掛金,09年5月1日～09年5月31日分仕入,3456,0,2980003
2869,0001-20090531-125-462-1-1385,4,2009-05-31,312,買掛金,09年5月1日～09年5月31日分仕入,6450,0,2986453
2873,0001-20090531-126-463-1-1387,1,2009-05-31,312,買掛金,09年5月1日～09年5月31日分仕入,203369,0,3189822
2876,0001-20090531-126-463-1-1387,4,2009-05-31,312,買掛金,09年5月1日～09年5月31日分仕入,292310,0,3482132
2879,0001-20090531-126-463-1-1387,7,2009-05-31,312,買掛金,09年5月1日～09年5月31日分仕入,2018,0,3484150
2882,0001-20090531-126-463-1-1387,10,2009-05-31,312,買掛金,09年5月1日～09年5月31日分仕入,137904,0,3622054
2885,0001-20090531-126-463-1-1387,13,2009-05-31,312,買掛金,09年5月1日～09年5月31日分仕入,147963,0,3770017
2889,0001-20090531-126-463-1-1387,17,2009-05-31,312,買掛金,09年5月1日～09年5月31日分仕入,30032,0,3800049
2891,0001-20090531-126-463-1-1387,19,2009-05-31,312,買掛金,09年5月1日～09年5月31日分仕入,61503,0,3861552
2894,0001-20090531-126-463-1-1387,22,2009-05-31,312,買掛金,09年5月1日～09年5月31日分仕入,15724,0,3877276
2897,0001-20090531-126-463-1-1387,25,2009-05-31,312,買掛金,09年5月1日～09年5月31日分仕入,6681,0,3883957
2900,0001-20090531-126-463-1-1387,28,2009-05-31,312,買掛金,09年5月1日～09年5月31日分仕入,3864,0,3887821
2904,0001-20090531-127-464-1-1389,1,2009-05-31,312,買掛金,09年5月1日～09年5月31日分仕入,169023,0,4056844
2907,0001-20090531-127-464-1-1389,4,2009-05-31,312,買掛金,09年5月1日～09年5月31日分仕入,84366,0,4141210
2910,0001-20090531-127-464-1-1389,7,2009-05-31,312,買掛金,09年5月1日～09年5月31日分仕入,54947,0,4196157
2913,0001-20090531-127-464-1-1389,10,2009-05-31,312,買掛金,09年5月1日～09年5月31日分仕入,615,0,4196772
2916,0001-20090531-127-464-1-1389,13,2009-05-31,312,買掛金,09年5月1日～09年5月31日分仕入,825,0,4197597
2919,0001-20090531-127-464-1-1389,16,2009-05-31,312,買掛金,09年5月1日～09年5月31日分仕入,9070,0,4206667
2923,0001-20090531-128-465-1-1391,1,2009-05-31,312,買掛金,09年5月1日～09年5月31日分仕入,144285,0,4350952
2926,0001-20090531-128-465-1-1391,4,2009-05-31,312,買掛金,09年5月1日～09年5月31日分仕入,168102,0,4519054
2929,0001-20090531-128-465-1-1391,7,2009-05-31,312,買掛金,09年5月1日～09年5月31日分仕入,178294,0,4697348
2932,0001-20090531-128-465-1-1391,10,2009-05-31,312,買掛金,09年5月1日～09年5月31日分仕入,44085,0,4741433
2935,0001-20090531-128-465-1-1391,13,2009-05-31,312,買掛金,09年5月1日～09年5月31日分仕入,8064,0,4749497
2938,0001-20090531-128-465-1-1391,16,2009-05-31,312,買掛金,09年5月1日～09年5月31日分仕入,2668,0,4752165
2941,0001-20090531-128-465-1-1391,19,2009-05-31,312,買掛金,09年5月1日～09年5月31日分仕入,13504,0,4765669
2944,0001-20090531-128-465-1-1391,22,2009-05-31,312,買掛金,09年5月1日～09年5月31日分仕入,1056,0,4766725
2948,0001-20090531-129-466-1-1393,1,2009-05-31,312,買掛金,09年5月1日～09年5月31日分仕入,1152,0,4767877
2951,0001-20090531-129-466-1-1393,4,2009-05-31,312,買掛金,09年5月1日～09年5月31日分仕入,2620,0,4770497
3018,0001-20090531-145-478-1-1417,1,2009-05-31,322,未払金,運賃,8138,0,4778635
3046,0001-20090531-154-483-1-1427,1,2009-05-31,322,未払金,お花代,600,0,4779235
3072,0001-20090531-36-437-1-1335,1,2009-05-31,322,未払金,運賃　ヤマト運輸,72816,0,4852051
3075,0001-20090531-36-437-1-1335,4,2009-05-31,322,未払金,運賃　佐川急便,47645,0,4899696
3078,0001-20090531-40-438-1-1337,1,2009-05-31,322,未払金,広告掲載,2380,0,4902076
3082,0001-20090531-55-439-1-1339,1,2009-05-31,111,現金,高速代,461,0,4902537
3086,0001-20090531-60-440-1-1341,1,2009-05-31,111,現金,旅費,892,0,4903429
3095,0001-20090531-66-442-1-1345,1,2009-05-31,131,普通預金,リース料,9992,0,4913421
3121,0001-20090531-77-447-1-1355,1,2009-05-31,322,未払金,運賃　ヤマト運輸,7263,0,4920684
3125,0001-20090531-81-448-1-1357,1,2009-05-31,322,未払金,お茶代,1252,0,4921936
3134,0001-20090531-99-450-1-1361,1,2009-05-31,322,未払金,運賃,35635,0,4957571
,,,2009-05,,※※月計※※,,2525583,0,
3138,0001-20090601-106-487-1-1435,1,2009-06-01,111,現金,食事代　やまびこ4名,363,0,4957934
3141,0001-20090601-106-487-1-1435,4,2009-06-01,111,現金,飲食代　スナック北新地,1031,0,4958965
3144,0001-20090601-147-488-1-1437,1,2009-06-01,322,未払金,ガソリン代,270,0,4959235
3147,0001-20090601-147-488-1-1437,4,2009-06-01,322,未払金,高速代,28,0,4959263
3150,0001-20090601-94-486-1-1433,1,2009-06-01,111,現金,お茶代,150,0,4959413
3154,0001-20090602-10-489-1-1439,1,2009-06-02,111,現金,ガソリン代,201,0,4959614
3158,0001-20090602-18-490-1-1441,1,2009-06-02,111,現金,旅費,1033,0,4960647
3162,0001-20090602-42-491-1-1443,1,2009-06-02,111,現金,昼食代　喫茶エンゼル3名,162,0,4960809
3166,0001-20090602-56-492-1-1445,1,2009-06-02,111,現金,旅費,1552,0,4962361
3170,0001-20090602-77-493-1-1447,1,2009-06-02,111,現金,ゴルフプレー代,323,0,4962684
3174,0001-20090604-161-495-1-1451,1,2009-06-04,111,現金,旅費,357,0,4963041
3178,0001-20090604-19-494-1-1449,1,2009-06-04,111,現金,旅費,714,0,4963755
3182,0001-20090605-133-499-1-1459,1,2009-06-05,131,普通預金,税理士報酬,6652,0,4970407
3192,0001-20090605-94-496-1-1453,3,2009-06-05,152,売掛金,09年6月5日伝票No230株式会社　渡辺産業,22,0,4970429
3200,0001-20090605-95-497-1-1455,3,2009-06-05,152,売掛金,09年6月5日伝票No231佐々木販売株式会社,22,0,4970451
3209,0001-20090606-110-502-1-1465,1,2009-06-06,111,現金,タクシー代,109,0,4970560
3213,0001-20090606-122-503-1-1467,1,2009-06-06,111,現金,証明書発行手数料,50,0,4970610
3217,0001-20090606-142-504-1-1469,1,2009-06-06,111,現金,ガソリン代,313,0,4970923
3220,0001-20090606-142-504-1-1469,4,2009-06-06,111,現金,高速代,78,0,4971001
3222,0001-20090606-142-504-1-1469,6,2009-06-06,111,現金,駐車代,30,0,4971031
3224,0001-20090606-142-504-1-1469,8,2009-06-06,111,現金,洗車代,50,0,4971081
3227,0001-20090606-20-500-1-1461,1,2009-06-06,111,現金,航空券代,1952,0,4973033
3231,0001-20090606-84-501-1-1463,1,2009-06-06,111,現金,切手代,190,0,4973223
3235,0001-20090607-141-509-1-1479,1,2009-06-07,111,現金,JR代,761,0,4973984
3239,0001-20090607-22-505-1-1471,1,2009-06-07,111,現金,旅費,2380,0,4976364
3243,0001-20090607-58-506-1-1473,1,2009-06-07,111,現金,旅費,3333,0,4979697
3247,0001-20090607-69-507-1-1475,1,2009-06-07,111,現金,電池代,66,0,4979763
3250,0001-20090607-69-507-1-1475,4,2009-06-07,111,現金,洗剤等,87,0,4979850
3253,0001-20090607-78-508-1-1477,1,2009-06-07,111,現金,ゴルフプレー代,600,0,4980450
3257,0001-20090608-149-512-1-1485,1,2009-06-08,111,現金,コーヒー代,60,0,4980510
3261,0001-20090608-50-510-1-1481,1,2009-06-08,111,現金,高速代,57,0,4980567
3265,0001-20090608-85-511-1-1483,1,2009-06-08,111,現金,旅費,390,0,4980957
3269,0001-20090609-112-516-1-1493,1,2009-06-09,131,普通預金,電話代,10265,0,4991222
3275,0001-20090609-129-517-1-1495,1,2009-06-09,131,普通預金,家賃支払い,19000,0,5010222
3281,0001-20090609-167-518-1-1497,1,2009-06-09,131,普通預金,家賃支払い,30000,0,5040222
3286,0001-20090609-167-518-1-1497,4,2009-06-09,131,普通預金,電話代,7112,0,5047334
3292,0001-20090609-33-513-1-1487,1,2009-06-09,131,普通預金,家賃支払い,15238,0,5062572
3297,0001-20090609-33-513-1-1487,4,2009-06-09,131,普通預金,電話代,5878,0,5068450
3303,0001-20090609-70-514-1-1489,1,2009-06-09,131,普通預金,家賃支払,60000,0,5128450
3309,0001-20090609-71-515-1-1491,1,2009-06-09,131,普通預金,家賃支払,40000,0,5168450
3319,0001-20090610-100-531-1-1523,3,2009-06-10,152,売掛金,09年6月10日伝票No496株式会社　藤田東京本社,40,0,5168490
3336,0001-20090610-162-535-1-1531,1,2009-06-10,111,現金,会議　食事代,1190,0,5169680
3340,0001-20090610-168-536-1-1533,1,2009-06-10,322,未払金,有線,300,0,5169980
3343,0001-20090610-168-536-1-1533,4,2009-06-10,322,未払金,警備料,2142,0,5172122
3346,0001-20090610-21-519-1-1499,1,2009-06-10,111,現金,JR代,3075,0,5175197
3350,0001-20090610-44-520-1-1501,1,2009-06-10,111,現金,コーヒー代2名,60,0,5175257
3354,0001-20090610-57-521-1-1503,1,2009-06-10,111,現金,JR代,3136,0,5178393
3373,0001-20090610-72-524-1-1509,1,2009-06-10,322,未払金,有線,250,0,5178643
3376,0001-20090610-72-524-1-1509,4,2009-06-10,322,未払金,警備料,1714,0,5180357
3379,0001-20090610-76-525-1-1511,1,2009-06-10,322,未払金,社員夜食代,595,0,5180952
3383,0001-20090610-85-526-1-1513,1,2009-06-10,131,普通預金,電話代,3645,0,5184597
3389,0001-20090610-86-527-1-1515,1,2009-06-10,111,現金,タクシー代,240,0,5184837
3397,0001-20090610-97-528-1-1517,3,2009-06-10,152,売掛金,09年6月10日伝票No233株式会社　ミナミ,35,0,5184872
3407,0001-20090611-158-541-1-1543,1,2009-06-11,111,現金,出張旅費,1047,0,5185919
3411,0001-20090611-23-538-1-1537,1,2009-06-11,111,現金,旅費,1500,0,5187419
3414,0001-20090611-23-538-1-1537,4,2009-06-11,111,現金,旅費,1419,0,5188838
3416,0001-20090611-23-538-1-1537,6,2009-06-11,111,現金,旅費,1980,0,5190818
3419,0001-20090611-8-537-1-1535,1,2009-06-11,111,現金,食事代　昼食3名,312,0,5191130
3423,0001-20090611-87-539-1-1539,1,2009-06-11,111,現金,旅費,500,0,5191630
3427,0001-20090611-88-540-1-1541,1,2009-06-11,111,現金,ＪＲ代,523,0,5192153
3431,0001-20090612-159-543-1-1547,1,2009-06-12,111,現金,タクシー代,353,0,5192506
3435,0001-20090612-7-542-1-1545,1,2009-06-12,111,現金,食事代　居酒屋おたわ,378,0,5192884
3438,0001-20090612-7-542-1-1545,4,2009-06-12,111,現金,飲食代　スナックりんりん,1285,0,5194169
3441,0001-20090613-143-545-1-1551,1,2009-06-13,111,現金,ガソリン代,345,0,5194514
3445,0001-20090613-150-546-1-1553,1,2009-06-13,111,現金,手土産代,696,0,5195210
3449,0001-20090613-151-547-1-1555,1,2009-06-13,111,現金,食事代　お好み焼きやきやき4名,324,0,5195534
3452,0001-20090613-151-547-1-1555,4,2009-06-13,111,現金,飲食代　ハブバージョイ4名,1173,0,5196707
3455,0001-20090613-152-548-1-1557,1,2009-06-13,111,現金,食事代,348,0,5197055
3459,0001-20090613-73-544-1-1549,1,2009-06-13,111,現金,飲食代　華3名,544,0,5197599
3462,0001-20090613-73-544-1-1549,4,2009-06-13,111,現金,電池代,22,0,5197621
3466,0001-20090614-51-549-1-1559,1,2009-06-14,111,現金,ガソリン代,546,0,5198167
3469,0001-20090614-51-549-1-1559,4,2009-06-14,111,現金,駐車代,38,0,5198205
3471,0001-20090614-51-549-1-1559,6,2009-06-14,111,現金,高速代,157,0,5198362
3478,0001-20090615-103-554-1-1569,3,2009-06-15,152,売掛金,09年6月15日伝票No235五越株式会社,40,0,5198402
3486,0001-20090615-104-555-1-1571,3,2009-06-15,152,売掛金,09年6月15日伝票No236株式会社　エントリー,40,0,5198442
3494,0001-20090615-105-556-1-1573,3,2009-06-15,152,売掛金,09年6月15日伝票No237タワー株式会社,30,0,5198472
3502,0001-20090615-106-557-1-1575,3,2009-06-15,152,売掛金,09年6月15日伝票No238高橋物産株式会社,35,0,5198507
3515,0001-20090615-108-559-1-1579,3,2009-06-15,152,売掛金,09年6月15日伝票No240株式会社　久城商事,15,0,5198522
3524,0001-20090615-11-550-1-1561,1,2009-06-15,111,現金,高速代,152,0,5198674
3536,0001-20090615-164-563-1-1587,1,2009-06-15,111,現金,事務用品,143,0,5198817
3540,0001-20090615-52-551-1-1563,1,2009-06-15,111,現金,高速代,35,0,5198852
3544,0001-20090615-61-552-1-1565,1,2009-06-15,131,普通預金,電話代,8073,0,5206925
3556,0001-20090616-136-565-1-1591,1,2009-06-16,111,現金,ダスキン代,785,0,5207710
3560,0001-20090616-83-564-1-1589,1,2009-06-16,322,未払金,ガソリン代,236,0,5207946
3564,0001-20090617-144-568-1-1597,1,2009-06-17,111,現金,ガソリン代,276,0,5208222
3567,0001-20090617-144-568-1-1597,4,2009-06-17,111,現金,高速代,38,0,5208260
3569,0001-20090617-144-568-1-1597,6,2009-06-17,111,現金,駐車代,71,0,5208331
3572,0001-20090617-4-566-1-1593,1,2009-06-17,322,未払金,広告費,1500,0,5209831
3576,0001-20090617-86-567-1-1595,1,2009-06-17,111,現金,切手代,380,0,5210211
3580,0001-20090618-103-570-1-1601,1,2009-06-18,111,現金,ゴルフプレー代,598,0,5210809
3584,0001-20090618-82-569-1-1599,1,2009-06-18,322,未払金,ガソリン代,1480,0,5212289
3588,0001-20090619-46-571-1-1603,1,2009-06-19,111,現金,ガソリン代,599,0,5212888
3592,0001-20090619-74-572-1-1605,1,2009-06-19,111,現金,飲食代　スナックライラ4名,1542,0,5214430
3596,0001-20090620-101-590-1-1641,1,2009-06-20,322,未払金,広告料,2500,0,5216930
3607,0001-20090620-111-592-1-1645,3,2009-06-20,152,売掛金,09年6月20日伝票No242合同会社　たかだ,30,0,5216960
3615,0001-20090620-112-593-1-1647,3,2009-06-20,152,売掛金,09年6月20日伝票No243株式会社　ＹＡＧ,35,0,5216995
3634,0001-20090620-118-597-1-1655,1,2009-06-20,322,未払金,コピー代,339,0,5217334
3638,0001-20090620-132-598-1-1657,1,2009-06-20,131,普通預金,電気代,4765,0,5222099
3643,0001-20090620-132-598-1-1657,4,2009-06-20,131,普通預金,水道代,277,0,5222376
3646,0001-20090620-134-599-1-1659,1,2009-06-20,322,未払金,用紙,1095,0,5223471
3650,0001-20090620-135-600-1-1661,1,2009-06-20,322,未払金,事務用品,347,0,5223818
3673,0001-20090620-169-604-1-1669,1,2009-06-20,131,普通預金,電気料,4788,0,5228606
3678,0001-20090620-169-604-1-1669,4,2009-06-20,131,普通預金,水道料,341,0,5228947
3681,0001-20090620-3-573-1-1607,1,2009-06-20,322,未払金,宿泊代,1486,0,5230433
3685,0001-20090620-31-575-1-1611,1,2009-06-20,322,未払金,コピー代,131,0,5230564
3689,0001-20090620-34-576-1-1613,1,2009-06-20,131,普通預金,電気代,3745,0,5234309
3694,0001-20090620-34-576-1-1613,4,2009-06-20,131,普通預金,水道代,202,0,5234511
3697,0001-20090620-53-577-1-1615,1,2009-06-20,111,現金,高速代,119,0,5234630
3701,0001-20090620-6-574-1-1609,1,2009-06-20,111,現金,広告料,238,0,5234868
3705,0001-20090620-64-578-1-1617,1,2009-06-20,131,普通預金,電気料,8632,0,5243500
3710,0001-20090620-64-578-1-1617,4,2009-06-20,131,普通預金,水道料,347,0,5243847
3720,0001-20090620-66-580-1-1621,1,2009-06-20,322,未払金,お茶代,500,0,5244347
3724,0001-20090620-71-581-1-1623,1,2009-06-20,322,未払金,事務用品,75,0,5244422
3727,0001-20090620-71-581-1-1623,4,2009-06-20,322,未払金,カウンター料金,1592,0,5246014
3730,0001-20090620-74-582-1-1625,1,2009-06-20,322,未払金,有線,238,0,5246252
3734,0001-20090620-75-583-1-1627,1,2009-06-20,111,現金,トイレットペーパー他,51,0,5246303
3738,0001-20090620-76-584-1-1629,1,2009-06-20,322,未払金,カウンター料金,300,0,5246603
3742,0001-20090620-80-585-1-1631,1,2009-06-20,322,未払金,会費支払い,19875,0,5266478
3746,0001-20090620-81-586-1-1633,1,2009-06-20,322,未払金,ファイル等,833,0,5267311
3749,0001-20090620-81-586-1-1633,4,2009-06-20,322,未払金,飲料水,10500,0,5277811
3751,0001-20090620-81-586-1-1633,6,2009-06-20,322,未払金,名刺代,1595,0,5279406
3754,0001-20090620-89-587-1-1635,1,2009-06-20,131,普通預金,電気料,3936,0,5283342
3759,0001-20090620-89-587-1-1635,4,2009-06-20,131,普通預金,水道料,166,0,5283508
3761,0001-20090620-89-587-1-1635,6,2009-06-20,131,普通預金,ガス代,141,0,5283649
3764,0001-20090620-97-588-1-1637,1,2009-06-20,322,未払金,コピー代,1849,0,5285498
3768,0001-20090620-98-589-1-1639,1,2009-06-20,322,未払金,事務用品,113,0,5285611
3772,0001-20090621-12-605-1-1671,1,2009-06-21,111,現金,ガソリン代,222,0,5285833
3775,0001-20090621-12-605-1-1671,4,2009-06-21,111,現金,ガソリン添加剤代,115,0,5285948
3777,0001-20090621-12-605-1-1671,6,2009-06-21,111,現金,高速代,52,0,5286000
3780,0001-20090621-160-608-1-1677,1,2009-06-21,111,現金,出張旅費,3333,0,5289333
3784,0001-20090621-24-606-1-1673,1,2009-06-21,111,現金,JR回数券,3934,0,5293267
3788,0001-20090621-89-607-1-1675,1,2009-06-21,111,現金,旅費,466,0,5293733
3792,0001-20090622-109-612-1-1685,1,2009-06-22,322,未払金,ガソリン代,331,0,5294064
3796,0001-20090622-153-613-1-1687,1,2009-06-22,111,現金,飲食代　居酒屋田舎,787,0,5294851
3800,0001-20090622-155-614-1-1689,1,2009-06-22,111,現金,ガソリン代,285,0,5295136
3803,0001-20090622-155-614-1-1689,4,2009-06-22,111,現金,高速代,38,0,5295174
3805,0001-20090622-155-614-1-1689,6,2009-06-22,111,現金,駐車代,19,0,5295193
3811,0001-20090622-166-616-1-1693,1,2009-06-22,111,現金,ダスキン代,90,0,5295283
3815,0001-20090622-9-609-1-1679,1,2009-06-22,111,現金,お菓子詰め合わせ　タワー,161,0,5295444
3818,0001-20090622-9-609-1-1679,4,2009-06-22,111,現金,商品券　タワー,238,0,5295682
3821,0001-20090622-90-610-1-1681,1,2009-06-22,111,現金,ダスキン代,500,0,5296182
3825,0001-20090622-95-611-1-1683,1,2009-06-22,322,未払金,清掃料,3413,0,5299595
3829,0001-20090623-140-621-1-1703,1,2009-06-23,111,現金,旅費,354,0,5299949
3833,0001-20090623-25-617-1-1695,1,2009-06-23,111,現金,旅費,2904,0,5302853
3837,0001-20090623-28-618-1-1697,1,2009-06-23,322,未払金,タクシー代,115,0,5302968
3841,0001-20090623-38-619-1-1699,1,2009-06-23,322,未払金,宿泊費,2293,0,5305261
3845,0001-20090623-59-620-1-1701,1,2009-06-23,111,現金,旅費,3095,0,5308356
3854,0001-20090624-154-626-1-1713,1,2009-06-24,322,未払金,ゴルフプレー代,868,0,5309224
3858,0001-20090624-26-622-1-1705,1,2009-06-24,111,現金,旅費,571,0,5309795
3862,0001-20090624-29-623-1-1707,1,2009-06-24,131,普通預金,携帯電話代,2359,0,5312154
3868,0001-20090624-81-624-1-1709,1,2009-06-24,322,未払金,お茶代,857,0,5313011
3872,0001-20090625-111-632-1-1725,1,2009-06-25,322,未払金,タクシー代,466,0,5313477
3883,0001-20090625-117-634-1-1729,3,2009-06-25,152,売掛金,09年6月25日伝票No245株式会社　総合経営,35,0,5313512
3891,0001-20090625-118-635-1-1731,3,2009-06-25,152,売掛金,09年6月25日伝票No246株式会社　鎌田商店,30,0,5313542
3899,0001-20090625-119-636-1-1733,3,2009-06-25,152,売掛金,09年6月25日伝票No247株式会社　小林マーケット,40,0,5313582
3903,0001-20090625-121-637-1-1735,1,2009-06-25,111,現金,お茶代,547,0,5314129
3907,0001-20090625-170-638-1-1737,1,2009-06-25,111,現金,新聞代,143,0,5314272
3911,0001-20090625-171-639-1-1739,1,2009-06-25,131,普通預金,携帯代,2004,0,5316276
3917,0001-20090625-27-627-1-1715,1,2009-06-25,111,現金,旅費,1190,0,5317466
3920,0001-20090625-27-627-1-1715,4,2009-06-25,111,現金,旅費,1619,0,5319085
3922,0001-20090625-27-627-1-1715,6,2009-06-25,111,現金,旅費,1195,0,5320280
3925,0001-20090625-54-628-1-1717,1,2009-06-25,111,現金,駐車代,95,0,5320375
3929,0001-20090625-62-629-1-1719,1,2009-06-25,131,普通預金,携帯代,6027,0,5326402
3935,0001-20090625-72-630-1-1721,1,2009-06-25,111,現金,新聞代,143,0,5326545
3938,0001-20090625-72-630-1-1721,4,2009-06-25,111,現金,新聞代,140,0,5326685
3940,0001-20090625-72-630-1-1721,6,2009-06-25,111,現金,新聞代,169,0,5326854
4058,0001-20090626-113-646-1-1753,1,2009-06-26,131,普通預金,携帯代,2922,0,5329776
4064,0001-20090626-114-647-1-1755,1,2009-06-26,111,現金,新聞代,126,0,5329902
4067,0001-20090626-114-647-1-1755,4,2009-06-26,111,現金,新聞代,143,0,5330045
4070,0001-20090626-120-648-1-1757,1,2009-06-26,322,未払金,業務委託費,22500,0,5352545
4074,0001-20090626-13-640-1-1741,1,2009-06-26,111,現金,ガソリン代,164,0,5352709
4078,0001-20090626-138-649-1-1759,1,2009-06-26,111,現金,高速代,337,0,5353046
4082,0001-20090626-14-641-1-1743,1,2009-06-26,111,現金,洗車代,142,0,5353188
4086,0001-20090626-146-650-1-1761,1,2009-06-26,322,未払金,業務委託費,7000,0,5360188
4090,0001-20090626-172-651-1-1763,1,2009-06-26,322,未払金,業務委託費支払い,6904,0,5367092
4094,0001-20090626-37-642-1-1745,1,2009-06-26,322,未払金,業務委託費,62857,0,5429949
4101,0001-20090626-87-644-1-1749,1,2009-06-26,131,普通預金,携帯代,2026,0,5431975
4107,0001-20090626-88-645-1-1751,1,2009-06-26,111,現金,新聞代,169,0,5432144
4119,0001-20090627-35-653-1-1767,1,2009-06-27,111,現金,新聞代,186,0,5432330
4123,0001-20090627-39-654-1-1769,1,2009-06-27,111,現金,会費,428,0,5432758
4127,0001-20090627-78-655-1-1771,1,2009-06-27,322,未払金,業務委託費支払い,9000,0,5441758
4131,0001-20090628-108-659-1-1779,1,2009-06-28,111,現金,コーヒー代2名,53,0,5441811
4151,0001-20090628-60-657-1-1775,1,2009-06-28,111,現金,旅費,690,0,5442501
4155,0001-20090628-93-658-1-1777,1,2009-06-28,322,未払金,修繕費,850,0,5443351
4159,0001-20090629-83-661-1-1783,1,2009-06-29,111,現金,車両管理費,2452,0,5445803
4163,0001-20090630-1-662-1-1785,1,2009-06-30,322,未払金,運賃　佐川急便,2921,0,5448724
4167,0001-20090630-100-678-1-1817,1,2009-06-30,111,現金,会費,285,0,5449009
4309,0001-20090630-125-685-1-1831,3,2009-06-30,152,売掛金,09年6月30日伝票No248マークマーケット,40,0,5449049
4317,0001-20090630-126-686-1-1833,3,2009-06-30,152,売掛金,09年6月30日伝票No249株式会社　ＡＢＣ,40,0,5449089
4330,0001-20090630-128-688-1-1837,5,2009-06-30,152,売掛金,09年6月30日伝票No251株式会社　畠山商事,30,0,5449119
4338,0001-20090630-129-689-1-1839,3,2009-06-30,152,売掛金,09年6月30日伝票No252株式会社　千代サービス,10,0,5449129
4345,0001-20090630-131-691-1-1843,1,2009-06-30,312,買掛金,09年6月1日～09年6月30日分仕入,3693,0,5452822
4348,0001-20090630-131-691-1-1843,4,2009-06-30,312,買掛金,09年6月1日～09年6月30日分仕入,2352,0,5455174
4352,0001-20090630-132-692-1-1845,1,2009-06-30,312,買掛金,09年6月1日～09年6月30日分仕入,199392,0,5654566
4355,0001-20090630-132-692-1-1845,4,2009-06-30,312,買掛金,09年6月1日～09年6月30日分仕入,276791,0,5931357
4358,0001-20090630-132-692-1-1845,7,2009-06-30,312,買掛金,09年6月1日～09年6月30日分仕入,136390,0,6067747
4361,0001-20090630-132-692-1-1845,10,2009-06-30,312,買掛金,09年6月1日～09年6月30日分仕入,149334,0,6217081
4364,0001-20090630-132-692-1-1845,13,2009-06-30,312,買掛金,09年6月1日～09年6月30日分仕入,58320,0,6275401
4368,0001-20090630-132-692-1-1845,17,2009-06-30,312,買掛金,09年6月1日～09年6月30日分仕入,704,0,6276105
4370,0001-20090630-132-692-1-1845,19,2009-06-30,312,買掛金,09年6月1日～09年6月30日分仕入,15073,0,6291178
4373,0001-20090630-132-692-1-1845,22,2009-06-30,312,買掛金,09年6月1日～09年6月30日分仕入,3214,0,6294392
4376,0001-20090630-132-692-1-1845,25,2009-06-30,312,買掛金,09年6月1日～09年6月30日分仕入,10584,0,6304976
4379,0001-20090630-132-692-1-1845,28,2009-06-30,312,買掛金,09年6月1日～09年6月30日分仕入,980,0,6305956
4382,0001-20090630-132-692-1-1845,31,2009-06-30,312,買掛金,09年6月1日～09年6月30日分仕入,29337,0,6335293
4386,0001-20090630-133-693-1-1847,1,2009-06-30,312,買掛金,09年6月1日～09年6月30日分仕入,166182,0,6501475
4389,0001-20090630-133-693-1-1847,4,2009-06-30,312,買掛金,09年6月1日～09年6月30日分仕入,81529,0,6583004
4392,0001-20090630-133-693-1-1847,7,2009-06-30,312,買掛金,09年6月1日～09年6月30日分仕入,52792,0,6635796
4395,0001-20090630-133-693-1-1847,10,2009-06-30,312,買掛金,09年6月1日～09年6月30日分仕入,5538,0,6641334
4398,0001-20090630-133-693-1-1847,13,2009-06-30,312,買掛金,09年6月1日～09年6月30日分仕入,1176,0,6642510
4401,0001-20090630-133-693-1-1847,16,2009-06-30,312,買掛金,09年6月1日～09年6月30日分仕入,2038,0,6644548
4405,0001-20090630-134-694-1-1849,1,2009-06-30,312,買掛金,09年6月1日～09年6月30日分仕入,144768,0,6789316
4408,0001-20090630-134-694-1-1849,4,2009-06-30,312,買掛金,09年6月1日～09年6月30日分仕入,165839,0,6955155
4411,0001-20090630-134-694-1-1849,7,2009-06-30,312,買掛金,09年6月1日～09年6月30日分仕入,176314,0,7131469
4414,0001-20090630-134-694-1-1849,10,2009-06-30,312,買掛金,09年6月1日～09年6月30日分仕入,42296,0,7173765
4418,0001-20090630-134-694-1-1849,14,2009-06-30,312,買掛金,09年6月1日～09年6月30日分仕入,16618,0,7190383
4420,0001-20090630-134-694-1-1849,16,2009-06-30,312,買掛金,09年6月1日～09年6月30日分仕入,960,0,7191343
4423,0001-20090630-134-694-1-1849,19,2009-06-30,312,買掛金,09年6月1日～09年6月30日分仕入,2116,0,7193459
4426,0001-20090630-134-694-1-1849,22,2009-06-30,312,買掛金,09年6月1日～09年6月30日分仕入,1076,0,7194535
4429,0001-20090630-134-694-1-1849,25,2009-06-30,312,買掛金,09年6月1日～09年6月30日分仕入,1116,0,7195651
4433,0001-20090630-135-695-1-1851,1,2009-06-30,312,買掛金,09年6月1日～09年6月30日分仕入,6565,0,7202216
4436,0001-20090630-135-695-1-1851,4,2009-06-30,312,買掛金,09年6月1日～09年6月30日分仕入,2352,0,7204568
4445,0001-20090630-137-697-1-1855,1,2009-06-30,322,未払金,有線,300,0,7204868
4448,0001-20090630-137-697-1-1855,4,2009-06-30,322,未払金,警備料,2142,0,7207010
4450,0001-20090630-137-697-1-1855,6,2009-06-30,131,普通預金,高速料,2538,0,7209548
4455,0001-20090630-137-697-1-1855,9,2009-06-30,322,未払金,清掃料,3500,0,7213048
4496,0001-20090630-145-705-1-1871,1,2009-06-30,322,未払金,運賃,6783,0,7219831
4534,0001-20090630-36-663-1-1787,1,2009-06-30,322,未払金,運賃　ヤマト運輸,81850,0,7301681
4537,0001-20090630-36-663-1-1787,4,2009-06-30,322,未払金,運賃　佐川急便,40287,0,7341968
4540,0001-20090630-40-664-1-1789,1,2009-06-30,322,未払金,広告掲載,2380,0,7344348
4544,0001-20090630-49-665-1-1791,1,2009-06-30,131,普通預金,ガソリン代,5714,0,7350062
4558,0001-20090630-70-668-1-1797,1,2009-06-30,322,未払金,有線,300,0,7350362
4561,0001-20090630-70-668-1-1797,4,2009-06-30,322,未払金,警備料,2619,0,7352981
4563,0001-20090630-70-668-1-1797,6,2009-06-30,131,普通預金,高速料,3016,0,7355997
4568,0001-20090630-70-668-1-1797,9,2009-06-30,322,未払金,清掃料,3500,0,7359497
4572,0001-20090630-77-669-1-1799,1,2009-06-30,322,未払金,運賃,7107,0,7366604
4593,0001-20090630-84-673-1-1807,1,2009-06-30,111,現金,ガソリン代,162,0,7366766
4668,0001-20090630-96-676-1-1813,1,2009-06-30,131,普通預金,警備料,1070,0,7367836
4674,0001-20090630-99-677-1-1815,1,2009-06-30,322,未払金,運賃,29163,0,7396999
,,,2009-06,,※※月計※※,,2439428,0,
4678,0001-20090701-116-714-1-1889,1,2009-07-01,131,普通預金,リース料,4000,0,7400999
4684,0001-20090701-56-710-1-1881,1,2009-07-01,111,現金,旅費,942,0,7401941
4688,0001-20090701-66-711-1-1883,1,2009-07-01,131,普通預金,リース料,9992,0,7411933
4694,0001-20090701-70-712-1-1885,1,2009-07-01,111,現金,電池代,21,0,7411954
4698,0001-20090701-79-713-1-1887,1,2009-07-01,111,現金,景品代,1670,0,7413624
4702,0001-20090702-142-716-1-1893,1,2009-07-02,111,現金,洗車代,122,0,7413746
4705,0001-20090702-142-716-1-1893,4,2009-07-02,111,現金,ガソリン代,311,0,7414057
4707,0001-20090702-142-716-1-1893,6,2009-07-02,111,現金,高速代,154,0,7414211
4709,0001-20090702-142-716-1-1893,8,2009-07-02,111,現金,高速代,23,0,7414234
4711,0001-20090702-142-716-1-1893,10,2009-07-02,111,現金,高速代,404,0,7414638
4713,0001-20090702-142-716-1-1893,12,2009-07-02,111,現金,ガソリン代,192,0,7414830
4716,0001-20090702-151-717-1-1895,1,2009-07-02,111,現金,食事代　ダイニング彩2名,307,0,7415137
4719,0001-20090702-151-717-1-1895,4,2009-07-02,111,現金,食事代　イタリアンレストランペンネ4名,445,0,7415582
4722,0001-20090702-32-715-1-1891,1,2009-07-02,322,未払金,事務用品費,106,0,7415688
4726,0001-20090703-134-720-1-1901,1,2009-07-03,111,現金,用紙,656,0,7416344
4730,0001-20090703-19-718-1-1897,1,2009-07-03,111,現金,旅費,497,0,7416841
4734,0001-20090703-80-719-1-1899,1,2009-07-03,111,現金,タクシー代,309,0,7417150
4738,0001-20090704-10-721-1-1903,1,2009-07-04,111,現金,ガソリン代,348,0,7417498
4745,0001-20090704-73-723-1-1907,1,2009-07-04,111,現金,飲食代　カフェモントレ,696,0,7418194
4749,0001-20090704-82-724-1-1909,1,2009-07-04,322,未払金,ガソリン代,900,0,7419094
4753,0001-20090705-133-730-1-1921,1,2009-07-05,131,普通預金,税理士報酬,6652,0,7425746
4759,0001-20090705-18-725-1-1911,1,2009-07-05,111,現金,航空券,1166,0,7426912
4763,0001-20090705-42-726-1-1913,1,2009-07-05,111,現金,コーヒー代3名,75,0,7426987
4774,0001-20090705-87-727-1-1915,6,2009-07-05,152,売掛金,09年7月5日伝票No253株式会社　渡辺産業,22,0,7427009
4782,0001-20090705-88-728-1-1917,3,2009-07-05,152,売掛金,09年7月5日伝票No254佐々木販売株式会社,22,0,7427031
4791,0001-20090706-110-734-1-1929,1,2009-07-06,111,現金,タクシー代,109,0,7427140
4795,0001-20090706-156-735-1-1931,1,2009-07-06,111,現金,出張旅費,571,0,7427711
4799,0001-20090706-43-732-1-1925,1,2009-07-06,111,現金,昼食代　レストラン桜花3名,340,0,7428051
4803,0001-20090706-7-731-1-1923,1,2009-07-06,111,現金,食事代　ホテルランチ2名,277,0,7428328
4806,0001-20090706-7-731-1-1923,4,2009-07-06,111,現金,コーヒー代2名,52,0,7428380
4809,0001-20090706-94-733-1-1927,1,2009-07-06,111,現金,トイレットペーパー代,147,0,7428527
4813,0001-20090707-21-736-1-1933,1,2009-07-07,111,現金,JR代,3309,0,7431836
4817,0001-20090707-22-737-1-1935,1,2009-07-07,111,現金,旅費,2380,0,7434216
4821,0001-20090707-50-738-1-1937,1,2009-07-07,111,現金,ガソリン代,571,0,7434787
4825,0001-20090708-103-742-1-1945,1,2009-07-08,111,現金,コーヒー代4名,105,0,7434892
4829,0001-20090708-147-743-1-1947,1,2009-07-08,322,未払金,ガソリン代,270,0,7435162
4832,0001-20090708-147-743-1-1947,4,2009-07-08,322,未払金,高速代,242,0,7435404
4834,0001-20090708-147-743-1-1947,6,2009-07-08,322,未払金,駐車代,28,0,7435432
4837,0001-20090708-150-744-1-1949,1,2009-07-08,111,現金,ゴルフプレー代2名,868,0,7436300
4841,0001-20090708-157-745-1-1951,1,2009-07-08,131,普通預金,航空券代,2142,0,7438442
4847,0001-20090708-20-739-1-1939,1,2009-07-08,111,現金,旅費,2000,0,7440442
4851,0001-20090708-68-740-1-1941,1,2009-07-08,111,現金,トイレットペーパー他,112,0,7440554
4855,0001-20090708-76-741-1-1943,1,2009-07-08,322,未払金,景品代,2907,0,7443461
4859,0001-20090709-143-747-1-1955,1,2009-07-09,111,現金,点検作業料,1904,0,7445365
4863,0001-20090709-79-746-1-1953,1,2009-07-09,111,現金,ガソリン代,167,0,7445532
4867,0001-20090710-112-761-1-1983,1,2009-07-10,131,普通預金,電話代,11753,0,7457285
4873,0001-20090710-129-762-1-1985,1,2009-07-10,131,普通預金,家賃支払い,19000,0,7476285
4884,0001-20090710-152-764-1-1989,1,2009-07-10,111,現金,コーヒー代2名,74,0,7476359
4888,0001-20090710-162-765-1-1991,1,2009-07-10,111,現金,会議　食事代,1190,0,7477549
4892,0001-20090710-167-766-1-1993,1,2009-07-10,131,普通預金,家賃支払い,30000,0,7507549
4897,0001-20090710-167-766-1-1993,4,2009-07-10,131,普通預金,電話代,7905,0,7515454
4900,0001-20090710-168-767-1-1995,1,2009-07-10,322,未払金,有線,300,0,7515754
4903,0001-20090710-168-767-1-1995,4,2009-07-10,322,未払金,警備料,2142,0,7517896
4906,0001-20090710-33-748-1-1957,1,2009-07-10,131,普通預金,家賃支払い,15238,0,7533134
4911,0001-20090710-33-748-1-1957,4,2009-07-10,131,普通預金,電話代,7397,0,7540531
4917,0001-20090710-57-749-1-1959,1,2009-07-10,111,現金,JR代,3717,0,7544248
4921,0001-20090710-65-750-1-1961,1,2009-07-10,131,普通預金,家賃支払,40000,0,7584248
4927,0001-20090710-67-751-1-1963,1,2009-07-10,322,未払金,有線,250,0,7584498
4930,0001-20090710-67-751-1-1963,4,2009-07-10,322,未払金,警備料,1714,0,7586212
4943,0001-20090710-85-753-1-1967,1,2009-07-10,131,普通預金,電話代,3982,0,7590194
4953,0001-20090710-90-754-1-1969,3,2009-07-10,152,売掛金,09年7月10日伝票No256株式会社　ミナミ,35,0,7590229
4967,0001-20090710-93-757-1-1975,3,2009-07-10,152,売掛金,09年7月10日伝票No497株式会社　藤田東京本社,40,0,7590269
4979,0001-20090710-96-760-1-1981,1,2009-07-10,131,普通預金,家賃支払,60000,0,7650269
4985,0001-20090711-23-768-1-1997,1,2009-07-11,111,現金,旅費,1747,0,7652016
4988,0001-20090711-23-768-1-1997,4,2009-07-11,111,現金,旅費,1366,0,7653382
4990,0001-20090711-23-768-1-1997,6,2009-07-11,111,現金,旅費,2795,0,7656177
4998,0001-20090711-69-770-1-2001,1,2009-07-11,111,現金,トイレットペーパー代,38,0,7656215
5001,0001-20090711-69-770-1-2001,4,2009-07-11,111,現金,洗剤代,40,0,7656255
5007,0001-20090712-58-771-1-2003,1,2009-07-12,111,現金,旅費,2850,0,7659105
5011,0001-20090712-74-772-1-2005,1,2009-07-12,111,現金,食事代　トン吉4名,413,0,7659518
5015,0001-20090712-81-773-1-2007,1,2009-07-12,111,現金,旅費,976,0,7660494
5019,0001-20090714-104-777-1-2015,1,2009-07-14,111,現金,手土産代　阿部商店,75,0,7660569
5023,0001-20090714-51-775-1-2011,1,2009-07-14,111,現金,高速代,358,0,7660927
5026,0001-20090714-51-775-1-2011,4,2009-07-14,111,現金,駐車代,164,0,7661091
5029,0001-20090714-74-776-1-2013,1,2009-07-14,111,現金,ゴルフプレー代,376,0,7661467
5042,0001-20090715-101-785-1-2031,3,2009-07-15,152,売掛金,09年7月15日伝票No263株式会社　久城商事,15,0,7661482
5059,0001-20090715-141-789-1-2039,1,2009-07-15,111,現金,JR代,357,0,7661839
5063,0001-20090715-46-778-1-2017,1,2009-07-15,111,現金,ガソリン代,666,0,7662505
5080,0001-20090715-96-780-1-2021,3,2009-07-15,152,売掛金,09年7月15日伝票No258五越株式会社,40,0,7662545
5088,0001-20090715-97-781-1-2023,3,2009-07-15,152,売掛金,09年7月15日伝票No259株式会社　エントリー,40,0,7662585
5096,0001-20090715-98-782-1-2025,3,2009-07-15,152,売掛金,09年7月15日伝票No260タワー株式会社,40,0,7662625
5104,0001-20090715-99-783-1-2027,3,2009-07-15,152,売掛金,09年7月15日伝票No261高橋物産株式会社,40,0,7662665
5108,0001-20090716-105-793-1-2047,1,2009-07-16,111,現金,飲食代　ダイニング彩4名,873,0,7663538
5111,0001-20090716-105-793-1-2047,4,2009-07-16,111,現金,飲食代　スナック箱船4名,1565,0,7665103
5114,0001-20090716-11-790-1-2041,1,2009-07-16,111,現金,ガソリン代,152,0,7665255
5118,0001-20090716-136-794-1-2049,1,2009-07-16,111,現金,ダスキン代,785,0,7666040
5122,0001-20090716-161-795-1-2051,1,2009-07-16,111,現金,旅費,166,0,7666206
5126,0001-20090716-52-791-1-2043,1,2009-07-16,111,現金,高速代,169,0,7666375
5129,0001-20090716-52-791-1-2043,4,2009-07-16,111,現金,ガソリン代,3571,0,7669946
5132,0001-20090716-61-792-1-2045,1,2009-07-16,131,普通預金,電話代,6408,0,7676354
5138,0001-20090717-12-797-1-2055,1,2009-07-17,111,現金,駐車代,38,0,7676392
5141,0001-20090717-12-797-1-2055,4,2009-07-17,111,現金,ガソリン代,222,0,7676614
5144,0001-20090717-12-797-1-2055,7,2009-07-17,111,現金,ガソリン代,200,0,7676814
5147,0001-20090717-4-796-1-2053,1,2009-07-17,322,未払金,広告費,1500,0,7678314
5151,0001-20090718-123-800-1-2061,1,2009-07-18,111,現金,切手代,761,0,7679075
5155,0001-20090718-139-801-1-2063,1,2009-07-18,322,未払金,社員夜食代,2143,0,7681218
5159,0001-20090718-148-802-1-2065,1,2009-07-18,111,現金,ガソリン代,224,0,7681442
5162,0001-20090718-148-802-1-2065,4,2009-07-18,111,現金,ウォッシャー液他,80,0,7681522
5165,0001-20090718-59-798-1-2057,1,2009-07-18,111,現金,旅費,2142,0,7683664
5169,0001-20090718-82-799-1-2059,1,2009-07-18,111,現金,旅費,466,0,7684130
5173,0001-20090719-160-805-1-2071,1,2009-07-19,111,現金,出張旅費,4128,0,7688258
5177,0001-20090719-47-804-1-2069,1,2009-07-19,111,現金,ガソリン代,406,0,7688664
5181,0001-20090719-8-803-1-2067,1,2009-07-19,111,現金,定例ミーティング会費,952,0,7689616
5184,0001-20090719-8-803-1-2067,4,2009-07-19,111,現金,景品,150,0,7689766
5187,0001-20090720-101-817-1-2095,1,2009-07-20,322,未払金,広告料,2500,0,7692266
5198,0001-20090720-104-819-1-2099,3,2009-07-20,152,売掛金,09年7月20日伝票No265合同会社　たかだ,30,0,7692296
5206,0001-20090720-105-820-1-2101,3,2009-07-20,152,売掛金,09年7月20日伝票No266株式会社　ＹＡＧ,35,0,7692331
5225,0001-20090720-118-824-1-2109,1,2009-07-20,322,未払金,コピー代,343,0,7692674
5229,0001-20090720-119-825-1-2111,1,2009-07-20,322,未払金,事務用品,70,0,7692744
5256,0001-20090720-144-829-1-2119,1,2009-07-20,111,現金,ガソリン代,216,0,7692960
5259,0001-20090720-144-829-1-2119,4,2009-07-20,111,現金,高速代,170,0,7693130
5261,0001-20090720-144-829-1-2119,6,2009-07-20,111,現金,ガソリン代,352,0,7693482
5264,0001-20090720-158-830-1-2121,1,2009-07-20,111,現金,出張旅費,476,0,7693958
5271,0001-20090720-164-832-1-2125,1,2009-07-20,111,現金,事務用品,284,0,7694242
5275,0001-20090720-31-807-1-2075,1,2009-07-20,322,未払金,コピー代,136,0,7694378
5279,0001-20090720-45-808-1-2077,1,2009-07-20,111,現金,コーヒー代2名,60,0,7694438
5283,0001-20090720-48-809-1-2079,1,2009-07-20,111,現金,ガソリン代,204,0,7694642
5287,0001-20090720-53-810-1-2081,1,2009-07-20,111,現金,ガソリン代,319,0,7694961
5290,0001-20090720-53-810-1-2081,4,2009-07-20,111,現金,駐車代,71,0,7695032
5292,0001-20090720-53-810-1-2081,6,2009-07-20,111,現金,高速代,35,0,7695067
5295,0001-20090720-6-806-1-2073,1,2009-07-20,111,現金,広告料,238,0,7695305
5299,0001-20090720-69-811-1-2083,1,2009-07-20,322,未払金,有線,238,0,7695543
5303,0001-20090720-71-812-1-2085,1,2009-07-20,322,未払金,事務用品,570,0,7696113
5306,0001-20090720-71-812-1-2085,4,2009-07-20,322,未払金,カウンター料金,1565,0,7697678
5309,0001-20090720-72-813-1-2087,1,2009-07-20,322,未払金,カウンター料金,300,0,7697978
5313,0001-20090720-77-814-1-2089,1,2009-07-20,322,未払金,ファイル等,969,0,7698947
5316,0001-20090720-77-814-1-2089,4,2009-07-20,322,未払金,飲料水,11950,0,7710897
5318,0001-20090720-77-814-1-2089,6,2009-07-20,322,未払金,名刺代,504,0,7711401
5321,0001-20090720-97-815-1-2091,1,2009-07-20,322,未払金,コピー代,1704,0,7713105
5325,0001-20090720-98-816-1-2093,1,2009-07-20,322,未払金,事務用品,280,0,7713385
5329,0001-20090721-159-835-1-2131,1,2009-07-21,111,現金,タクシー代,465,0,7713850
5333,0001-20090721-25-833-1-2127,1,2009-07-21,111,現金,旅費,2666,0,7716516
5337,0001-20090721-63-834-1-2129,1,2009-07-21,322,未払金,お茶代,526,0,7717042
5341,0001-20090722-132-842-1-2145,1,2009-07-22,131,普通預金,電気代,4697,0,7721739
5346,0001-20090722-132-842-1-2145,4,2009-07-22,131,普通預金,水道代,236,0,7721975
5349,0001-20090722-165-843-1-2147,1,2009-07-22,111,現金,洗剤他,120,0,7722095
5353,0001-20090722-166-844-1-2149,1,2009-07-22,111,現金,ダスキン代,90,0,7722185
5357,0001-20090722-169-845-1-2151,1,2009-07-22,131,普通預金,電気料,5313,0,7727498
5362,0001-20090722-169-845-1-2151,4,2009-07-22,131,普通預金,水道料,332,0,7727830
5365,0001-20090722-26-836-1-2133,1,2009-07-22,111,現金,旅費,907,0,7728737
5369,0001-20090722-34-837-1-2135,1,2009-07-22,131,普通預金,電気代,4835,0,7733572
5374,0001-20090722-34-837-1-2135,4,2009-07-22,131,普通預金,水道代,262,0,7733834
5377,0001-20090722-64-838-1-2137,1,2009-07-22,131,普通預金,電気料,8546,0,7742380
5382,0001-20090722-64-838-1-2137,4,2009-07-22,131,普通預金,水道料,382,0,7742762
5385,0001-20090722-89-839-1-2139,1,2009-07-22,131,普通預金,電気料,3939,0,7746701
5390,0001-20090722-89-839-1-2139,4,2009-07-22,131,普通預金,水道料,169,0,7746870
5392,0001-20090722-89-839-1-2139,6,2009-07-22,131,普通預金,ガス代,153,0,7747023
5395,0001-20090722-90-840-1-2141,1,2009-07-22,111,現金,ダスキン代,500,0,7747523
5399,0001-20090722-95-841-1-2143,1,2009-07-22,322,未払金,清掃料,3413,0,7750936
5403,0001-20090723-140-847-1-2155,1,2009-07-23,111,現金,旅費,523,0,7751459
5407,0001-20090723-24-846-1-2153,1,2009-07-23,111,現金,JR回数券,3934,0,7755393
5411,0001-20090724-137-850-1-2161,1,2009-07-24,322,未払金,有線,300,0,7755693
5414,0001-20090724-137-850-1-2161,4,2009-07-24,322,未払金,警備料,2142,0,7757835
5416,0001-20090724-137-850-1-2161,6,2009-07-24,131,普通預金,高速料,1416,0,7759251
5421,0001-20090724-137-850-1-2161,9,2009-07-24,322,未払金,清掃料,3500,0,7762751
5424,0001-20090724-137-850-1-2161,12,2009-07-24,111,現金,駐車代,167,0,7762918
5428,0001-20090724-154-851-1-2163,1,2009-07-24,322,未払金,飲食代　博多亭3名,651,0,7763569
5431,0001-20090724-154-851-1-2163,4,2009-07-24,322,未払金,飲食代　スナックみわ,1173,0,7764742
5434,0001-20090724-172-852-1-2165,1,2009-07-24,322,未払金,業務委託費支払い,6285,0,7771027
5438,0001-20090724-38-848-1-2157,1,2009-07-24,322,未払金,宿泊費,2293,0,7773320
5442,0001-20090724-54-849-1-2159,1,2009-07-24,111,現金,高速代,142,0,7773462
5445,0001-20090724-54-849-1-2159,4,2009-07-24,111,現金,ガソリン代,220,0,7773682
5448,0001-20090725-109-863-1-2187,1,2009-07-25,322,未払金,ガソリン代,2119,0,7775801
5458,0001-20090725-110-864-1-2189,3,2009-07-25,152,売掛金,09年7月25日伝票No268株式会社　総合経営,35,0,7775836
5462,0001-20090725-111-865-1-2191,1,2009-07-25,322,未払金,タクシー代,1123,0,7776959
5469,0001-20090725-111-865-1-2191,6,2009-07-25,152,売掛金,09年7月25日伝票No269株式会社　鎌田商店,30,0,7776989
5477,0001-20090725-112-866-1-2193,3,2009-07-25,152,売掛金,09年7月25日伝票No270株式会社　小林マーケット,40,0,7777029
5481,0001-20090725-114-867-1-2195,1,2009-07-25,111,現金,新聞代,126,0,7777155
5484,0001-20090725-114-867-1-2195,4,2009-07-25,111,現金,新聞代,143,0,7777298
5492,0001-20090725-153-869-1-2199,1,2009-07-25,111,現金,食事代　カナッシュ2名,168,0,7777466
5496,0001-20090725-155-870-1-2201,1,2009-07-25,111,現金,ガソリン代,345,0,7777811
5500,0001-20090725-170-871-1-2203,1,2009-07-25,111,現金,新聞代,143,0,7777954
5504,0001-20090725-171-872-1-2205,1,2009-07-25,131,普通預金,携帯代,3385,0,7781339
5510,0001-20090725-28-854-1-2169,1,2009-07-25,322,未払金,タクシー代,285,0,7781624
5514,0001-20090725-29-855-1-2171,1,2009-07-25,131,普通預金,携帯電話代,4016,0,7785640
5520,0001-20090725-3-853-1-2167,1,2009-07-25,322,未払金,宿泊代,1429,0,7787069
5524,0001-20090725-35-856-1-2173,1,2009-07-25,111,現金,新聞代,186,0,7787255
5528,0001-20090725-60-857-1-2175,1,2009-07-25,111,現金,旅費,533,0,7787788
5532,0001-20090725-78-858-1-2177,1,2009-07-25,322,未払金,業務委託費支払い,9000,0,7796788
5651,0001-20090725-87-860-1-2181,1,2009-07-25,131,普通預金,携帯代,3011,0,7799799
5657,0001-20090725-88-861-1-2183,1,2009-07-25,111,現金,新聞代,169,0,7799968
5661,0001-20090725-92-862-1-2185,1,2009-07-25,322,未払金,コピー機修繕,857,0,7800825
5665,0001-20090726-113-876-1-2213,1,2009-07-26,131,普通預金,携帯代,2344,0,7803169
5671,0001-20090726-120-877-1-2215,1,2009-07-26,322,未払金,業務委託費,16000,0,7819169
5675,0001-20090726-146-878-1-2217,1,2009-07-26,322,未払金,業務委託費,7000,0,7826169
5679,0001-20090726-27-873-1-2207,1,2009-07-26,111,現金,旅費,716,0,7826885
5682,0001-20090726-27-873-1-2207,4,2009-07-26,111,現金,旅費,2184,0,7829069
5684,0001-20090726-27-873-1-2207,6,2009-07-26,111,現金,旅費,1503,0,7830572
5687,0001-20090726-73-874-1-2209,1,2009-07-26,111,現金,ゴルフプレー代2名,1533,0,7832105
5691,0001-20090726-83-875-1-2211,1,2009-07-26,111,現金,ＪＲ代,571,0,7832676
5695,0001-20090727-15-879-1-2219,1,2009-07-27,111,現金,高速代,142,0,7832818
5704,0001-20090727-37-881-1-2223,1,2009-07-27,322,未払金,業務委託費,23866,0,7856684
5707,0001-20090727-37-881-1-2223,4,2009-07-27,322,未払金,業務委託費,13300,0,7869984
5709,0001-20090727-37-881-1-2223,6,2009-07-27,322,未払金,業務委託費,40818,0,7910802
5712,0001-20090727-39-882-1-2225,1,2009-07-27,111,現金,会費,428,0,7911230
5716,0001-20090727-62-883-1-2227,1,2009-07-27,131,普通預金,携帯代,5249,0,7916479
5722,0001-20090727-83-884-1-2229,1,2009-07-27,111,現金,車両管理費,2142,0,7918621
5726,0001-20090728-121-889-1-2239,1,2009-07-28,111,現金,お茶代,500,0,7919121
5730,0001-20090728-138-890-1-2241,1,2009-07-28,111,現金,高速代,214,0,7919335
5733,0001-20090728-138-890-1-2241,4,2009-07-28,111,現金,駐車代,152,0,7919487
5735,0001-20090728-138-890-1-2241,6,2009-07-28,111,現金,高速代,311,0,7919798
5737,0001-20090728-138-890-1-2241,8,2009-07-28,111,現金,高速代,23,0,7919821
5739,0001-20090728-138-890-1-2241,10,2009-07-28,111,現金,高速代,117,0,7919938
5741,0001-20090728-138-890-1-2241,12,2009-07-28,111,現金,ガソリン代,309,0,7920247
5744,0001-20090728-72-886-1-2233,1,2009-07-28,111,現金,新聞代,143,0,7920390
5747,0001-20090728-72-886-1-2233,4,2009-07-28,111,現金,新聞代,140,0,7920530
5749,0001-20090728-72-886-1-2233,6,2009-07-28,111,現金,新聞代,169,0,7920699
5752,0001-20090728-81-887-1-2235,1,2009-07-28,322,未払金,お茶代,1047,0,7921746
5756,0001-20090728-9-885-1-2231,1,2009-07-28,111,現金,手土産ジュース他　総合経営,120,0,7921866
5760,0001-20090728-93-888-1-2237,1,2009-07-28,322,未払金,修繕費,850,0,7922716
5764,0001-20090729-108-892-1-2245,1,2009-07-29,111,現金,コーヒー代他　2名,74,0,7922790
5768,0001-20090729-14-891-1-2243,1,2009-07-29,111,現金,ガソリン代,142,0,7922932
5772,0001-20090730-100-900-1-2261,1,2009-07-30,111,現金,会費,285,0,7923217
5781,0001-20090730-49-893-1-2247,1,2009-07-30,111,現金,ガソリン代,8095,0,7931312
5784,0001-20090730-49-893-1-2247,4,2009-07-30,111,現金,車両管理費,1000,0,7932312
5812,0001-20090730-70-897-1-2255,1,2009-07-30,322,未払金,有線,300,0,7932612
5815,0001-20090730-70-897-1-2255,4,2009-07-30,322,未払金,警備料,2619,0,7935231
5817,0001-20090730-70-897-1-2255,6,2009-07-30,322,未払金,清掃料,3500,0,7938731
5821,0001-20090730-71-898-1-2257,1,2009-07-30,111,現金,洗剤代,38,0,7938769
5825,0001-20090730-96-899-1-2259,1,2009-07-30,131,普通預金,警備料,1070,0,7939839
5831,0001-20090731-1-902-1-2265,1,2009-07-31,322,未払金,運賃　佐川急便,7752,0,7947591
5934,0001-20090731-116-916-1-2293,28,2009-07-31,131,普通預金,リース料,4000,0,7951591
5957,0001-20090731-118-918-1-2297,3,2009-07-31,152,売掛金,09年7月31日伝票No271マークマーケット,40,0,7951631
5965,0001-20090731-119-919-1-2299,3,2009-07-31,152,売掛金,09年7月31日伝票No272株式会社　ＡＢＣ,40,0,7951671
5976,0001-20090731-121-921-1-2303,3,2009-07-31,152,売掛金,09年7月31日伝票No274株式会社　畠山商事,22,0,7951693
5984,0001-20090731-122-922-1-2305,3,2009-07-31,152,売掛金,09年7月31日伝票No275株式会社　千代サービス,10,0,7951703
5991,0001-20090731-124-924-1-2309,1,2009-07-31,312,買掛金,09年7月1日～09年7月31日分仕入,2352,0,7954055
5994,0001-20090731-124-924-1-2309,4,2009-07-31,312,買掛金,09年7月1日～09年7月31日分仕入,8412,0,7962467
5998,0001-20090731-125-925-1-2311,1,2009-07-31,312,買掛金,09年7月1日～09年7月31日分仕入,140624,0,8103091
6001,0001-20090731-125-925-1-2311,4,2009-07-31,312,買掛金,09年7月1日～09年7月31日分仕入,153142,0,8256233
6004,0001-20090731-125-925-1-2311,7,2009-07-31,312,買掛金,09年7月1日～09年7月31日分仕入,1643,0,8257876
6007,0001-20090731-125-925-1-2311,10,2009-07-31,312,買掛金,09年7月1日～09年7月31日分仕入,62724,0,8320600
6010,0001-20090731-125-925-1-2311,13,2009-07-31,312,買掛金,09年7月1日～09年7月31日分仕入,291395,0,8611995
6014,0001-20090731-125-925-1-2311,17,2009-07-31,312,買掛金,09年7月1日～09年7月31日分仕入,209459,0,8821454
6016,0001-20090731-125-925-1-2311,19,2009-07-31,312,買掛金,09年7月1日～09年7月31日分仕入,16027,0,8837481
6019,0001-20090731-125-925-1-2311,22,2009-07-31,312,買掛金,09年7月1日～09年7月31日分仕入,30977,0,8868458
6022,0001-20090731-125-925-1-2311,25,2009-07-31,312,買掛金,09年7月1日～09年7月31日分仕入,7996,0,8876454
6025,0001-20090731-125-925-1-2311,28,2009-07-31,312,買掛金,09年7月1日～09年7月31日分仕入,916,0,8877370
6029,0001-20090731-126-926-1-2313,1,2009-07-31,312,買掛金,09年7月1日～09年7月31日分仕入,86616,0,8963986
6032,0001-20090731-126-926-1-2313,4,2009-07-31,312,買掛金,09年7月1日～09年7月31日分仕入,55196,0,9019182
6035,0001-20090731-126-926-1-2313,7,2009-07-31,312,買掛金,09年7月1日～09年7月31日分仕入,173284,0,9192466
6038,0001-20090731-126-926-1-2313,10,2009-07-31,312,買掛金,09年7月1日～09年7月31日分仕入,892,0,9193358
6041,0001-20090731-126-926-1-2313,13,2009-07-31,312,買掛金,09年7月1日～09年7月31日分仕入,3693,0,9197051
6044,0001-20090731-126-926-1-2313,16,2009-07-31,312,買掛金,09年7月1日～09年7月31日分仕入,1176,0,9198227
6048,0001-20090731-127-927-1-2315,1,2009-07-31,312,買掛金,09年7月1日～09年7月31日分仕入,182886,0,9381113
6051,0001-20090731-127-927-1-2315,4,2009-07-31,312,買掛金,09年7月1日～09年7月31日分仕入,44232,0,9425345
6054,0001-20090731-127-927-1-2315,7,2009-07-31,312,買掛金,09年7月1日～09年7月31日分仕入,149923,0,9575268
6057,0001-20090731-127-927-1-2315,10,2009-07-31,312,買掛金,09年7月1日～09年7月31日分仕入,171459,0,9746727
6060,0001-20090731-127-927-1-2315,13,2009-07-31,312,買掛金,09年7月1日～09年7月31日分仕入,705,0,9747432
6063,0001-20090731-127-927-1-2315,16,2009-07-31,312,買掛金,09年7月1日～09年7月31日分仕入,7056,0,9754488
6066,0001-20090731-127-927-1-2315,19,2009-07-31,312,買掛金,09年7月1日～09年7月31日分仕入,10258,0,9764746
6070,0001-20090731-128-928-1-2317,1,2009-07-31,312,買掛金,09年7月1日～09年7月31日分仕入,1176,0,9765922
6073,0001-20090731-128-928-1-2317,4,2009-07-31,312,買掛金,09年7月1日～09年7月31日分仕入,9437,0,9775359
6134,0001-20090731-145-940-1-2341,1,2009-07-31,322,未払金,運賃,7866,0,9783225
6155,0001-20090731-36-903-1-2267,1,2009-07-31,322,未払金,運賃　ヤマト運輸,91750,0,9874975
6158,0001-20090731-36-903-1-2267,4,2009-07-31,322,未払金,運賃　佐川急便,48202,0,9923177
6161,0001-20090731-40-904-1-2269,1,2009-07-31,322,未払金,広告掲載,2380,0,9925557
6165,0001-20090731-66-905-1-2271,1,2009-07-31,131,普通預金,リース料,9992,0,9935549
6195,0001-20090731-77-909-1-2279,1,2009-07-31,322,未払金,運賃,5979,0,9941528
6211,0001-20090731-99-912-1-2285,1,2009-07-31,322,未払金,運賃,35961,0,9977489
,,,2009-07,,※※月計※※,,2580490,0,
6215,0001-20090801-102-947-1-2355,1,2009-08-01,111,現金,手土産代　阿部商店,100,0,9977589
6219,0001-20090801-18-944-1-2349,1,2009-08-01,111,現金,旅費,1000,0,9978589
6223,0001-20090801-41-945-1-2351,1,2009-08-01,111,現金,食事代　レストランフレンド3名,167,0,9978756
6227,0001-20090801-50-946-1-2353,1,2009-08-01,111,現金,高速代,28,0,9978784
6231,0001-20090802-147-948-1-2357,1,2009-08-02,322,未払金,ガソリン代,316,0,9979100
6235,0001-20090803-134-951-1-2363,1,2009-08-03,322,未払金,用紙,751,0,9979851
6238,0001-20090803-134-951-1-2363,4,2009-08-03,322,未払金,用紙,800,0,9980651
6242,0001-20090803-139-952-1-2365,1,2009-08-03,322,未払金,社員夜食代,1209,0,9981860
6246,0001-20090803-142-953-1-2367,1,2009-08-03,111,現金,高速代,122,0,9981982
6249,0001-20090803-142-953-1-2367,4,2009-08-03,111,現金,ガソリン代,152,0,9982134
6251,0001-20090803-142-953-1-2367,6,2009-08-03,111,現金,高速代,59,0,9982193
6253,0001-20090803-142-953-1-2367,8,2009-08-03,111,現金,高速代,427,0,9982620
6255,0001-20090803-142-953-1-2367,10,2009-08-03,111,現金,高速代,214,0,9982834
6258,0001-20090803-56-949-1-2359,1,2009-08-03,111,現金,旅費,747,0,9983581
6262,0001-20090803-82-950-1-2361,1,2009-08-03,322,未払金,ガソリン代,858,0,9984439
6266,0001-20090804-141-955-1-2371,1,2009-08-04,111,現金,JR代,409,0,9984848
6270,0001-20090804-42-954-1-2369,1,2009-08-04,111,現金,昼食代3名　ホテルエルディ,221,0,9985069
6274,0001-20090805-133-961-1-2383,1,2009-08-05,131,普通預金,税理士報酬,6652,0,9991721
6280,0001-20090805-19-956-1-2373,1,2009-08-05,111,現金,旅費,500,0,9992221
6284,0001-20090805-57-957-1-2375,1,2009-08-05,111,現金,JR代,4271,0,9996492
6292,0001-20090805-84-958-1-2377,3,2009-08-05,152,売掛金,09年8月5日伝票No276株式会社　渡辺産業,22,0,9996514
6300,0001-20090805-85-959-1-2379,3,2009-08-05,152,売掛金,09年8月5日伝票No277佐々木販売株式会社,22,0,9996536
6309,0001-20090806-106-963-1-2387,1,2009-08-06,111,現金,お中元　五越百貨店,1840,0,9998376
6312,0001-20090806-106-963-1-2387,4,2009-08-06,111,現金,お中元　阿部商店,487,0,9998863
6315,0001-20090806-110-964-1-2389,1,2009-08-06,111,現金,タクシー代,109,0,9998972
6319,0001-20090806-156-965-1-2391,1,2009-08-06,111,現金,出張旅費,119,0,9999091
6323,0001-20090806-71-962-1-2385,1,2009-08-06,111,現金,ゴルフプレー代2名,1152,0,10000243
6327,0001-20090807-10-966-1-2393,1,2009-08-07,111,現金,ガソリン代,201,0,10000444
6331,0001-20090807-21-967-1-2395,1,2009-08-07,111,現金,JR代,3309,0,10003753
6335,0001-20090807-22-968-1-2397,1,2009-08-07,111,現金,旅費,2380,0,10006133
6339,0001-20090807-58-969-1-2399,1,2009-08-07,111,現金,旅費,3333,0,10009466
6343,0001-20090808-149-970-1-2401,1,2009-08-08,111,現金,手土産代　五越百貨店,500,0,10009966
6347,0001-20090808-150-971-1-2403,1,2009-08-08,111,現金,お中元　今井百貨店,3583,0,10013549
6351,0001-20090809-112-976-1-2413,1,2009-08-09,131,普通預金,電話代,8688,0,10022237
6357,0001-20090809-143-977-1-2415,1,2009-08-09,111,現金,点検作業料,1500,0,10023737
6361,0001-20090809-20-972-1-2405,1,2009-08-09,111,現金,旅費,1952,0,10025689
6365,0001-20090809-44-973-1-2407,1,2009-08-09,111,現金,手土産代　エントリー,135,0,10025824
6369,0001-20090809-46-974-1-2409,1,2009-08-09,111,現金,レーダー代,164,0,10025988
6372,0001-20090809-46-974-1-2409,4,2009-08-09,111,現金,ガソリン代,210,0,10026198
6375,0001-20090809-76-975-1-2411,1,2009-08-09,322,未払金,社員夜食代,1688,0,10027886
6379,0001-20090810-129-991-1-2443,1,2009-08-10,131,普通預金,家賃支払い,19000,0,10046886
6390,0001-20090810-148-993-1-2447,1,2009-08-10,111,現金,ガソリン代,187,0,10047073
6394,0001-20090810-151-994-1-2449,1,2009-08-10,111,現金,食事代　お好み焼きやきやき2名,136,0,10047209
6398,0001-20090810-152-995-1-2451,1,2009-08-10,111,現金,手土産代　大塚物産,150,0,10047359
6402,0001-20090810-162-996-1-2453,1,2009-08-10,111,現金,会議　食事代,1190,0,10048549
6406,0001-20090810-167-997-1-2455,1,2009-08-10,131,普通預金,家賃支払い,30000,0,10078549
6411,0001-20090810-167-997-1-2455,4,2009-08-10,131,普通預金,電話代,5748,0,10084297
6417,0001-20090810-168-998-1-2457,1,2009-08-10,322,未払金,有線,300,0,10084597
6420,0001-20090810-168-998-1-2457,4,2009-08-10,322,未払金,警備料,2142,0,10086739
6423,0001-20090810-32-978-1-2417,1,2009-08-10,322,未払金,事務用品費,186,0,10086925
6427,0001-20090810-33-979-1-2419,1,2009-08-10,131,普通預金,家賃支払い,15238,0,10102163
6432,0001-20090810-33-979-1-2419,4,2009-08-10,131,普通預金,電話代,6126,0,10108289
6448,0001-20090810-66-981-1-2423,1,2009-08-10,322,未払金,有線,250,0,10108539
6451,0001-20090810-66-981-1-2423,4,2009-08-10,322,未払金,警備料,1714,0,10110253
6453,0001-20090810-66-981-1-2423,6,2009-08-10,131,普通預金,家賃支払,40000,0,10150253
6459,0001-20090810-77-982-1-2425,1,2009-08-10,111,現金,旅費,714,0,10150967
6463,0001-20090810-79-983-1-2427,1,2009-08-10,111,現金,景品代,1422,0,10152389
6471,0001-20090810-87-984-1-2429,3,2009-08-10,152,売掛金,09年8月10日伝票No279株式会社　ミナミ,35,0,10152424
6485,0001-20090810-90-987-1-2435,3,2009-08-10,152,売掛金,09年8月10日伝票No498株式会社　藤田東京本社,40,0,10152464
6497,0001-20090810-95-990-1-2441,1,2009-08-10,131,普通預金,家賃支払,60000,0,10212464
6503,0001-20090811-144-1003-1-2467,1,2009-08-11,111,現金,ガソリン代,164,0,10212628
6506,0001-20090811-144-1003-1-2467,4,2009-08-11,111,現金,ガソリン代,309,0,10212937
6508,0001-20090811-144-1003-1-2467,6,2009-08-11,111,現金,洗車代,95,0,10213032
6511,0001-20090811-165-1004-1-2469,1,2009-08-11,111,現金,ティッシュ他,37,0,10213069
6520,0001-20090811-7-999-1-2459,1,2009-08-11,111,現金,昼食代　ホテルグランディ3名,387,0,10213456
6524,0001-20090811-78-1001-1-2463,1,2009-08-11,111,現金,ＪＲ代,390,0,10213846
6528,0001-20090811-85-1002-1-2465,1,2009-08-11,131,普通預金,電話代,4212,0,10218058
6534,0001-20090812-153-1005-1-2471,1,2009-08-12,111,現金,食事代　ホテルクリーク2名,163,0,10218221
6538,0001-20090813-11-1006-1-2473,1,2009-08-13,111,現金,ガソリン代,152,0,10218373
6542,0001-20090813-158-1007-1-2475,1,2009-08-13,111,現金,出張旅費,423,0,10218796
6546,0001-20090814-61-1008-1-2477,1,2009-08-14,131,普通預金,電話代,6980,0,10225776
6557,0001-20090815-4-1009-1-2479,1,2009-08-15,322,未払金,広告費,1500,0,10227276
6561,0001-20090815-59-1010-1-2481,1,2009-08-15,111,現金,旅費,1238,0,10228514
6578,0001-20090815-93-1012-1-2485,3,2009-08-15,152,売掛金,09年8月15日伝票No281五越株式会社,40,0,10228554
6586,0001-20090815-94-1013-1-2487,3,2009-08-15,152,売掛金,09年8月15日伝票No282株式会社　エントリー,40,0,10228594
6594,0001-20090815-95-1014-1-2489,3,2009-08-15,152,売掛金,09年8月15日伝票No283タワー株式会社,40,0,10228634
6602,0001-20090815-96-1015-1-2491,3,2009-08-15,152,売掛金,09年8月15日伝票No284高橋物産株式会社,40,0,10228674
6615,0001-20090815-98-1017-1-2495,3,2009-08-15,152,売掛金,09年8月15日伝票No286株式会社　久城商事,15,0,10228689
6624,0001-20090816-12-1020-1-2501,1,2009-08-16,111,現金,ガソリン代,222,0,10228911
6627,0001-20090816-12-1020-1-2501,4,2009-08-16,111,現金,高速代,115,0,10229026
6629,0001-20090816-12-1020-1-2501,6,2009-08-16,111,現金,ウォッシャー液,15,0,10229041
6632,0001-20090816-136-1023-1-2507,1,2009-08-16,111,現金,ダスキン代,785,0,10229826
6636,0001-20090816-51-1021-1-2503,1,2009-08-16,111,現金,高速代,168,0,10229994
6639,0001-20090816-51-1021-1-2503,4,2009-08-16,111,現金,ガソリン代,220,0,10230214
6641,0001-20090816-51-1021-1-2503,6,2009-08-16,111,現金,駐車代,88,0,10230302
6644,0001-20090816-74-1022-1-2505,1,2009-08-16,111,現金,飲食代　カフェバーライン,445,0,10230747
6654,0001-20090817-159-1027-1-2515,1,2009-08-17,111,現金,タクシー代,524,0,10231271
6658,0001-20090817-52-1024-1-2509,1,2009-08-17,111,現金,ガソリン代,180,0,10231451
6662,0001-20090818-103-1029-1-2519,1,2009-08-18,111,現金,手土産代　今井百貨店,150,0,10231601
6666,0001-20090818-23-1028-1-2517,1,2009-08-18,111,現金,旅費,1311,0,10232912
6669,0001-20090818-23-1028-1-2517,4,2009-08-18,111,現金,旅費,1685,0,10234597
6671,0001-20090818-23-1028-1-2517,6,2009-08-18,111,現金,旅費,1981,0,10236578
6674,0001-20090819-164-1033-1-2527,1,2009-08-19,111,現金,事務用品,102,0,10236680
6678,0001-20090819-47-1030-1-2521,1,2009-08-19,111,現金,駐車代,40,0,10236720
6682,0001-20090819-68-1031-1-2523,1,2009-08-19,111,現金,お茶代,117,0,10236837
6686,0001-20090819-84-1032-1-2525,1,2009-08-19,111,現金,切手代,380,0,10237217
6693,0001-20090820-101-1048-1-2557,1,2009-08-20,322,未払金,広告料,2500,0,10239717
6700,0001-20090820-101-1048-1-2557,6,2009-08-20,152,売掛金,09年8月20日伝票No288合同会社　たかだ,30,0,10239747
6708,0001-20090820-102-1049-1-2559,3,2009-08-20,152,売掛金,09年8月20日伝票No289株式会社　ＹＡＧ,35,0,10239782
6717,0001-20090820-104-1051-1-2563,1,2009-08-20,111,現金,コーヒー代2名,60,0,10239842
6730,0001-20090820-118-1053-1-2567,1,2009-08-20,322,未払金,コピー代,334,0,10240176
6734,0001-20090820-119-1054-1-2569,1,2009-08-20,322,未払金,事務用品,127,0,10240303
6738,0001-20090820-132-1055-1-2571,1,2009-08-20,131,普通預金,電気代,4840,0,10245143
6743,0001-20090820-132-1055-1-2571,4,2009-08-20,131,普通預金,水道代,288,0,10245431
6759,0001-20090820-161-1058-1-2577,1,2009-08-20,111,現金,旅費,400,0,10245831
6763,0001-20090820-169-1059-1-2579,1,2009-08-20,131,普通預金,電気料,4736,0,10250567
6768,0001-20090820-169-1059-1-2579,4,2009-08-20,131,普通預金,水道料,221,0,10250788
6771,0001-20090820-31-1034-1-2529,1,2009-08-20,322,未払金,コピー代,114,0,10250902
6775,0001-20090820-34-1035-1-2531,1,2009-08-20,131,普通預金,電気代,4721,0,10255623
6780,0001-20090820-34-1035-1-2531,4,2009-08-20,131,普通預金,水道代,212,0,10255835
6783,0001-20090820-53-1036-1-2533,1,2009-08-20,111,現金,ガソリン代,493,0,10256328
6787,0001-20090820-64-1037-1-2535,1,2009-08-20,131,普通預金,電気料,7800,0,10264128
6792,0001-20090820-64-1037-1-2535,4,2009-08-20,131,普通預金,水道料,338,0,10264466
6795,0001-20090820-67-1038-1-2537,1,2009-08-20,322,未払金,有線,238,0,10264704
6799,0001-20090820-69-1039-1-2539,1,2009-08-20,322,未払金,カウンター料金,300,0,10265004
6803,0001-20090820-71-1040-1-2541,1,2009-08-20,322,未払金,事務用品,363,0,10265367
6806,0001-20090820-71-1040-1-2541,4,2009-08-20,322,未払金,カウンター料金,1624,0,10266991
6809,0001-20090820-74-1041-1-2543,1,2009-08-20,322,未払金,ファイル等,630,0,10267621
6812,0001-20090820-74-1041-1-2543,4,2009-08-20,322,未払金,飲料水,13157,0,10280778
6814,0001-20090820-74-1041-1-2543,6,2009-08-20,322,未払金,名刺代,266,0,10281044
6817,0001-20090820-79-1042-1-2545,1,2009-08-20,111,現金,旅費,571,0,10281615
6821,0001-20090820-80-1043-1-2547,1,2009-08-20,322,未払金,会費支払い,19875,0,10301490
6825,0001-20090820-89-1044-1-2549,1,2009-08-20,131,普通預金,電気料,3303,0,10304793
6830,0001-20090820-89-1044-1-2549,4,2009-08-20,131,普通預金,水道料,174,0,10304967
6832,0001-20090820-89-1044-1-2549,6,2009-08-20,131,普通預金,ガス代,184,0,10305151
6835,0001-20090820-97-1045-1-2551,1,2009-08-20,322,未払金,コピー代,1626,0,10306777
6839,0001-20090820-98-1046-1-2553,1,2009-08-20,322,未払金,事務用品,287,0,10307064
6846,0001-20090821-155-1066-1-2593,1,2009-08-21,111,現金,ガソリン代,335,0,10307399
6850,0001-20090821-160-1067-1-2595,1,2009-08-21,111,現金,出張旅費,3333,0,10310732
6854,0001-20090821-25-1062-1-2585,1,2009-08-21,111,現金,旅費,2666,0,10313398
6858,0001-20090821-38-1063-1-2587,1,2009-08-21,322,未払金,宿泊費,2293,0,10315691
6865,0001-20090821-5-1060-1-2581,1,2009-08-21,131,普通預金,広告費,2500,0,10318191
6871,0001-20090821-6-1061-1-2583,1,2009-08-21,111,現金,広告料,238,0,10318429
6875,0001-20090822-107-1073-1-2607,1,2009-08-22,111,現金,お見舞い,476,0,10318905
6879,0001-20090822-109-1074-1-2609,1,2009-08-22,322,未払金,ガソリン代,2697,0,10321602
6886,0001-20090822-166-1076-1-2613,1,2009-08-22,111,現金,ダスキン代,90,0,10321692
6890,0001-20090822-24-1068-1-2597,1,2009-08-22,111,現金,JR回数券,3934,0,10325626
6894,0001-20090822-48-1069-1-2599,1,2009-08-22,111,現金,ガソリン代,243,0,10325869
6898,0001-20090822-69-1070-1-2601,1,2009-08-22,111,現金,のし袋,15,0,10325884
6901,0001-20090822-69-1070-1-2601,4,2009-08-22,111,現金,電池,37,0,10325921
6904,0001-20090822-90-1071-1-2603,1,2009-08-22,111,現金,ダスキン代,500,0,10326421
6908,0001-20090822-95-1072-1-2605,1,2009-08-22,322,未払金,清掃料,3413,0,10329834
6912,0001-20090823-140-1079-1-2619,1,2009-08-23,111,現金,旅費,307,0,10330141
6916,0001-20090823-28-1077-1-2615,1,2009-08-23,322,未払金,タクシー代,115,0,10330256
6920,0001-20090823-29-1078-1-2617,1,2009-08-23,131,普通預金,携帯電話代,3447,0,10333703
6926,0001-20090824-105-1083-1-2627,1,2009-08-24,111,現金,飲食代　居酒屋梅田小路,606,0,10334309
6929,0001-20090824-105-1083-1-2627,4,2009-08-24,111,現金,飲食代　スナック北新地,936,0,10335245
6932,0001-20090824-120-1084-1-2629,1,2009-08-24,322,未払金,業務委託費,15000,0,10350245
6936,0001-20090824-62-1081-1-2623,1,2009-08-24,322,未払金,お茶代,690,0,10350935
6940,0001-20090824-8-1080-1-2621,1,2009-08-24,111,現金,定例ミーティング会費,952,0,10351887
6943,0001-20090824-8-1080-1-2621,4,2009-08-24,111,現金,飲食代　スナック今日子6名,1552,0,10353439
7068,0001-20090825-107-1093-1-2647,3,2009-08-25,152,売掛金,09年8月25日伝票No291株式会社　総合経営,35,0,10353474
7076,0001-20090825-108-1094-1-2649,3,2009-08-25,152,売掛金,09年8月25日伝票No292株式会社　鎌田商店,30,0,10353504
7084,0001-20090825-109-1095-1-2651,3,2009-08-25,152,売掛金,09年8月25日伝票No293株式会社　小林マーケット,40,0,10353544
7088,0001-20090825-111-1096-1-2653,1,2009-08-25,322,未払金,タクシー代,776,0,10354320
7092,0001-20090825-114-1097-1-2655,1,2009-08-25,111,現金,新聞代,126,0,10354446
7095,0001-20090825-114-1097-1-2655,4,2009-08-25,111,現金,新聞代,143,0,10354589
7098,0001-20090825-15-1085-1-2631,1,2009-08-25,111,現金,洗車代,142,0,10354731
7102,0001-20090825-171-1098-1-2657,1,2009-08-25,131,普通預金,携帯代,3301,0,10358032
7108,0001-20090825-26-1086-1-2633,1,2009-08-25,111,現金,旅費,760,0,10358792
7112,0001-20090825-37-1087-1-2635,1,2009-08-25,322,未払金,業務委託費,55142,0,10413934
7116,0001-20090825-62-1088-1-2637,1,2009-08-25,131,普通預金,携帯代,4593,0,10418527
7122,0001-20090825-72-1089-1-2639,1,2009-08-25,111,現金,新聞代,143,0,10418670
7125,0001-20090825-72-1089-1-2639,4,2009-08-25,111,現金,新聞代,140,0,10418810
7127,0001-20090825-72-1089-1-2639,6,2009-08-25,111,現金,新聞代,169,0,10418979
7130,0001-20090825-80-1090-1-2641,1,2009-08-25,111,現金,タクシー代,466,0,10419445
7134,0001-20090825-87-1091-1-2643,1,2009-08-25,131,普通預金,携帯代,2458,0,10421903
7140,0001-20090826-113-1101-1-2663,1,2009-08-26,131,普通預金,携帯代,3926,0,10425829
7151,0001-20090826-138-1103-1-2667,1,2009-08-26,111,現金,高速代,269,0,10426098
7154,0001-20090826-138-1103-1-2667,4,2009-08-26,111,現金,高速代,192,0,10426290
7156,0001-20090826-138-1103-1-2667,6,2009-08-26,111,現金,ガソリン代,319,0,10426609
7158,0001-20090826-138-1103-1-2667,8,2009-08-26,111,現金,駐車代,170,0,10426779
7161,0001-20090826-146-1104-1-2669,1,2009-08-26,322,未払金,業務委託費,7000,0,10433779
7165,0001-20090826-172-1105-1-2671,1,2009-08-26,322,未払金,業務委託費支払い,4952,0,10438731
7169,0001-20090826-27-1099-1-2659,1,2009-08-26,111,現金,旅費,1332,0,10440063
7172,0001-20090826-27-1099-1-2659,4,2009-08-26,111,現金,旅費,1703,0,10441766
7174,0001-20090826-27-1099-1-2659,6,2009-08-26,111,現金,旅費,1279,0,10443045
7177,0001-20090826-60-1100-1-2661,1,2009-08-26,111,現金,旅費,414,0,10443459
7181,0001-20090827-13-1106-1-2673,1,2009-08-27,111,現金,ガソリン代,364,0,10443823
7185,0001-20090827-14-1107-1-2675,1,2009-08-27,111,現金,ガソリン代,142,0,10443965
7189,0001-20090827-170-1113-1-2687,1,2009-08-27,111,現金,新聞代,143,0,10444108
7198,0001-20090827-35-1109-1-2679,1,2009-08-27,111,現金,新聞代,186,0,10444294
7202,0001-20090827-39-1110-1-2681,1,2009-08-27,111,現金,会費,428,0,10444722
7206,0001-20090827-78-1111-1-2683,1,2009-08-27,322,未払金,業務委託費支払い,9000,0,10453722
7210,0001-20090827-88-1112-1-2685,1,2009-08-27,111,現金,新聞代,169,0,10453891
7230,0001-20090828-3-1114-1-2689,1,2009-08-28,322,未払金,宿泊代,1484,0,10455375
7234,0001-20090828-54-1115-1-2691,1,2009-08-28,111,現金,高速代,85,0,10455460
7237,0001-20090828-54-1115-1-2691,4,2009-08-28,111,現金,駐車代,42,0,10455502
7240,0001-20090828-75-1116-1-2693,1,2009-08-28,111,現金,飲食代　居酒屋チキンズ10名,1920,0,10457422
7244,0001-20090828-93-1117-1-2695,1,2009-08-28,322,未払金,修繕費,850,0,10458272
7251,0001-20090829-70-1120-1-2701,1,2009-08-29,111,現金,ゴルフプレー代4名,2038,0,10460310
7255,0001-20090830-100-1127-1-2715,1,2009-08-30,111,現金,会費,285,0,10460595
7264,0001-20090830-121-1129-1-2719,1,2009-08-30,111,現金,お茶代,571,0,10461166
7268,0001-20090830-137-1130-1-2721,1,2009-08-30,322,未払金,有線,300,0,10461466
7271,0001-20090830-137-1130-1-2721,4,2009-08-30,322,未払金,警備料,2142,0,10463608
7273,0001-20090830-137-1130-1-2721,6,2009-08-30,131,普通預金,高速料,2146,0,10465754
7278,0001-20090830-137-1130-1-2721,9,2009-08-30,322,未払金,清掃料,3500,0,10469254
7282,0001-20090830-49-1121-1-2703,1,2009-08-30,111,現金,ガソリン代,8113,0,10477367
7285,0001-20090830-49-1121-1-2703,4,2009-08-30,111,現金,車両管理費,1168,0,10478535
7289,0001-20090830-70-1122-1-2705,1,2009-08-30,322,未払金,有線,300,0,10478835
7292,0001-20090830-70-1122-1-2705,4,2009-08-30,322,未払金,警備料,2619,0,10481454
7294,0001-20090830-70-1122-1-2705,6,2009-08-30,111,現金,高速代,2690,0,10484144
7297,0001-20090830-70-1122-1-2705,9,2009-08-30,322,未払金,清掃料,3500,0,10487644
7301,0001-20090830-76-1123-1-2707,1,2009-08-30,111,現金,ガソリン代,281,0,10487925
7304,0001-20090830-76-1123-1-2707,4,2009-08-30,111,現金,タイヤ代　175/60-14　4本,2114,0,10490039
7306,0001-20090830-76-1123-1-2707,6,2009-08-30,111,現金,タイヤ交換代,60,0,10490099
7309,0001-20090830-81-1124-1-2709,1,2009-08-30,322,未払金,お茶代,942,0,10491041
7313,0001-20090830-96-1125-1-2711,1,2009-08-30,131,普通預金,警備料,1070,0,10492111
7319,0001-20090830-99-1126-1-2713,1,2009-08-30,322,未払金,運賃,32595,0,10524706
7323,0001-20090831-1-1131-1-2723,1,2009-08-31,322,未払金,運賃　佐川急便,4206,0,10528912
7327,0001-20090831-108-1142-1-2745,1,2009-08-31,111,現金,コーヒー代2名,64,0,10528976
7430,0001-20090831-115-1148-1-2757,3,2009-08-31,152,売掛金,09年8月31日伝票No294マークマーケット,40,0,10529016
7438,0001-20090831-116-1149-1-2759,3,2009-08-31,152,売掛金,09年8月31日伝票No295株式会社　ＡＢＣ,40,0,10529056
7441,0001-20090831-116-1149-1-2759,6,2009-08-31,131,普通預金,リース料,4000,0,10533056
7454,0001-20090831-118-1151-1-2763,3,2009-08-31,152,売掛金,09年8月31日伝票No297株式会社　畠山商事,30,0,10533086
7462,0001-20090831-119-1152-1-2765,3,2009-08-31,152,売掛金,09年8月31日伝票No298株式会社　千代サービス,15,0,10533101
7469,0001-20090831-121-1154-1-2769,1,2009-08-31,312,買掛金,09年8月1日～09年8月31日分仕入,4307,0,10537408
7472,0001-20090831-121-1154-1-2769,4,2009-08-31,312,買掛金,09年8月1日～09年8月31日分仕入,3528,0,10540936
7476,0001-20090831-122-1155-1-2771,1,2009-08-31,312,買掛金,09年8月1日～09年8月31日分仕入,140624,0,10681560
7479,0001-20090831-122-1155-1-2771,4,2009-08-31,312,買掛金,09年8月1日～09年8月31日分仕入,154785,0,10836345
7482,0001-20090831-122-1155-1-2771,7,2009-08-31,312,買掛金,09年8月1日～09年8月31日分仕入,62724,0,10899069
7485,0001-20090831-122-1155-1-2771,10,2009-08-31,312,買掛金,09年8月1日～09年8月31日分仕入,292311,0,11191380
7488,0001-20090831-122-1155-1-2771,13,2009-08-31,312,買掛金,09年8月1日～09年8月31日分仕入,209459,0,11400839
7491,0001-20090831-122-1155-1-2771,16,2009-08-31,312,買掛金,09年8月1日～09年8月31日分仕入,16027,0,11416866
7494,0001-20090831-122-1155-1-2771,19,2009-08-31,312,買掛金,09年8月1日～09年8月31日分仕入,7056,0,11423922
7497,0001-20090831-122-1155-1-2771,22,2009-08-31,312,買掛金,09年8月1日～09年8月31日分仕入,38980,0,11462902
7501,0001-20090831-123-1156-1-2773,1,2009-08-31,312,買掛金,09年8月1日～09年8月31日分仕入,86616,0,11549518
7504,0001-20090831-123-1156-1-2773,4,2009-08-31,312,買掛金,09年8月1日～09年8月31日分仕入,56088,0,11605606
7507,0001-20090831-123-1156-1-2773,7,2009-08-31,312,買掛金,09年8月1日～09年8月31日分仕入,173284,0,11778890
7510,0001-20090831-123-1156-1-2773,10,2009-08-31,312,買掛金,09年8月1日～09年8月31日分仕入,2116,0,11781006
7513,0001-20090831-123-1156-1-2773,13,2009-08-31,312,買掛金,09年8月1日～09年8月31日分仕入,12925,0,11793931
7517,0001-20090831-124-1157-1-2775,1,2009-08-31,312,買掛金,09年8月1日～09年8月31日分仕入,182886,0,11976817
7520,0001-20090831-124-1157-1-2775,4,2009-08-31,312,買掛金,09年8月1日～09年8月31日分仕入,44937,0,12021754
7523,0001-20090831-124-1157-1-2775,7,2009-08-31,312,買掛金,09年8月1日～09年8月31日分仕入,149923,0,12171677
7526,0001-20090831-124-1157-1-2775,10,2009-08-31,312,買掛金,09年8月1日～09年8月31日分仕入,171459,0,12343136
7529,0001-20090831-124-1157-1-2775,13,2009-08-31,312,買掛金,09年8月1日～09年8月31日分仕入,5880,0,12349016
7532,0001-20090831-124-1157-1-2775,16,2009-08-31,312,買掛金,09年8月1日～09年8月31日分仕入,3693,0,12352709
7536,0001-20090831-125-1158-1-2777,1,2009-08-31,312,買掛金,09年8月1日～09年8月31日分仕入,2872,0,12355581
7610,0001-20090831-145-1173-1-2807,1,2009-08-31,322,未払金,運賃,5972,0,12361553
7614,0001-20090831-36-1132-1-2725,1,2009-08-31,322,未払金,運賃　ヤマト運輸,80930,0,12442483
7617,0001-20090831-36-1132-1-2725,4,2009-08-31,322,未払金,運賃　佐川急便,45835,0,12488318
7620,0001-20090831-40-1133-1-2727,1,2009-08-31,322,未払金,広告掲載,2380,0,12490698
7642,0001-20090831-66-1135-1-2731,1,2009-08-31,131,普通預金,リース料,9992,0,12500690
7665,0001-20090831-77-1139-1-2739,1,2009-08-31,322,未払金,運賃,6936,0,12507626
7669,0001-20090831-83-1140-1-2741,1,2009-08-31,111,現金,車両管理費,2023,0,12509649
7677,0001-20090831-94-1141-1-2743,1,2009-08-31,111,現金,お茶代他,245,0,12509894
,,,2009-08,,※※月計※※,,2532405,0,
7681,0001-20090901-56-1174-1-2809,1,2009-09-01,111,現金,旅費,1475,0,12511369
7685,0001-20090901-84-1175-1-2811,1,2009-09-01,111,現金,ＪＲ代,247,0,12511616
7689,0001-20090902-150-1181-1-2823,1,2009-09-02,111,現金,食事代　長崎港屋2名,207,0,12511823
7693,0001-20090902-151-1182-1-2825,1,2009-09-02,111,現金,食事代　トルテーヤ2名,365,0,12512188
7696,0001-20090902-151-1182-1-2825,4,2009-09-02,111,現金,食事代　和風ダイニング法善寺3名,681,0,12512869
7699,0001-20090902-159-1183-1-2827,1,2009-09-02,111,現金,タクシー代,221,0,12513090
7703,0001-20090902-164-1184-1-2829,1,2009-09-02,111,現金,事務用品,147,0,12513237
7707,0001-20090902-19-1176-1-2813,1,2009-09-02,111,現金,旅費,803,0,12514040
7711,0001-20090902-57-1177-1-2815,1,2009-09-02,111,現金,JR代,4232,0,12518272
7715,0001-20090902-70-1178-1-2817,1,2009-09-02,111,現金,お茶代,53,0,12518325
7719,0001-20090902-76-1179-1-2819,1,2009-09-02,322,未払金,制服代,2666,0,12520991
7723,0001-20090902-94-1180-1-2821,1,2009-09-02,111,現金,洗剤他,37,0,12521028
7727,0001-20090903-134-1188-1-2837,1,2009-09-03,111,現金,用紙,652,0,12521680
7731,0001-20090903-18-1185-1-2831,1,2009-09-03,111,現金,旅費,799,0,12522479
7735,0001-20090903-50-1186-1-2833,1,2009-09-03,111,現金,駐車代,28,0,12522507
7739,0001-20090903-69-1187-1-2835,1,2009-09-03,111,現金,ティッシュ代,57,0,12522564
7743,0001-20090904-147-1190-1-2841,1,2009-09-04,322,未払金,ガソリン代,3258,0,12525822
7747,0001-20090904-16-1189-1-2839,1,2009-09-04,111,現金,駐車代,26,0,12525848
7750,0001-20090904-16-1189-1-2839,4,2009-09-04,111,現金,ガソリン代,297,0,12526145
7753,0001-20090905-142-1194-1-2849,1,2009-09-05,111,現金,ガソリン代,364,0,12526509
7756,0001-20090905-142-1194-1-2849,4,2009-09-05,111,現金,洗車代,95,0,12526604
7758,0001-20090905-142-1194-1-2849,6,2009-09-05,111,現金,駐車代,152,0,12526756
7765,0001-20090905-91-1191-1-2843,3,2009-09-05,152,売掛金,09年9月5日伝票No299株式会社　渡辺産業,22,0,12526778
7773,0001-20090905-92-1192-1-2845,3,2009-09-05,152,売掛金,09年9月5日伝票No300佐々木販売株式会社,22,0,12526800
7782,0001-20090906-10-1195-1-2851,1,2009-09-06,111,現金,ガソリン代,201,0,12527001
7786,0001-20090906-110-1198-1-2857,1,2009-09-06,111,現金,タクシー代,109,0,12527110
7790,0001-20090906-133-1199-1-2859,1,2009-09-06,131,普通預金,税理士報酬,6652,0,12533762
7796,0001-20090906-42-1196-1-2853,1,2009-09-06,111,現金,コーヒー代2名,60,0,12533822
7800,0001-20090906-43-1197-1-2855,1,2009-09-06,111,現金,食事代　トン吉2名,196,0,12534018
7804,0001-20090907-21-1200-1-2861,1,2009-09-07,111,現金,JR代,3309,0,12537327
7808,0001-20090907-22-1201-1-2863,1,2009-09-07,111,現金,旅費,2380,0,12539707
7812,0001-20090908-9-1202-1-2865,1,2009-09-08,111,現金,コーヒー代2名,66,0,12539773
7816,0001-20090909-148-1204-1-2869,1,2009-09-09,111,現金,ガソリン代,343,0,12540116
7819,0001-20090909-148-1204-1-2869,4,2009-09-09,111,現金,高速代,114,0,12540230
7822,0001-20090909-20-1203-1-2867,1,2009-09-09,111,現金,旅費,1855,0,12542085
7834,0001-20090910-143-1219-1-2899,1,2009-09-10,111,現金,点検作業料,1047,0,12543132
7838,0001-20090910-162-1220-1-2901,1,2009-09-10,111,現金,会議　食事代,1190,0,12544322
7842,0001-20090910-168-1221-1-2903,1,2009-09-10,322,未払金,有線,300,0,12544622
7845,0001-20090910-168-1221-1-2903,4,2009-09-10,322,未払金,警備料,2142,0,12546764
7848,0001-20090910-44-1205-1-2871,1,2009-09-10,111,現金,手土産代　五越百貨店,120,0,12546884
7862,0001-20090910-66-1207-1-2875,1,2009-09-10,322,未払金,有線,250,0,12547134
7865,0001-20090910-66-1207-1-2875,4,2009-09-10,322,未払金,警備料,1714,0,12548848
7868,0001-20090910-73-1208-1-2877,1,2009-09-10,111,現金,ゴルフプレー代,885,0,12549733
7872,0001-20090910-81-1209-1-2879,1,2009-09-10,111,現金,ガソリン代,246,0,12549979
7875,0001-20090910-81-1209-1-2879,4,2009-09-10,111,現金,駐車代,28,0,12550007
7878,0001-20090910-85-1210-1-2881,1,2009-09-10,131,普通預金,電話代,3292,0,12553299
7883,0001-20090910-85-1210-1-2881,4,2009-09-10,111,現金,ＪＲ代,285,0,12553584
7891,0001-20090910-94-1211-1-2883,3,2009-09-10,152,売掛金,09年9月10日伝票No302株式会社　ミナミ,35,0,12553619
7905,0001-20090910-97-1214-1-2889,3,2009-09-10,152,売掛金,09年9月10日伝票No499株式会社　藤田東京本社,40,0,12553659
7917,0001-20090911-112-1228-1-2917,1,2009-09-11,131,普通預金,電話代,7981,0,12561640
7923,0001-20090911-129-1229-1-2919,1,2009-09-11,131,普通預金,家賃支払い,19000,0,12580640
7929,0001-20090911-156-1230-1-2921,1,2009-09-11,111,現金,出張旅費,333,0,12580973
7933,0001-20090911-161-1231-1-2923,1,2009-09-11,111,現金,旅費,204,0,12581177
7937,0001-20090911-167-1232-1-2925,1,2009-09-11,131,普通預金,家賃支払い,30000,0,12611177
7942,0001-20090911-167-1232-1-2925,4,2009-09-11,131,普通預金,電話代,5273,0,12616450
7948,0001-20090911-23-1222-1-2905,1,2009-09-11,111,現金,旅費,1422,0,12617872
7951,0001-20090911-23-1222-1-2905,4,2009-09-11,111,現金,旅費,1659,0,12619531
7953,0001-20090911-23-1222-1-2905,6,2009-09-11,111,現金,旅費,1990,0,12621521
7956,0001-20090911-33-1223-1-2907,1,2009-09-11,131,普通預金,家賃支払い,15238,0,12636759
7961,0001-20090911-33-1223-1-2907,4,2009-09-11,131,普通預金,電話代,8059,0,12644818
7967,0001-20090911-45-1224-1-2909,1,2009-09-11,111,現金,飲食代　居酒屋富士4名,826,0,12645644
7971,0001-20090911-58-1225-1-2911,1,2009-09-11,111,現金,旅費,4295,0,12649939
7975,0001-20090911-63-1226-1-2913,1,2009-09-11,131,普通預金,家賃支払,60000,0,12709939
7981,0001-20090911-64-1227-1-2915,1,2009-09-11,131,普通預金,家賃支払,40000,0,12749939
7987,0001-20090912-104-1236-1-2933,1,2009-09-12,111,現金,コーヒー代3名,90,0,12750029
7991,0001-20090912-11-1233-1-2927,1,2009-09-12,111,現金,ガソリン代,152,0,12750181
7995,0001-20090912-149-1237-1-2935,1,2009-09-12,111,現金,コーヒー代3名,90,0,12750271
8004,0001-20090912-73-1235-1-2931,1,2009-09-12,111,現金,コーヒー代3名,75,0,12750346
8008,0001-20090913-152-1240-1-2941,1,2009-09-13,111,現金,コーヒー代3名,90,0,12750436
8012,0001-20090913-157-1241-1-2943,1,2009-09-13,131,普通預金,航空券代,1280,0,12751716
8018,0001-20090913-165-1242-1-2945,1,2009-09-13,111,現金,台所用品他,62,0,12751778
8022,0001-20090913-17-1238-1-2937,1,2009-09-13,111,現金,駐車代,17,0,12751795
8026,0001-20090913-75-1239-1-2939,1,2009-09-13,111,現金,ゴルフプレー代,350,0,12752145
8030,0001-20090914-105-1245-1-2951,1,2009-09-14,111,現金,飲食代　和食ダイニング小笹3名,892,0,12753037
8034,0001-20090914-51-1243-1-2947,1,2009-09-14,111,現金,高速代,156,0,12753193
8037,0001-20090914-51-1243-1-2947,4,2009-09-14,111,現金,駐車代,130,0,12753323
8040,0001-20090914-61-1244-1-2949,1,2009-09-14,131,普通預金,電話代,6174,0,12759497
8050,0001-20090915-100-1248-1-2957,3,2009-09-15,152,売掛金,09年9月15日伝票No304五越株式会社,40,0,12759537
8058,0001-20090915-101-1249-1-2959,3,2009-09-15,152,売掛金,09年9月15日伝票No305株式会社　エントリー,40,0,12759577
8066,0001-20090915-102-1250-1-2961,3,2009-09-15,152,売掛金,09年9月15日伝票No306タワー株式会社,40,0,12759617
8074,0001-20090915-103-1251-1-2963,3,2009-09-15,152,売掛金,09年9月15日伝票No307高橋物産株式会社,40,0,12759657
8087,0001-20090915-105-1253-1-2967,3,2009-09-15,152,売掛金,09年9月15日伝票No309株式会社　久城商事,15,0,12759672
8099,0001-20090915-82-1246-1-2953,1,2009-09-15,322,未払金,ガソリン代,1227,0,12760899
8117,0001-20090916-136-1259-1-2979,1,2009-09-16,111,現金,ダスキン代,785,0,12761684
8121,0001-20090916-74-1256-1-2973,1,2009-09-16,111,現金,ゴルフプレー代,523,0,12762207
8125,0001-20090916-86-1257-1-2975,1,2009-09-16,111,現金,タクシー代,361,0,12762568
8129,0001-20090917-12-1261-1-2983,1,2009-09-17,111,現金,ガソリン代,355,0,12762923
8132,0001-20090917-12-1261-1-2983,4,2009-09-17,111,現金,ガソリン代,200,0,12763123
8135,0001-20090917-4-1260-1-2981,1,2009-09-17,322,未払金,広告費,1500,0,12764623
8139,0001-20090917-52-1262-1-2985,1,2009-09-17,111,現金,高速代,54,0,12764677
8142,0001-20090917-52-1262-1-2985,4,2009-09-17,111,現金,駐車代,38,0,12764715
8144,0001-20090917-52-1262-1-2985,6,2009-09-17,111,現金,ガソリン代,273,0,12764988
8147,0001-20090918-24-1263-1-2987,1,2009-09-18,111,現金,JR回数券,3934,0,12768922
8151,0001-20090918-74-1264-1-2989,1,2009-09-18,111,現金,手土産代　今井百貨店,300,0,12769222
8155,0001-20090918-79-1265-1-2991,1,2009-09-18,111,現金,景品代,1898,0,12771120
8159,0001-20090919-47-1266-1-2993,1,2009-09-19,111,現金,ガソリン代,172,0,12771292
8163,0001-20090919-82-1267-1-2995,1,2009-09-19,111,現金,ガソリン代,230,0,12771522
8166,0001-20090919-82-1267-1-2995,4,2009-09-19,111,現金,駐車代,19,0,12771541
8169,0001-20090920-101-1278-1-3017,1,2009-09-20,322,未払金,広告料,2500,0,12774041
8191,0001-20090920-108-1281-1-3023,3,2009-09-20,152,売掛金,09年9月20日伝票No311合同会社　たかだ,30,0,12774071
8199,0001-20090920-109-1282-1-3025,3,2009-09-20,152,売掛金,09年9月20日伝票No312株式会社　ＹＡＧ,35,0,12774106
8218,0001-20090920-118-1286-1-3033,1,2009-09-20,322,未払金,コピー代,342,0,12774448
8222,0001-20090920-135-1287-1-3035,1,2009-09-20,322,未払金,事務用品,272,0,12774720
8226,0001-20090920-138-1288-1-3037,1,2009-09-20,111,現金,高速代,170,0,12774890
8229,0001-20090920-138-1288-1-3037,4,2009-09-20,111,現金,高速代,126,0,12775016
8231,0001-20090920-138-1288-1-3037,6,2009-09-20,111,現金,高速代,183,0,12775199
8233,0001-20090920-138-1288-1-3037,8,2009-09-20,111,現金,洗車代,95,0,12775294
8235,0001-20090920-138-1288-1-3037,10,2009-09-20,111,現金,ガソリン代,427,0,12775721
8237,0001-20090920-138-1288-1-3037,12,2009-09-20,111,現金,ウォッシャー液代,28,0,12775749
8239,0001-20090920-138-1288-1-3037,14,2009-09-20,111,現金,高速代,214,0,12775963
8242,0001-20090920-141-1289-1-3039,1,2009-09-20,111,現金,JR代,404,0,12776367
8249,0001-20090920-31-1269-1-2999,1,2009-09-20,322,未払金,コピー代,133,0,12776500
8253,0001-20090920-48-1270-1-3001,1,2009-09-20,111,現金,ガソリン代,204,0,12776704
8257,0001-20090920-53-1271-1-3003,1,2009-09-20,111,現金,ガソリン代,119,0,12776823
8260,0001-20090920-53-1271-1-3003,4,2009-09-20,111,現金,高速代,59,0,12776882
8263,0001-20090920-6-1268-1-2997,1,2009-09-20,111,現金,広告料,238,0,12777120
8267,0001-20090920-69-1272-1-3005,1,2009-09-20,322,未払金,有線,238,0,12777358
8271,0001-20090920-71-1273-1-3007,1,2009-09-20,322,未払金,事務用品,299,0,12777657
8274,0001-20090920-71-1273-1-3007,4,2009-09-20,322,未払金,カウンター料金,1460,0,12779117
8277,0001-20090920-72-1274-1-3009,1,2009-09-20,322,未払金,カウンター料金,300,0,12779417
8281,0001-20090920-78-1275-1-3011,1,2009-09-20,322,未払金,ファイル等,1751,0,12781168
8284,0001-20090920-78-1275-1-3011,4,2009-09-20,322,未払金,飲料水,13296,0,12794464
8287,0001-20090920-97-1276-1-3013,1,2009-09-20,322,未払金,コピー代,1735,0,12796199
8291,0001-20090920-98-1277-1-3015,1,2009-09-20,322,未払金,事務用品,243,0,12796442
8295,0001-20090921-132-1294-1-3049,1,2009-09-21,131,普通預金,電気代,5384,0,12801826
8300,0001-20090921-132-1294-1-3049,4,2009-09-21,131,普通預金,水道代,315,0,12802141
8303,0001-20090921-154-1295-1-3051,1,2009-09-21,322,未払金,飲食代　居酒屋花道4名,1180,0,12803321
8306,0001-20090921-154-1295-1-3051,4,2009-09-21,322,未払金,飲食代　スナックみわ,1685,0,12805006
8309,0001-20090921-160-1296-1-3053,1,2009-09-21,111,現金,出張旅費,3333,0,12808339
8313,0001-20090921-169-1297-1-3055,1,2009-09-21,131,普通預金,電気料,5116,0,12813455
8318,0001-20090921-169-1297-1-3055,4,2009-09-21,131,普通預金,水道料,277,0,12813732
8321,0001-20090921-34-1291-1-3043,1,2009-09-21,131,普通預金,電気代,3731,0,12817463
8326,0001-20090921-34-1291-1-3043,4,2009-09-21,131,普通預金,水道代,212,0,12817675
8329,0001-20090921-64-1292-1-3045,1,2009-09-21,131,普通預金,電気料,8972,0,12826647
8334,0001-20090921-64-1292-1-3045,4,2009-09-21,131,普通預金,水道料,365,0,12827012
8337,0001-20090921-89-1293-1-3047,1,2009-09-21,131,普通預金,電気料,3937,0,12830949
8342,0001-20090921-89-1293-1-3047,4,2009-09-21,131,普通預金,水道料,171,0,12831120
8344,0001-20090921-89-1293-1-3047,6,2009-09-21,131,普通預金,ガス代,191,0,12831311
8347,0001-20090922-107-1304-1-3069,1,2009-09-22,111,現金,お見舞い,476,0,12831787
8351,0001-20090922-153-1305-1-3071,1,2009-09-22,111,現金,コーヒー代2名,60,0,12831847
8355,0001-20090922-166-1306-1-3073,1,2009-09-22,111,現金,ダスキン代,90,0,12831937
8359,0001-20090922-38-1298-1-3057,1,2009-09-22,322,未払金,宿泊費,2293,0,12834230
8363,0001-20090922-61-1299-1-3059,1,2009-09-22,322,未払金,お茶代,519,0,12834749
8367,0001-20090922-67-1300-1-3061,1,2009-09-22,111,現金,ティッシュペーパー他,75,0,12834824
8371,0001-20090922-75-1301-1-3063,1,2009-09-22,111,現金,飲食代　スナックりりあん2名,498,0,12835322
8375,0001-20090922-90-1302-1-3065,1,2009-09-22,111,現金,ダスキン代,500,0,12835822
8379,0001-20090922-95-1303-1-3067,1,2009-09-22,322,未払金,清掃料,3413,0,12839235
8383,0001-20090923-140-1311-1-3083,1,2009-09-23,111,現金,旅費,1119,0,12840354
8387,0001-20090923-26-1308-1-3077,1,2009-09-23,111,現金,旅費,523,0,12840877
8391,0001-20090923-28-1309-1-3079,1,2009-09-23,322,未払金,タクシー代,115,0,12840992
8395,0001-20090923-3-1307-1-3075,1,2009-09-23,322,未払金,宿泊代,1373,0,12842365
8399,0001-20090923-54-1310-1-3081,1,2009-09-23,111,現金,高速代,219,0,12842584
8403,0001-20090924-109-1314-1-3089,1,2009-09-24,322,未払金,ガソリン代,2161,0,12844745
8407,0001-20090924-120-1315-1-3091,1,2009-09-24,322,未払金,業務委託費,24000,0,12868745
8411,0001-20090924-144-1316-1-3093,1,2009-09-24,111,現金,ガソリン代,308,0,12869053
8414,0001-20090924-144-1316-1-3093,4,2009-09-24,111,現金,高速代,423,0,12869476
8417,0001-20090924-146-1317-1-3095,1,2009-09-24,322,未払金,業務委託費,7000,0,12876476
8421,0001-20090924-62-1312-1-3085,1,2009-09-24,131,普通預金,携帯代,4790,0,12881266
8427,0001-20090924-71-1313-1-3087,1,2009-09-24,111,現金,ティッシュ代他,45,0,12881311
8431,0001-20090925-111-1322-1-3105,1,2009-09-25,322,未払金,タクシー代,428,0,12881739
8442,0001-20090925-114-1324-1-3109,3,2009-09-25,152,売掛金,09年9月25日伝票No314株式会社　総合経営,35,0,12881774
8450,0001-20090925-115-1325-1-3111,3,2009-09-25,152,売掛金,09年9月25日伝票No315株式会社　鎌田商店,30,0,12881804
8458,0001-20090925-116-1326-1-3113,3,2009-09-25,152,売掛金,09年9月25日伝票No316株式会社　小林マーケット,40,0,12881844
8462,0001-20090925-121-1327-1-3115,1,2009-09-25,111,現金,お茶代,452,0,12882296
8471,0001-20090925-172-1329-1-3119,1,2009-09-25,322,未払金,業務委託費支払い,4142,0,12886438
8475,0001-20090925-29-1318-1-3097,1,2009-09-25,131,普通預金,携帯電話代,4502,0,12890940
8481,0001-20090925-35-1319-1-3099,1,2009-09-25,111,現金,新聞代,186,0,12891126
8485,0001-20090925-78-1320-1-3101,1,2009-09-25,322,未払金,業務委託費支払い,9207,0,12900333
8604,0001-20090926-155-1334-1-3129,1,2009-09-26,111,現金,ガソリン代,345,0,12900678
8608,0001-20090926-170-1335-1-3131,1,2009-09-26,111,現金,新聞代,143,0,12900821
8612,0001-20090926-25-1331-1-3123,1,2009-09-26,111,現金,旅費,2914,0,12903735
8616,0001-20090926-72-1332-1-3125,1,2009-09-26,111,現金,新聞代,143,0,12903878
8619,0001-20090926-72-1332-1-3125,4,2009-09-26,111,現金,新聞代,140,0,12904018
8621,0001-20090926-72-1332-1-3125,6,2009-09-26,111,現金,新聞代,169,0,12904187
8624,0001-20090926-8-1330-1-3121,1,2009-09-26,111,現金,定例ミーティング会費,952,0,12905139
8628,0001-20090926-87-1333-1-3127,1,2009-09-26,131,普通預金,携帯代,2100,0,12907239
8634,0001-20090927-113-1342-1-3145,1,2009-09-27,131,普通預金,携帯代,3556,0,12910795
8640,0001-20090927-114-1343-1-3147,1,2009-09-27,111,現金,新聞代,126,0,12910921
8643,0001-20090927-114-1343-1-3147,4,2009-09-27,111,現金,新聞代,143,0,12911064
8646,0001-20090927-13-1336-1-3133,1,2009-09-27,111,現金,修理代,4450,0,12915514
8650,0001-20090927-14-1337-1-3135,1,2009-09-27,111,現金,ガソリン代,190,0,12915704
8654,0001-20090927-171-1344-1-3149,1,2009-09-27,131,普通預金,携帯代,2627,0,12918331
8665,0001-20090927-37-1339-1-3139,1,2009-09-27,322,未払金,業務委託費,46952,0,12965283
8669,0001-20090927-39-1340-1-3141,1,2009-09-27,111,現金,会費,428,0,12965711
8673,0001-20090927-60-1341-1-3143,1,2009-09-27,111,現金,旅費,1023,0,12966734
8677,0001-20090928-83-1345-1-3151,1,2009-09-28,111,現金,車両管理費,2309,0,12969043
8681,0001-20090928-88-1346-1-3153,1,2009-09-28,111,現金,新聞代,169,0,12969212
8685,0001-20090928-93-1347-1-3155,1,2009-09-28,322,未払金,修繕費,850,0,12970062
8689,0001-20090929-108-1350-1-3161,1,2009-09-29,111,現金,食事代　レストラン梅田,263,0,12970325
8693,0001-20090929-137-1351-1-3163,1,2009-09-29,322,未払金,有線,300,0,12970625
8696,0001-20090929-137-1351-1-3163,4,2009-09-29,322,未払金,警備料,2142,0,12972767
8698,0001-20090929-137-1351-1-3163,6,2009-09-29,131,普通預金,高速料,3229,0,12975996
8703,0001-20090929-137-1351-1-3163,9,2009-09-29,322,未払金,清掃料,3500,0,12979496
8723,0001-20090929-81-1348-1-3157,1,2009-09-29,322,未払金,お茶代,900,0,12980396
8727,0001-20090929-83-1349-1-3159,1,2009-09-29,111,現金,ガソリン代,207,0,12980603
8731,0001-20090930-1-1353-1-3167,1,2009-09-30,322,未払金,運賃　佐川急便,6264,0,12986867
8735,0001-20090930-100-1370-1-3201,1,2009-09-30,111,現金,会費,285,0,12987152
8843,0001-20090930-122-1377-1-3215,3,2009-09-30,152,売掛金,09年9月30日伝票No317マークマーケット,40,0,12987192
8851,0001-20090930-123-1378-1-3217,3,2009-09-30,152,売掛金,09年9月30日伝票No318株式会社　ＡＢＣ,40,0,12987232
8862,0001-20090930-125-1380-1-3221,3,2009-09-30,152,売掛金,09年9月30日伝票No320株式会社　畠山商事,30,0,12987262
8870,0001-20090930-126-1381-1-3223,3,2009-09-30,152,売掛金,09年9月30日伝票No321株式会社　千代サービス,10,0,12987272
8879,0001-20090930-128-1383-1-3227,3,2009-09-30,312,買掛金,09年9月1日～09年9月30日分仕入,11079,0,12998351
8883,0001-20090930-129-1384-1-3229,1,2009-09-30,312,買掛金,09年9月1日～09年9月30日分仕入,136586,0,13134937
8886,0001-20090930-129-1384-1-3229,4,2009-09-30,312,買掛金,09年9月1日～09年9月30日分仕入,150151,0,13285088
8889,0001-20090930-129-1384-1-3229,7,2009-09-30,312,買掛金,09年9月1日～09年9月30日分仕入,62724,0,13347812
8892,0001-20090930-129-1384-1-3229,10,2009-09-30,312,買掛金,09年9月1日～09年9月30日分仕入,282567,0,13630379
8895,0001-20090930-129-1384-1-3229,13,2009-09-30,312,買掛金,09年9月1日～09年9月30日分仕入,204013,0,13834392
8898,0001-20090930-129-1384-1-3229,16,2009-09-30,312,買掛金,09年9月1日～09年9月30日分仕入,15073,0,13849465
8901,0001-20090930-129-1384-1-3229,19,2009-09-30,312,買掛金,09年9月1日～09年9月30日分仕入,15052,0,13864517
8904,0001-20090930-129-1384-1-3229,22,2009-09-30,312,買掛金,09年9月1日～09年9月30日分仕入,18670,0,13883187
8908,0001-20090930-130-1385-1-3231,1,2009-09-30,312,買掛金,09年9月1日～09年9月30日分仕入,86616,0,13969803
8911,0001-20090930-130-1385-1-3231,4,2009-09-30,312,買掛金,09年9月1日～09年9月30日分仕入,56088,0,14025891
8914,0001-20090930-130-1385-1-3231,7,2009-09-30,312,買掛金,09年9月1日～09年9月30日分仕入,164123,0,14190014
8917,0001-20090930-130-1385-1-3231,10,2009-09-30,312,買掛金,09年9月1日～09年9月30日分仕入,5539,0,14195553
8920,0001-20090930-130-1385-1-3231,13,2009-09-30,312,買掛金,09年9月1日～09年9月30日分仕入,3528,0,14199081
8924,0001-20090930-131-1386-1-3233,1,2009-09-30,312,買掛金,09年9月1日～09年9月30日分仕入,177624,0,14376705
8927,0001-20090930-131-1386-1-3233,4,2009-09-30,312,買掛金,09年9月1日～09年9月30日分仕入,44937,0,14421642
8930,0001-20090930-131-1386-1-3233,7,2009-09-30,312,買掛金,09年9月1日～09年9月30日分仕入,145286,0,14566928
8933,0001-20090930-131-1386-1-3233,10,2009-09-30,312,買掛金,09年9月1日～09年9月30日分仕入,165944,0,14732872
8936,0001-20090930-131-1386-1-3233,13,2009-09-30,312,買掛金,09年9月1日～09年9月30日分仕入,19284,0,14752156
8939,0001-20090930-131-1386-1-3233,16,2009-09-30,312,買掛金,09年9月1日～09年9月30日分仕入,1176,0,14753332
8943,0001-20090930-132-1387-1-3235,1,2009-09-30,312,買掛金,09年9月1日～09年9月30日分仕入,4513,0,14757845
9004,0001-20090930-145-1399-1-3259,1,2009-09-30,322,未払金,運賃,6625,0,14764470
9025,0001-20090930-156-1403-1-3267,1,2009-09-30,111,現金,出張旅費,642,0,14765112
9029,0001-20090930-158-1404-1-3269,1,2009-09-30,111,現金,出張旅費,328,0,14765440
9033,0001-20090930-27-1355-1-3171,1,2009-09-30,111,現金,旅費,1418,0,14766858
9036,0001-20090930-27-1355-1-3171,4,2009-09-30,111,現金,旅費,1386,0,14768244
9038,0001-20090930-27-1355-1-3171,6,2009-09-30,111,現金,旅費,1898,0,14770142
9041,0001-20090930-36-1356-1-3173,1,2009-09-30,322,未払金,運賃　ヤマト運輸,82523,0,14852665
9044,0001-20090930-36-1356-1-3173,4,2009-09-30,322,未払金,運賃　佐川急便,40516,0,14893181
9047,0001-20090930-40-1357-1-3175,1,2009-09-30,322,未払金,広告掲載,2380,0,14895561
9051,0001-20090930-49-1358-1-3177,1,2009-09-30,111,現金,ガソリン代,6380,0,14901941
9054,0001-20090930-49-1358-1-3177,4,2009-09-30,111,現金,高速代,286,0,14902227
9057,0001-20090930-5-1354-1-3169,1,2009-09-30,131,普通預金,広告費,2500,0,14904727
9071,0001-20090930-70-1361-1-3183,1,2009-09-30,322,未払金,有線,300,0,14905027
9074,0001-20090930-70-1361-1-3183,4,2009-09-30,322,未払金,警備料,2619,0,14907646
9076,0001-20090930-70-1361-1-3183,6,2009-09-30,111,現金,高速代,3491,0,14911137
9079,0001-20090930-70-1361-1-3183,9,2009-09-30,322,未払金,清掃料,3500,0,14914637
9106,0001-20090930-77-1364-1-3189,3,2009-09-30,322,未払金,運賃,7877,0,14922514
9117,0001-20090930-87-1366-1-3193,1,2009-09-30,111,現金,旅費,1428,0,14923942
9126,0001-20090930-96-1368-1-3197,1,2009-09-30,131,普通預金,警備料,1070,0,14925012
9132,0001-20090930-99-1369-1-3199,1,2009-09-30,322,未払金,運賃,30097,0,14955109
,,,2009-09,,※※月計※※,,2445215,0,
9136,0001-20091001-116-1407-1-3275,1,2009-10-01,131,普通預金,リース料,4000,0,14959109
9142,0001-20091001-141-1408-1-3277,1,2009-10-01,111,現金,JR代,371,0,14959480
9146,0001-20091001-18-1405-1-3271,1,2009-10-01,111,現金,旅費,1279,0,14960759
9150,0001-20091001-66-1406-1-3273,1,2009-10-01,131,普通預金,リース料,9992,0,14970751
9156,0001-20091002-142-1413-1-3287,1,2009-10-02,111,現金,ガソリン代,311,0,14971062
9159,0001-20091002-142-1413-1-3287,4,2009-10-02,111,現金,高速代,214,0,14971276
9161,0001-20091002-142-1413-1-3287,6,2009-10-02,111,現金,点検作業料,2171,0,14973447
9164,0001-20091002-157-1414-1-3289,1,2009-10-02,131,普通預金,航空券代,2633,0,14976080
9170,0001-20091002-32-1410-1-3281,1,2009-10-02,322,未払金,事務用品費,324,0,14976404
9174,0001-20091002-50-1411-1-3283,1,2009-10-02,111,現金,駐車代,57,0,14976461
9178,0001-20091002-7-1409-1-3279,1,2009-10-02,111,現金,飲食代　居酒屋太助2名,589,0,14977050
9182,0001-20091002-75-1412-1-3285,1,2009-10-02,111,現金,コーヒー代2名,60,0,14977110
9186,0001-20091003-102-1417-1-3295,1,2009-10-03,111,現金,手土産代　阿部商店,50,0,14977160
9190,0001-20091003-158-1418-1-3297,1,2009-10-03,111,現金,出張旅費,642,0,14977802
9194,0001-20091003-56-1415-1-3291,1,2009-10-03,111,現金,旅費,1733,0,14979535
9198,0001-20091003-75-1416-1-3293,1,2009-10-03,111,現金,旅費,571,0,14980106
9202,0001-20091005-147-1424-1-3309,1,2009-10-05,322,未払金,ガソリン代,188,0,14980294
9206,0001-20091005-161-1425-1-3311,1,2009-10-05,111,現金,旅費,302,0,14980596
9210,0001-20091005-164-1426-1-3313,1,2009-10-05,111,現金,事務用品,134,0,14980730
9214,0001-20091005-19-1419-1-3299,1,2009-10-05,111,現金,旅費,903,0,14981633
9218,0001-20091005-76-1420-1-3301,1,2009-10-05,322,未払金,制服代,2666,0,14984299
9226,0001-20091005-83-1421-1-3303,3,2009-10-05,152,売掛金,09年10月5日伝票No322株式会社　渡辺産業,22,0,14984321
9234,0001-20091005-84-1422-1-3305,3,2009-10-05,152,売掛金,09年10月5日伝票No323佐々木販売株式会社,22,0,14984343
9243,0001-20091006-110-1428-1-3317,1,2009-10-06,111,現金,タクシー代,109,0,14984452
9247,0001-20091006-149-1429-1-3319,1,2009-10-06,111,現金,食事代　レストランラルー3名,445,0,14984897
9251,0001-20091006-150-1430-1-3321,1,2009-10-06,111,現金,ゴルフプレー代3名,1688,0,14986585
9255,0001-20091006-152-1431-1-3323,1,2009-10-06,111,現金,飲食代　スナックいちい,1173,0,14987758
9259,0001-20091006-42-1427-1-3315,1,2009-10-06,111,現金,食事代　レストランライラック3名,300,0,14988058
9263,0001-20091007-133-1436-1-3333,1,2009-10-07,131,普通預金,税理士報酬,6652,0,14994710
9269,0001-20091007-21-1432-1-3325,1,2009-10-07,111,現金,JR代,3309,0,14998019
9273,0001-20091007-22-1433-1-3327,1,2009-10-07,111,現金,旅費,2380,0,15000399
9280,0001-20091007-58-1435-1-3331,1,2009-10-07,111,現金,旅費,3333,0,15003732
9284,0001-20091008-10-1437-1-3335,1,2009-10-08,111,現金,駐車代,23,0,15003755
9288,0001-20091008-151-1440-1-3341,1,2009-10-08,111,現金,食事代　ラーメンめん吉,71,0,15003826
9292,0001-20091008-16-1438-1-3337,1,2009-10-08,111,現金,洗車代,142,0,15003968
9295,0001-20091008-16-1438-1-3337,4,2009-10-08,111,現金,ガソリン代,300,0,15004268
9299,0001-20091008-82-1439-1-3339,1,2009-10-08,322,未払金,ガソリン代,1368,0,15005636
9303,0001-20091009-20-1441-1-3343,1,2009-10-09,111,現金,旅費,1964,0,15007600
9307,0001-20091009-46-1442-1-3345,1,2009-10-09,111,現金,ガソリン代,308,0,15007908
9310,0001-20091009-46-1442-1-3345,4,2009-10-09,111,現金,高速代,357,0,15008265
9312,0001-20091009-46-1442-1-3345,6,2009-10-09,111,現金,駐車代,166,0,15008431
9315,0001-20091010-103-1458-1-3377,1,2009-10-10,111,現金,食事代　イタリアンレストランペンネ2名,223,0,15008654
9319,0001-20091010-112-1459-1-3379,1,2009-10-10,131,普通預金,電話代,6872,0,15015526
9325,0001-20091010-129-1460-1-3381,1,2009-10-10,131,普通預金,家賃支払い,19000,0,15034526
9336,0001-20091010-162-1462-1-3385,1,2009-10-10,111,現金,会議　食事代,1190,0,15035716
9340,0001-20091010-167-1463-1-3387,1,2009-10-10,131,普通預金,家賃支払い,30000,0,15065716
9345,0001-20091010-167-1463-1-3387,4,2009-10-10,131,普通預金,電話代,5832,0,15071548
9351,0001-20091010-168-1464-1-3389,1,2009-10-10,322,未払金,有線,300,0,15071848
9354,0001-20091010-168-1464-1-3389,4,2009-10-10,322,未払金,警備料,2142,0,15073990
9357,0001-20091010-33-1443-1-3347,1,2009-10-10,131,普通預金,家賃支払い,15238,0,15089228
9362,0001-20091010-33-1443-1-3347,4,2009-10-10,131,普通預金,電話代,6451,0,15095679
9368,0001-20091010-44-1444-1-3349,1,2009-10-10,111,現金,昼食代　ホテルエンペラー2名,136,0,15095815
9382,0001-20091010-64-1446-1-3353,1,2009-10-10,131,普通預金,家賃支払,60000,0,15155815
9388,0001-20091010-65-1447-1-3355,1,2009-10-10,322,未払金,有線,250,0,15156065
9391,0001-20091010-65-1447-1-3355,4,2009-10-10,322,未払金,警備料,1714,0,15157779
9393,0001-20091010-65-1447-1-3355,6,2009-10-10,131,普通預金,家賃支払,40000,0,15197779
9399,0001-20091010-74-1448-1-3357,1,2009-10-10,111,現金,飲食代　居酒屋栗の木4名,773,0,15198552
9403,0001-20091010-76-1449-1-3359,1,2009-10-10,111,現金,ＪＲ代,690,0,15199242
9407,0001-20091010-85-1450-1-3361,1,2009-10-10,131,普通預金,電話代,4454,0,15203696
9417,0001-20091010-86-1451-1-3363,3,2009-10-10,152,売掛金,09年10月10日伝票No325株式会社　ミナミ,35,0,15203731
9431,0001-20091010-89-1454-1-3369,3,2009-10-10,152,売掛金,09年10月10日伝票No500株式会社　藤田東京本社,35,0,15203766
9449,0001-20091011-73-1465-1-3391,1,2009-10-11,111,現金,ガソリン代,316,0,15204082
9452,0001-20091011-73-1465-1-3391,4,2009-10-11,111,現金,高速代,57,0,15204139
9455,0001-20091012-148-1467-1-3395,1,2009-10-12,111,現金,ガソリン代,336,0,15204475
9459,0001-20091012-154-1468-1-3397,1,2009-10-12,322,未払金,コーヒー代2名,60,0,15204535
9463,0001-20091012-57-1466-1-3393,1,2009-10-12,111,現金,JR代,5347,0,15209882
9467,0001-20091013-11-1469-1-3399,1,2009-10-13,111,現金,ガソリン代,152,0,15210034
9471,0001-20091013-51-1470-1-3401,1,2009-10-13,111,現金,駐車代,183,0,15210217
9474,0001-20091013-51-1470-1-3401,4,2009-10-13,111,現金,高速代,276,0,15210493
9476,0001-20091013-51-1470-1-3401,6,2009-10-13,111,現金,ガソリン代,219,0,15210712
9479,0001-20091013-77-1471-1-3403,1,2009-10-13,111,現金,タクシー代,190,0,15210902
9483,0001-20091013-79-1472-1-3405,1,2009-10-13,111,現金,景品代,2320,0,15213222
9487,0001-20091014-159-1475-1-3411,1,2009-10-14,111,現金,タクシー代,423,0,15213645
9491,0001-20091014-23-1473-1-3407,1,2009-10-14,111,現金,旅費,1333,0,15214978
9494,0001-20091014-23-1473-1-3407,4,2009-10-14,111,現金,旅費,1476,0,15216454
9496,0001-20091014-23-1473-1-3407,6,2009-10-14,111,現金,旅費,1833,0,15218287
9499,0001-20091014-68-1474-1-3409,1,2009-10-14,111,現金,トイレットペーパー他,35,0,15218322
9511,0001-20091015-4-1476-1-3413,1,2009-10-15,322,未払金,広告費,1500,0,15219822
9533,0001-20091015-92-1479-1-3419,3,2009-10-15,152,売掛金,09年10月15日伝票No327五越株式会社,40,0,15219862
9541,0001-20091015-93-1480-1-3421,3,2009-10-15,152,売掛金,09年10月15日伝票No328株式会社　エントリー,40,0,15219902
9549,0001-20091015-94-1481-1-3423,3,2009-10-15,152,売掛金,09年10月15日伝票No329タワー株式会社,40,0,15219942
9557,0001-20091015-95-1482-1-3425,3,2009-10-15,152,売掛金,09年10月15日伝票No330高橋物産株式会社,40,0,15219982
9570,0001-20091015-97-1484-1-3429,3,2009-10-15,152,売掛金,09年10月15日伝票No332株式会社　久城商事,15,0,15219997
9579,0001-20091016-136-1490-1-3441,1,2009-10-16,111,現金,ダスキン代,785,0,15220782
9583,0001-20091016-61-1488-1-3437,1,2009-10-16,131,普通預金,電話代,6198,0,15226980
9589,0001-20091016-94-1489-1-3439,1,2009-10-16,111,現金,トイレットペーパー代,150,0,15227130
9592,0001-20091016-94-1489-1-3439,4,2009-10-16,111,現金,電池代,71,0,15227201
9595,0001-20091017-47-1491-1-3443,1,2009-10-17,111,現金,ガソリン代,120,0,15227321
9599,0001-20091017-69-1492-1-3445,1,2009-10-17,111,現金,洗剤他,136,0,15227457
9603,0001-20091018-104-1496-1-3453,1,2009-10-18,111,現金,食事代　ホテルラフォーネ2名,306,0,15227763
9607,0001-20091018-12-1493-1-3447,1,2009-10-18,111,現金,ガソリン代,222,0,15227985
9610,0001-20091018-12-1493-1-3447,4,2009-10-18,111,現金,高速代,115,0,15228100
9614,0001-20091018-155-1497-1-3455,1,2009-10-18,111,現金,ガソリン代,168,0,15228268
9618,0001-20091018-52-1494-1-3449,1,2009-10-18,111,現金,高速代,109,0,15228377
9621,0001-20091018-52-1494-1-3449,4,2009-10-18,111,現金,駐車代,85,0,15228462
9624,0001-20091018-86-1495-1-3451,1,2009-10-18,111,現金,切手代,380,0,15228842
9628,0001-20091019-153-1498-1-3457,1,2009-10-19,111,現金,手土産代　五越百貨店,311,0,15229153
9636,0001-20091020-100-1508-1-3477,3,2009-10-20,152,売掛金,09年10月20日伝票No334合同会社　たかだ,22,0,15229175
9646,0001-20091020-101-1509-1-3479,1,2009-10-20,322,未払金,広告料,2500,0,15231675
9653,0001-20091020-101-1509-1-3479,6,2009-10-20,152,売掛金,09年10月20日伝票No335株式会社　ＹＡＧ,35,0,15231710
9672,0001-20091020-118-1513-1-3487,1,2009-10-20,322,未払金,コピー代,332,0,15232042
9676,0001-20091020-119-1514-1-3489,1,2009-10-20,322,未払金,事務用品,316,0,15232358
9680,0001-20091020-139-1515-1-3491,1,2009-10-20,322,未払金,社員夜食代,1071,0,15233429
9684,0001-20091020-144-1516-1-3493,1,2009-10-20,111,現金,ガソリン代,214,0,15233643
9687,0001-20091020-144-1516-1-3493,4,2009-10-20,111,現金,ガソリン代,404,0,15234047
9689,0001-20091020-144-1516-1-3493,6,2009-10-20,111,現金,駐車代,168,0,15234215
9692,0001-20091020-31-1499-1-3459,1,2009-10-20,322,未払金,コピー代,128,0,15234343
9696,0001-20091020-48-1500-1-3461,1,2009-10-20,111,現金,ガソリン代,204,0,15234547
9700,0001-20091020-68-1501-1-3463,1,2009-10-20,322,未払金,カウンター料金,300,0,15234847
9704,0001-20091020-71-1502-1-3465,1,2009-10-20,322,未払金,事務用品,200,0,15235047
9707,0001-20091020-71-1502-1-3465,4,2009-10-20,322,未払金,カウンター料金,1571,0,15236618
9710,0001-20091020-72-1503-1-3467,1,2009-10-20,322,未払金,ファイル等,678,0,15237296
9713,0001-20091020-72-1503-1-3467,4,2009-10-20,322,未払金,飲料水,10994,0,15248290
9715,0001-20091020-72-1503-1-3467,6,2009-10-20,322,未払金,名刺代,600,0,15248890
9718,0001-20091020-80-1504-1-3469,1,2009-10-20,322,未払金,会費支払い,19875,0,15268765
9722,0001-20091020-97-1505-1-3471,1,2009-10-20,322,未払金,コピー代,1770,0,15270535
9726,0001-20091020-98-1506-1-3473,1,2009-10-20,322,未払金,事務用品,117,0,15270652
9742,0001-20091021-132-1527-1-3515,1,2009-10-21,131,普通預金,電気代,4589,0,15275241
9747,0001-20091021-132-1527-1-3515,4,2009-10-21,131,普通預金,水道代,237,0,15275478
9750,0001-20091021-160-1528-1-3517,1,2009-10-21,111,現金,出張旅費,3333,0,15278811
9754,0001-20091021-169-1529-1-3519,1,2009-10-21,131,普通預金,電気料,5445,0,15284256
9759,0001-20091021-169-1529-1-3519,4,2009-10-21,131,普通預金,水道料,296,0,15284552
9762,0001-20091021-25-1520-1-3501,1,2009-10-21,111,現金,旅費,2666,0,15287218
9766,0001-20091021-34-1521-1-3503,1,2009-10-21,131,普通預金,電気代,4345,0,15291563
9771,0001-20091021-34-1521-1-3503,4,2009-10-21,131,普通預金,水道代,286,0,15291849
9774,0001-20091021-5-1517-1-3495,1,2009-10-21,131,普通預金,広告費,2500,0,15294349
9780,0001-20091021-53-1522-1-3505,1,2009-10-21,111,現金,高速代,114,0,15294463
9783,0001-20091021-53-1522-1-3505,4,2009-10-21,111,現金,ガソリン代,50,0,15294513
9785,0001-20091021-53-1522-1-3505,6,2009-10-21,111,現金,駐車代,38,0,15294551
9788,0001-20091021-6-1518-1-3497,1,2009-10-21,111,現金,広告料,238,0,15294789
9792,0001-20091021-62-1523-1-3507,1,2009-10-21,322,未払金,お茶代,485,0,15295274
9796,0001-20091021-64-1524-1-3509,1,2009-10-21,131,普通預金,電気料,8317,0,15303591
9801,0001-20091021-64-1524-1-3509,4,2009-10-21,131,普通預金,水道料,388,0,15303979
9804,0001-20091021-79-1525-1-3511,1,2009-10-21,111,現金,旅費,1238,0,15305217
9808,0001-20091021-8-1519-1-3499,1,2009-10-21,111,現金,定例ミーティング会費,952,0,15306169
9812,0001-20091021-89-1526-1-3513,1,2009-10-21,131,普通預金,電気料,4211,0,15310380
9817,0001-20091021-89-1526-1-3513,4,2009-10-21,131,普通預金,水道料,198,0,15310578
9819,0001-20091021-89-1526-1-3513,6,2009-10-21,131,普通預金,ガス代,226,0,15310804
9822,0001-20091022-105-1536-1-3533,1,2009-10-22,111,現金,食事代　串揚げ一心4名,782,0,15311586
9825,0001-20091022-105-1536-1-3533,4,2009-10-22,111,現金,飲食代　スナック北新地4名,698,0,15312284
9828,0001-20091022-137-1537-1-3535,1,2009-10-22,322,未払金,有線,300,0,15312584
9831,0001-20091022-137-1537-1-3535,4,2009-10-22,322,未払金,警備料,2142,0,15314726
9833,0001-20091022-137-1537-1-3535,6,2009-10-22,131,普通預金,高速料,2145,0,15316871
9838,0001-20091022-137-1537-1-3535,9,2009-10-22,322,未払金,清掃料,3500,0,15320371
9845,0001-20091022-165-1539-1-3539,1,2009-10-22,111,現金,トイレットペーパー代,71,0,15320442
9849,0001-20091022-166-1540-1-3541,1,2009-10-22,111,現金,ダスキン代,90,0,15320532
9853,0001-20091022-3-1530-1-3521,1,2009-10-22,322,未払金,宿泊代,1423,0,15321955
9860,0001-20091022-69-1533-1-3527,1,2009-10-22,111,現金,ゴルフプレー代2名,1047,0,15323002
9864,0001-20091022-9-1531-1-3523,1,2009-10-22,111,現金,商品券,238,0,15323240
9868,0001-20091022-90-1534-1-3529,1,2009-10-22,111,現金,ダスキン代,500,0,15323740
9872,0001-20091022-95-1535-1-3531,1,2009-10-22,322,未払金,清掃料,3413,0,15327153
9876,0001-20091023-140-1544-1-3549,1,2009-10-23,111,現金,旅費,375,0,15327528
9880,0001-20091023-24-1541-1-3543,1,2009-10-23,111,現金,JR回数券,4532,0,15332060
9884,0001-20091023-28-1542-1-3545,1,2009-10-23,322,未払金,タクシー代,115,0,15332175
9888,0001-20091023-54-1543-1-3547,1,2009-10-23,111,現金,高速代,219,0,15332394
9892,0001-20091024-121-1546-1-3553,1,2009-10-24,111,現金,お茶代,333,0,15332727
9896,0001-20091024-146-1547-1-3555,1,2009-10-24,322,未払金,業務委託費,7000,0,15339727
9900,0001-20091024-26-1545-1-3551,1,2009-10-24,111,現金,旅費,576,0,15340303
9911,0001-20091025-106-1555-1-3571,3,2009-10-25,152,売掛金,09年10月25日伝票No337株式会社　総合経営,35,0,15340338
9919,0001-20091025-107-1556-1-3573,3,2009-10-25,152,売掛金,09年10月25日伝票No338株式会社　鎌田商店,30,0,15340368
9927,0001-20091025-108-1557-1-3575,3,2009-10-25,152,売掛金,09年10月25日伝票No339株式会社　小林マーケット,40,0,15340408
9931,0001-20091025-111-1558-1-3577,1,2009-10-25,322,未払金,タクシー代,642,0,15341050
9935,0001-20091025-170-1559-1-3579,1,2009-10-25,111,現金,新聞代,143,0,15341193
9939,0001-20091025-171-1560-1-3581,1,2009-10-25,131,普通預金,携帯代,2004,0,15343197
9948,0001-20091025-29-1548-1-3557,1,2009-10-25,131,普通預金,携帯電話代,6026,0,15349223
9954,0001-20091025-35-1549-1-3559,1,2009-10-25,111,現金,新聞代,186,0,15349409
9958,0001-20091025-37-1550-1-3561,1,2009-10-25,322,未払金,業務委託費,54428,0,15403837
9962,0001-20091025-74-1551-1-3563,1,2009-10-25,111,現金,ガソリン代,217,0,15404054
9965,0001-20091025-74-1551-1-3563,4,2009-10-25,111,現金,駐車代,28,0,15404082
10083,0001-20091025-92-1553-1-3567,1,2009-10-25,322,未払金,コピー機修繕,857,0,15404939
10087,0001-20091026-120-1566-1-3593,1,2009-10-26,322,未払金,業務委託費,30000,0,15434939
10096,0001-20091026-172-1568-1-3597,1,2009-10-26,322,未払金,業務委託費支払い,5619,0,15440558
10100,0001-20091026-27-1562-1-3585,1,2009-10-26,111,現金,旅費,1308,0,15441866
10103,0001-20091026-27-1562-1-3585,4,2009-10-26,111,現金,旅費,1700,0,15443566
10105,0001-20091026-27-1562-1-3585,6,2009-10-26,111,現金,旅費,1223,0,15444789
10108,0001-20091026-38-1563-1-3587,1,2009-10-26,322,未払金,宿泊費,2030,0,15446819
10112,0001-20091026-62-1564-1-3589,1,2009-10-26,131,普通預金,携帯代,3519,0,15450338
10118,0001-20091026-78-1565-1-3591,1,2009-10-26,322,未払金,業務委託費支払い,9000,0,15459338
10122,0001-20091027-113-1575-1-3611,1,2009-10-27,131,普通預金,携帯代,4197,0,15463535
10128,0001-20091027-14-1569-1-3599,1,2009-10-27,111,現金,ガソリン代,142,0,15463677
10137,0001-20091027-39-1571-1-3603,1,2009-10-27,111,現金,会費,428,0,15464105
10141,0001-20091027-83-1572-1-3605,1,2009-10-27,111,現金,車両管理費,2438,0,15466543
10145,0001-20091027-87-1573-1-3607,1,2009-10-27,131,普通預金,携帯代,1411,0,15467954
10151,0001-20091027-88-1574-1-3609,1,2009-10-27,111,現金,新聞代,169,0,15468123
10155,0001-20091028-114-1579-1-3619,1,2009-10-28,111,現金,新聞代,126,0,15468249
10158,0001-20091028-114-1579-1-3619,4,2009-10-28,111,現金,新聞代,143,0,15468392
10161,0001-20091028-15-1576-1-3613,1,2009-10-28,111,現金,駐車代,38,0,15468430
10165,0001-20091028-59-1577-1-3615,1,2009-10-28,111,現金,旅費,2328,0,15470758
10169,0001-20091028-93-1578-1-3617,1,2009-10-28,322,未払金,修繕費,850,0,15471608
10173,0001-20091029-109-1581-1-3623,1,2009-10-29,322,未払金,ガソリン代,2937,0,15474545
10177,0001-20091029-72-1580-1-3621,1,2009-10-29,111,現金,新聞代,143,0,15474688
10180,0001-20091029-72-1580-1-3621,4,2009-10-29,111,現金,新聞代,140,0,15474828
10182,0001-20091029-72-1580-1-3621,6,2009-10-29,111,現金,新聞代,169,0,15474997
10185,0001-20091030-100-1587-1-3635,1,2009-10-30,111,現金,会費,285,0,15475282
10194,0001-20091030-13-1582-1-3625,1,2009-10-30,111,現金,ガソリン代,619,0,15475901
10214,0001-20091030-55-1583-1-3627,1,2009-10-30,111,現金,車両管理費,1190,0,15477091
10217,0001-20091030-55-1583-1-3627,4,2009-10-30,111,現金,高速代,383,0,15477474
10220,0001-20091030-70-1584-1-3629,1,2009-10-30,322,未払金,有線,300,0,15477774
10223,0001-20091030-70-1584-1-3629,4,2009-10-30,322,未払金,警備料,2619,0,15480393
10225,0001-20091030-70-1584-1-3629,6,2009-10-30,131,普通預金,高速代,3571,0,15483964
10230,0001-20091030-70-1584-1-3629,9,2009-10-30,322,未払金,清掃料,3500,0,15487464
10234,0001-20091030-73-1585-1-3631,1,2009-10-30,111,現金,コーヒー代2名,60,0,15487524
10238,0001-20091030-96-1586-1-3633,1,2009-10-30,131,普通預金,警備料,1070,0,15488594
10244,0001-20091031-1-1590-1-3641,1,2009-10-31,322,未払金,運賃　佐川急便,10237,0,15498831
10360,0001-20091031-114-1609-1-3679,3,2009-10-31,152,売掛金,09年10月31日伝票No340マークマーケット,40,0,15498871
10368,0001-20091031-115-1610-1-3681,3,2009-10-31,152,売掛金,09年10月31日伝票No341株式会社　ＡＢＣ,40,0,15498911
10374,0001-20091031-116-1611-1-3683,3,2009-10-31,131,普通預金,リース料,4000,0,15502911
10384,0001-20091031-117-1612-1-3685,3,2009-10-31,152,売掛金,09年10月31日伝票No343株式会社　畠山商事,30,0,15502941
10392,0001-20091031-118-1613-1-3687,3,2009-10-31,152,売掛金,09年10月31日伝票No344株式会社　千代サービス,10,0,15502951
10399,0001-20091031-120-1615-1-3691,1,2009-10-31,312,買掛金,09年10月1日～09年10月31日分仕入,2400,0,15505351
10402,0001-20091031-120-1615-1-3691,4,2009-10-31,312,買掛金,09年10月1日～09年10月31日分仕入,5670,0,15511021
10406,0001-20091031-121-1616-1-3693,1,2009-10-31,312,買掛金,09年10月1日～09年10月31日分仕入,16380,0,15527401
10409,0001-20091031-121-1616-1-3693,4,2009-10-31,312,買掛金,09年10月1日～09年10月31日分仕入,292312,0,15819713
10412,0001-20091031-121-1616-1-3693,7,2009-10-31,312,買掛金,09年10月1日～09年10月31日分仕入,213939,0,16033652
10415,0001-20091031-121-1616-1-3693,10,2009-10-31,312,買掛金,09年10月1日～09年10月31日分仕入,143650,0,16177302
10418,0001-20091031-121-1616-1-3693,13,2009-10-31,312,買掛金,09年10月1日～09年10月31日分仕入,158253,0,16335555
10421,0001-20091031-121-1616-1-3693,16,2009-10-31,312,買掛金,09年10月1日～09年10月31日分仕入,43470,0,16379025
10424,0001-20091031-121-1616-1-3693,19,2009-10-31,312,買掛金,09年10月1日～09年10月31日分仕入,64080,0,16443105
10427,0001-20091031-121-1616-1-3693,22,2009-10-31,312,買掛金,09年10月1日～09年10月31日分仕入,10800,0,16453905
10431,0001-20091031-122-1617-1-3695,1,2009-10-31,312,買掛金,09年10月1日～09年10月31日分仕入,176940,0,16630845
10434,0001-20091031-122-1617-1-3695,4,2009-10-31,312,買掛金,09年10月1日～09年10月31日分仕入,88540,0,16719385
10437,0001-20091031-122-1617-1-3695,7,2009-10-31,312,買掛金,09年10月1日～09年10月31日分仕入,57380,0,16776765
10440,0001-20091031-122-1617-1-3695,10,2009-10-31,312,買掛金,09年10月1日～09年10月31日分仕入,7560,0,16784325
10444,0001-20091031-123-1618-1-3697,1,2009-10-31,312,買掛金,09年10月1日～09年10月31日分仕入,175104,0,16959429
10447,0001-20091031-123-1618-1-3697,4,2009-10-31,312,買掛金,09年10月1日～09年10月31日分仕入,153115,0,17112544
10450,0001-20091031-123-1618-1-3697,7,2009-10-31,312,買掛金,09年10月1日～09年10月31日分仕入,186830,0,17299374
10453,0001-20091031-123-1618-1-3697,10,2009-10-31,312,買掛金,09年10月1日～09年10月31日分仕入,45940,0,17345314
10456,0001-20091031-123-1618-1-3697,13,2009-10-31,312,買掛金,09年10月1日～09年10月31日分仕入,6000,0,17351314
10459,0001-20091031-123-1618-1-3697,16,2009-10-31,312,買掛金,09年10月1日～09年10月31日分仕入,3780,0,17355094
10463,0001-20091031-124-1619-1-3699,1,2009-10-31,312,買掛金,09年10月1日～09年10月31日分仕入,3780,0,17358874
10466,0001-20091031-124-1619-1-3699,4,2009-10-31,312,買掛金,09年10月1日～09年10月31日分仕入,960,0,17359834
10549,0001-20091031-145-1635-1-3731,1,2009-10-31,322,未払金,運賃,7271,0,17367105
10553,0001-20091031-36-1591-1-3643,1,2009-10-31,322,未払金,運賃　ヤマト運輸,81650,0,17448755
10556,0001-20091031-36-1591-1-3643,4,2009-10-31,322,未払金,運賃　佐川急便,46115,0,17494870
10559,0001-20091031-40-1592-1-3645,1,2009-10-31,322,未払金,広告掲載,2380,0,17497250
10563,0001-20091031-49-1593-1-3647,1,2009-10-31,111,現金,ガソリン代,7784,0,17505034
10572,0001-20091031-66-1595-1-3651,1,2009-10-31,131,普通預金,リース料,9992,0,17515026
10591,0001-20091031-77-1599-1-3659,1,2009-10-31,322,未払金,運賃,8230,0,17523256
10602,0001-20091031-81-1601-1-3663,1,2009-10-31,322,未払金,お茶代,976,0,17524232
10611,0001-20091031-99-1603-1-3667,1,2009-10-31,322,未払金,運賃,34005,0,17558237
,,,2009-10,,※※月計※※,,2603128,0,
10615,0001-20091101-165-1638-1-3737,1,2009-11-01,111,現金,お茶代他,178,0,17558415
10619,0001-20091101-18-1636-1-3733,1,2009-11-01,111,現金,旅費,1000,0,17559415
10623,0001-20091101-75-1637-1-3735,1,2009-11-01,111,現金,ガソリン代,307,0,17559722
10626,0001-20091101-75-1637-1-3735,4,2009-11-01,111,現金,ウォッシャー液代,23,0,17559745
10629,0001-20091102-149-1639-1-3739,1,2009-11-02,111,現金,食事代　和食処川よし2名,387,0,17560132
10632,0001-20091102-149-1639-1-3739,4,2009-11-02,111,現金,飲食代　スナックランディ,593,0,17560725
10635,0001-20091103-134-1641-1-3743,1,2009-11-03,111,現金,用紙,457,0,17561182
10639,0001-20091103-41-1640-1-3741,1,2009-11-03,111,現金,食事代　トン吉2名,168,0,17561350
10643,0001-20091104-67-1642-1-3745,1,2009-11-04,111,現金,お茶代他,106,0,17561456
10647,0001-20091104-68-1643-1-3747,1,2009-11-04,111,現金,ティッシュ代他,144,0,17561600
10654,0001-20091105-133-1653-1-3767,1,2009-11-05,131,普通預金,税理士報酬,6652,0,17568252
10660,0001-20091105-143-1654-1-3769,1,2009-11-05,111,現金,点検作業料,1492,0,17569744
10664,0001-20091105-19-1644-1-3749,1,2009-11-05,111,現金,旅費,466,0,17570210
10668,0001-20091105-42-1645-1-3751,1,2009-11-05,111,現金,コーヒー代3名,90,0,17570300
10672,0001-20091105-50-1646-1-3753,1,2009-11-05,111,現金,高速代,180,0,17570480
10676,0001-20091105-56-1647-1-3755,1,2009-11-05,111,現金,旅費,487,0,17570967
10680,0001-20091105-79-1648-1-3757,1,2009-11-05,111,現金,景品代,1422,0,17572389
10688,0001-20091105-84-1649-1-3759,3,2009-11-05,152,売掛金,09年11月5日伝票No353株式会社　渡辺産業,22,0,17572411
10696,0001-20091105-85-1650-1-3761,3,2009-11-05,152,売掛金,09年11月5日伝票No354佐々木販売株式会社,22,0,17572433
10705,0001-20091106-10-1655-1-3771,1,2009-11-06,111,現金,ガソリン代,201,0,17572634
10709,0001-20091106-110-1657-1-3775,1,2009-11-06,111,現金,タクシー代,109,0,17572743
10713,0001-20091106-16-1656-1-3773,1,2009-11-06,111,現金,スノーブレード代,380,0,17573123
10717,0001-20091107-20-1658-1-3777,1,2009-11-07,111,現金,旅費,1857,0,17574980
10721,0001-20091107-21-1659-1-3779,1,2009-11-07,111,現金,JR代,3309,0,17578289
10725,0001-20091107-22-1660-1-3781,1,2009-11-07,111,現金,旅費,2380,0,17580669
10729,0001-20091107-58-1661-1-3783,1,2009-11-07,111,現金,旅費,3333,0,17584002
10733,0001-20091108-32-1662-1-3785,1,2009-11-08,322,未払金,事務用品費,75,0,17584077
10737,0001-20091108-43-1663-1-3787,1,2009-11-08,111,現金,コーヒー代2名,75,0,17584152
10741,0001-20091108-44-1664-1-3789,1,2009-11-08,111,現金,手土産代　今井百貨店,150,0,17584302
10745,0001-20091108-78-1665-1-3791,1,2009-11-08,111,現金,ＪＲ代,466,0,17584768
10749,0001-20091109-139-1668-1-3797,1,2009-11-09,322,未払金,社員夜食代,1478,0,17586246
10753,0001-20091109-144-1669-1-3799,1,2009-11-09,111,現金,ガソリン代,305,0,17586551
10756,0001-20091109-144-1669-1-3799,4,2009-11-09,111,現金,駐車代,125,0,17586676
10758,0001-20091109-144-1669-1-3799,6,2009-11-09,111,現金,高速代,291,0,17586967
10761,0001-20091109-151-1670-1-3801,1,2009-11-09,111,現金,飲食代　和食ダイニング彩6名,1260,0,17588227
10764,0001-20091109-151-1670-1-3801,4,2009-11-09,111,現金,飲食代　パブランディー6名,1592,0,17589819
10770,0001-20091109-85-1667-1-3795,1,2009-11-09,131,普通預金,電話代,3042,0,17592861
10776,0001-20091110-129-1683-1-3827,1,2009-11-10,131,普通預金,家賃支払い,19000,0,17611861
10787,0001-20091110-141-1685-1-3831,1,2009-11-10,111,現金,JR代,571,0,17612432
10791,0001-20091110-147-1686-1-3833,1,2009-11-10,322,未払金,ガソリン代,338,0,17612770
10795,0001-20091110-156-1687-1-3835,1,2009-11-10,111,現金,出張旅費,161,0,17612931
10799,0001-20091110-162-1688-1-3837,1,2009-11-10,111,現金,会議　食事代,1190,0,17614121
10803,0001-20091110-167-1689-1-3839,1,2009-11-10,131,普通預金,家賃支払い,30000,0,17644121
10808,0001-20091110-167-1689-1-3839,4,2009-11-10,131,普通預金,電話代,6777,0,17650898
10814,0001-20091110-168-1690-1-3841,1,2009-11-10,322,未払金,有線,300,0,17651198
10817,0001-20091110-168-1690-1-3841,4,2009-11-10,322,未払金,警備料,2142,0,17653340
10820,0001-20091110-33-1671-1-3803,1,2009-11-10,131,普通預金,家賃支払い,15238,0,17668578
10825,0001-20091110-33-1671-1-3803,4,2009-11-10,131,普通預金,電話代,5550,0,17674128
10846,0001-20091110-65-1674-1-3809,1,2009-11-10,131,普通預金,家賃支払,40000,0,17714128
10852,0001-20091110-66-1675-1-3811,1,2009-11-10,322,未払金,有線,250,0,17714378
10855,0001-20091110-66-1675-1-3811,4,2009-11-10,322,未払金,警備料,1714,0,17716092
10865,0001-20091110-88-1677-1-3815,3,2009-11-10,152,売掛金,09年11月10日伝票No357株式会社　藤田東京本社,40,0,17716132
10873,0001-20091110-89-1678-1-3817,3,2009-11-10,152,売掛金,09年11月10日伝票No358株式会社　ミナミ,35,0,17716167
10888,0001-20091110-94-1682-1-3825,1,2009-11-10,131,普通預金,家賃支払,60000,0,17776167
10894,0001-20091111-103-1693-1-3847,1,2009-11-11,111,現金,手土産代　今井百貨店,150,0,17776317
10898,0001-20091111-112-1694-1-3849,1,2009-11-11,131,普通預金,電話代,10017,0,17786334
10904,0001-20091111-152-1695-1-3851,1,2009-11-11,111,現金,食事代　博多ラーメン3名,117,0,17786451
10908,0001-20091111-46-1691-1-3843,1,2009-11-11,111,現金,ガソリン代,414,0,17786865
10911,0001-20091111-46-1691-1-3843,4,2009-11-11,111,現金,高速代,61,0,17786926
10913,0001-20091111-46-1691-1-3843,6,2009-11-11,111,現金,駐車代,28,0,17786954
10916,0001-20091111-70-1692-1-3845,1,2009-11-11,111,現金,ゴルフプレー代4名,2000,0,17788954
10919,0001-20091111-70-1692-1-3845,4,2009-11-11,111,現金,景品代,500,0,17789454
10922,0001-20091112-73-1696-1-3853,1,2009-11-12,111,現金,飲食代　居酒屋栗の木3名,496,0,17789950
10926,0001-20091112-74-1697-1-3855,1,2009-11-12,111,現金,飲食代　スナックランディ,1078,0,17791028
10930,0001-20091112-79-1698-1-3857,1,2009-11-12,111,現金,旅費,571,0,17791599
10934,0001-20091113-142-1700-1-3861,1,2009-11-13,111,現金,高速代,172,0,17791771
10937,0001-20091113-142-1700-1-3861,4,2009-11-13,111,現金,高速代,102,0,17791873
10939,0001-20091113-142-1700-1-3861,6,2009-11-13,111,現金,高速代,59,0,17791932
10941,0001-20091113-142-1700-1-3861,8,2009-11-13,111,現金,駐車代,150,0,17792082
10943,0001-20091113-142-1700-1-3861,10,2009-11-13,111,現金,ガソリン代,360,0,17792442
10946,0001-20091113-158-1701-1-3863,1,2009-11-13,111,現金,航空券,2238,0,17794680
10950,0001-20091113-17-1699-1-3859,1,2009-11-13,111,現金,ウォッシャー液,17,0,17794697
10954,0001-20091114-161-1704-1-3869,1,2009-11-14,111,現金,旅費,354,0,17795051
10958,0001-20091114-23-1702-1-3865,1,2009-11-14,111,現金,旅費,1333,0,17796384
10961,0001-20091114-23-1702-1-3865,4,2009-11-14,111,現金,旅費,1476,0,17797860
10963,0001-20091114-23-1702-1-3865,6,2009-11-14,111,現金,旅費,1833,0,17799693
10966,0001-20091114-51-1703-1-3867,1,2009-11-14,111,現金,高速代,323,0,17800016
10975,0001-20091115-11-1705-1-3871,1,2009-11-15,111,現金,ガソリン代,152,0,17800168
10982,0001-20091115-57-1706-1-3873,1,2009-11-15,111,現金,JR代,4976,0,17805144
10986,0001-20091115-61-1707-1-3875,1,2009-11-15,131,普通預金,電話代,5558,0,17810702
10992,0001-20091115-76-1708-1-3877,1,2009-11-15,322,未払金,社員夜食代,1680,0,17812382
11009,0001-20091115-93-1710-1-3881,3,2009-11-15,152,売掛金,09年11月15日伝票No360五越株式会社,40,0,17812422
11017,0001-20091115-94-1711-1-3883,3,2009-11-15,152,売掛金,09年11月15日伝票No361五越株式会社,40,0,17812462
11025,0001-20091115-95-1712-1-3885,3,2009-11-15,152,売掛金,09年11月15日伝票No362株式会社　エントリー,40,0,17812502
11033,0001-20091115-96-1713-1-3887,3,2009-11-15,152,売掛金,09年11月15日伝票No363タワー株式会社,40,0,17812542
11041,0001-20091115-97-1714-1-3889,3,2009-11-15,152,売掛金,09年11月15日伝票No364高橋物産株式会社,40,0,17812582
11054,0001-20091115-99-1716-1-3893,3,2009-11-15,152,売掛金,09年11月15日伝票No366株式会社　久城商事,15,0,17812597
11063,0001-20091116-136-1722-1-3905,1,2009-11-16,111,現金,ダスキン代,785,0,17813382
11067,0001-20091116-164-1723-1-3907,1,2009-11-16,111,現金,事務用品,114,0,17813496
11071,0001-20091116-47-1719-1-3899,1,2009-11-16,111,現金,ガソリン代,414,0,17813910
11075,0001-20091116-82-1720-1-3901,1,2009-11-16,322,未払金,ガソリン代,1040,0,17814950
11078,0001-20091116-82-1720-1-3901,4,2009-11-16,322,未払金,ウォッシャー液,17,0,17814967
11081,0001-20091117-4-1724-1-3909,1,2009-11-17,322,未払金,広告費,1500,0,17816467
11085,0001-20091118-104-1727-1-3915,1,2009-11-18,111,現金,コーヒー代2名,60,0,17816527
11089,0001-20091118-59-1725-1-3911,1,2009-11-18,111,現金,旅費,2642,0,17819169
11093,0001-20091118-76-1726-1-3913,1,2009-11-18,111,現金,ガソリン代,184,0,17819353
11096,0001-20091118-76-1726-1-3913,4,2009-11-18,111,現金,高速代,38,0,17819391
11099,0001-20091119-12-1729-1-3919,1,2009-11-19,111,現金,ガソリン代,222,0,17819613
11102,0001-20091119-12-1729-1-3919,4,2009-11-19,111,現金,高速代,78,0,17819691
11104,0001-20091119-12-1729-1-3919,6,2009-11-19,111,現金,駐車代,38,0,17819729
11107,0001-20091119-45-1730-1-3921,1,2009-11-19,111,現金,コーヒー代,60,0,17819789
11111,0001-20091119-52-1731-1-3923,1,2009-11-19,111,現金,高速代,54,0,17819843
11114,0001-20091119-52-1731-1-3923,4,2009-11-19,111,現金,駐車代,109,0,17819952
11117,0001-20091119-8-1728-1-3917,1,2009-11-19,111,現金,定例ミーティング会費,952,0,17820904
11121,0001-20091120-101-1745-1-3951,1,2009-11-20,322,未払金,広告料,2500,0,17823404
11131,0001-20091120-102-1746-1-3953,3,2009-11-20,152,売掛金,09年11月20日伝票No368合同会社　たかだ,22,0,17823426
11139,0001-20091120-103-1747-1-3955,3,2009-11-20,152,売掛金,09年11月20日伝票No369株式会社　ＹＡＧ,35,0,17823461
11158,0001-20091120-118-1751-1-3963,1,2009-11-20,322,未払金,コピー代,350,0,17823811
11162,0001-20091120-119-1752-1-3965,1,2009-11-20,322,未払金,事務用品,185,0,17823996
11166,0001-20091120-132-1753-1-3967,1,2009-11-20,131,普通預金,電気代,5763,0,17829759
11171,0001-20091120-132-1753-1-3967,4,2009-11-20,131,普通預金,水道代,263,0,17830022
11187,0001-20091120-153-1756-1-3973,1,2009-11-20,111,現金,飲食代　居酒屋田舎2名,360,0,17830382
11191,0001-20091120-169-1757-1-3975,1,2009-11-20,131,普通預金,電気料,4984,0,17835366
11196,0001-20091120-169-1757-1-3975,4,2009-11-20,131,普通預金,水道料,315,0,17835681
11199,0001-20091120-24-1733-1-3927,1,2009-11-20,111,現金,JR回数券,3934,0,17839615
11203,0001-20091120-31-1734-1-3929,1,2009-11-20,322,未払金,コピー代,136,0,17839751
11207,0001-20091120-34-1735-1-3931,1,2009-11-20,131,普通預金,電気代,3936,0,17843687
11212,0001-20091120-34-1735-1-3931,4,2009-11-20,131,普通預金,水道代,244,0,17843931
11215,0001-20091120-53-1736-1-3933,1,2009-11-20,111,現金,高速代,19,0,17843950
11218,0001-20091120-53-1736-1-3933,4,2009-11-20,111,現金,高速代,50,0,17844000
11220,0001-20091120-53-1736-1-3933,6,2009-11-20,111,現金,高速代,50,0,17844050
11223,0001-20091120-6-1732-1-3925,1,2009-11-20,111,現金,広告料,238,0,17844288
11227,0001-20091120-64-1737-1-3935,1,2009-11-20,131,普通預金,電気料,9551,0,17853839
11232,0001-20091120-64-1737-1-3935,4,2009-11-20,131,普通預金,水道料,384,0,17854223
11235,0001-20091120-66-1738-1-3937,1,2009-11-20,322,未払金,有線,238,0,17854461
11239,0001-20091120-67-1739-1-3939,1,2009-11-20,322,未払金,カウンター料金,300,0,17854761
11243,0001-20091120-71-1740-1-3941,1,2009-11-20,322,未払金,事務用品,183,0,17854944
11246,0001-20091120-71-1740-1-3941,4,2009-11-20,322,未払金,カウンター料金,1572,0,17856516
11249,0001-20091120-73-1741-1-3943,1,2009-11-20,322,未払金,ファイル等,577,0,17857093
11252,0001-20091120-73-1741-1-3943,4,2009-11-20,322,未払金,飲料水,10498,0,17867591
11254,0001-20091120-73-1741-1-3943,6,2009-11-20,322,未払金,名刺代,622,0,17868213
11257,0001-20091120-89-1742-1-3945,1,2009-11-20,131,普通預金,電気料,4608,0,17872821
11262,0001-20091120-89-1742-1-3945,4,2009-11-20,131,普通預金,水道料,202,0,17873023
11264,0001-20091120-89-1742-1-3945,6,2009-11-20,131,普通預金,ガス代,218,0,17873241
11267,0001-20091120-97-1743-1-3947,1,2009-11-20,322,未払金,コピー代,1857,0,17875098
11271,0001-20091120-98-1744-1-3949,1,2009-11-20,322,未払金,事務用品,168,0,17875266
11275,0001-20091121-160-1760-1-3981,1,2009-11-21,111,現金,出張旅費,4525,0,17879791
11282,0001-20091121-25-1758-1-3977,1,2009-11-21,111,現金,旅費,2666,0,17882457
11286,0001-20091121-69-1759-1-3979,1,2009-11-21,111,現金,ティッシュ代,53,0,17882510
11290,0001-20091122-105-1767-1-3995,1,2009-11-22,111,現金,コーヒー代他2名,117,0,17882627
11293,0001-20091122-105-1767-1-3995,4,2009-11-22,111,現金,食事代　串揚げ一心2名,303,0,17882930
11295,0001-20091122-105-1767-1-3995,6,2009-11-22,111,現金,飲食代　カフェバーラウル,464,0,17883394
11301,0001-20091122-159-1769-1-3999,1,2009-11-22,111,現金,タクシー代,619,0,17884013
11305,0001-20091122-166-1770-1-4001,1,2009-11-22,111,現金,ダスキン代,90,0,17884103
11309,0001-20091122-48-1762-1-3985,1,2009-11-22,111,現金,ガソリン代,164,0,17884267
11313,0001-20091122-62-1763-1-3987,1,2009-11-22,322,未払金,お茶代,526,0,17884793
11317,0001-20091122-80-1764-1-3989,1,2009-11-22,111,現金,旅費,1476,0,17886269
11321,0001-20091122-90-1765-1-3991,1,2009-11-22,111,現金,ダスキン代,500,0,17886769
11325,0001-20091122-95-1766-1-3993,1,2009-11-22,322,未払金,清掃料,3413,0,17890182
11329,0001-20091123-13-1772-1-4005,1,2009-11-23,111,現金,ガソリン代,523,0,17890705
11333,0001-20091123-140-1777-1-4015,1,2009-11-23,111,現金,旅費,219,0,17890924
11337,0001-20091123-26-1773-1-4007,1,2009-11-23,111,現金,旅費,523,0,17891447
11341,0001-20091123-28-1774-1-4009,1,2009-11-23,322,未払金,タクシー代,115,0,17891562
11345,0001-20091123-3-1771-1-4003,1,2009-11-23,322,未払金,宿泊代,1477,0,17893039
11464,0001-20091123-94-1776-1-4013,1,2009-11-23,111,現金,洗剤代,76,0,17893115
11468,0001-20091124-120-1781-1-4023,1,2009-11-24,322,未払金,業務委託費,23000,0,17916115
11472,0001-20091124-150-1782-1-4025,1,2009-11-24,111,現金,ゴルフプレー代,683,0,17916798
11475,0001-20091124-150-1782-1-4025,4,2009-11-24,111,現金,景品代　今井百貨店,250,0,17917048
11478,0001-20091124-37-1778-1-4017,1,2009-11-24,322,未払金,業務委託費,41676,0,17958724
11482,0001-20091124-77-1779-1-4019,1,2009-11-24,111,現金,ガソリン代,152,0,17958876
11485,0001-20091124-77-1779-1-4019,4,2009-11-24,111,現金,駐車代,28,0,17958904
11488,0001-20091124-83-1780-1-4021,1,2009-11-24,111,現金,車両管理費,1500,0,17960404
11499,0001-20091125-108-1789-1-4039,3,2009-11-25,152,売掛金,09年11月25日伝票No371株式会社　総合経営,35,0,17960439
11503,0001-20091125-109-1790-1-4041,1,2009-11-25,322,未払金,高速代,492,0,17960931
11506,0001-20091125-109-1790-1-4041,4,2009-11-25,322,未払金,ガソリン代,2671,0,17963602
11512,0001-20091125-109-1790-1-4041,8,2009-11-25,152,売掛金,09年11月25日伝票No372株式会社　鎌田商店,30,0,17963632
11520,0001-20091125-110-1791-1-4043,3,2009-11-25,152,売掛金,09年11月25日伝票No373株式会社　小林マーケット,40,0,17963672
11524,0001-20091125-111-1792-1-4045,1,2009-11-25,322,未払金,タクシー代,704,0,17964376
11533,0001-20091125-146-1794-1-4049,1,2009-11-25,322,未払金,業務委託費,8000,0,17972376
11537,0001-20091125-170-1795-1-4051,1,2009-11-25,111,現金,新聞代,143,0,17972519
11541,0001-20091125-172-1796-1-4053,1,2009-11-25,322,未払金,業務委託費支払い,6000,0,17978519
11545,0001-20091125-29-1784-1-4029,1,2009-11-25,131,普通預金,携帯電話代,2786,0,17981305
11551,0001-20091125-62-1785-1-4031,1,2009-11-25,131,普通預金,携帯代,3326,0,17984631
11557,0001-20091125-78-1786-1-4033,1,2009-11-25,322,未払金,業務委託費支払い,9000,0,17993631
11561,0001-20091125-88-1787-1-4035,1,2009-11-25,111,現金,新聞代,169,0,17993800
11565,0001-20091125-9-1783-1-4027,1,2009-11-25,111,現金,飲食代　いろは2名,311,0,17994111
11568,0001-20091125-9-1783-1-4027,4,2009-11-25,111,現金,飲食代　カフェバー,416,0,17994527
11571,0001-20091126-113-1799-1-4059,1,2009-11-26,131,普通預金,携帯代,4460,0,17998987
11577,0001-20091126-121-1800-1-4061,1,2009-11-26,111,現金,お茶代,404,0,17999391
11581,0001-20091126-54-1797-1-4055,1,2009-11-26,111,現金,高速代,119,0,17999510
11585,0001-20091126-72-1798-1-4057,1,2009-11-26,111,現金,新聞代,143,0,17999653
11588,0001-20091126-72-1798-1-4057,4,2009-11-26,111,現金,新聞代,140,0,17999793
11590,0001-20091126-72-1798-1-4057,6,2009-11-26,111,現金,新聞代,169,0,17999962
11593,0001-20091127-114-1806-1-4073,1,2009-11-27,111,現金,新聞代,126,0,18000088
11596,0001-20091127-114-1806-1-4073,4,2009-11-27,111,現金,新聞代,143,0,18000231
11604,0001-20091127-14-1801-1-4063,1,2009-11-27,111,現金,ガソリン代,142,0,18000373
11608,0001-20091127-15-1802-1-4065,1,2009-11-27,111,現金,車両管理費,4285,0,18004658
11612,0001-20091127-171-1808-1-4077,1,2009-11-27,131,普通預金,携帯代,4147,0,18008805
11623,0001-20091127-39-1804-1-4069,1,2009-11-27,111,現金,会費,428,0,18009233
11627,0001-20091127-87-1805-1-4071,1,2009-11-27,131,普通預金,携帯代,1651,0,18010884
11633,0001-20091128-154-1813-1-4087,1,2009-11-28,322,未払金,食事代　ホテル大分2名,168,0,18011052
11636,0001-20091128-154-1813-1-4087,4,2009-11-28,322,未払金,飲食代　ホテル大分2名,736,0,18011788
11639,0001-20091128-27-1809-1-4079,1,2009-11-28,111,現金,旅費,1333,0,18013121
11642,0001-20091128-27-1809-1-4079,4,2009-11-28,111,現金,旅費,1476,0,18014597
11644,0001-20091128-27-1809-1-4079,6,2009-11-28,111,現金,旅費,1071,0,18015668
11647,0001-20091128-35-1810-1-4081,1,2009-11-28,111,現金,新聞代,186,0,18015854
11651,0001-20091128-38-1811-1-4083,1,2009-11-28,322,未払金,宿泊費,2293,0,18018147
11655,0001-20091128-93-1812-1-4085,1,2009-11-28,322,未払金,修繕費,850,0,18018997
11659,0001-20091129-137-1817-1-4095,1,2009-11-29,322,未払金,有線,300,0,18019297
11662,0001-20091129-137-1817-1-4095,4,2009-11-29,322,未払金,警備料,2142,0,18021439
11664,0001-20091129-137-1817-1-4095,6,2009-11-29,131,普通預金,高速料,3114,0,18024553
11669,0001-20091129-137-1817-1-4095,9,2009-11-29,322,未払金,清掃料,3500,0,18028053
11689,0001-20091129-148-1819-1-4099,1,2009-11-29,111,現金,ガソリン代,238,0,18028291
11696,0001-20091129-75-1815-1-4091,1,2009-11-29,111,現金,飲食代　スナックわたなべ5名,1551,0,18029842
11700,0001-20091129-81-1816-1-4093,1,2009-11-29,322,未払金,お茶代,933,0,18030775
11704,0001-20091130-1-1820-1-4101,1,2009-11-30,322,未払金,運賃　佐川急便,18184,0,18048959
11708,0001-20091130-100-1837-1-4135,1,2009-11-30,111,現金,会費,285,0,18049244
11712,0001-20091130-108-1838-1-4137,1,2009-11-30,111,現金,コーヒー代　ホテルラフォーネ3名,114,0,18049358
11833,0001-20091130-116-1845-1-4151,3,2009-11-30,152,売掛金,09年11月30日伝票No374マークマーケット,40,0,18049398
11836,0001-20091130-116-1845-1-4151,6,2009-11-30,131,普通預金,リース料,4000,0,18053398
11846,0001-20091130-117-1846-1-4153,3,2009-11-30,152,売掛金,09年11月30日伝票No375株式会社　ＡＢＣ,40,0,18053438
11860,0001-20091130-120-1849-1-4159,3,2009-11-30,152,売掛金,09年11月30日伝票No378株式会社　畠山商事,30,0,18053468
11868,0001-20091130-121-1850-1-4161,3,2009-11-30,152,売掛金,09年11月30日伝票No379株式会社　千代サービス,10,0,18053478
11872,0001-20091130-122-1851-1-4163,1,2009-11-30,312,買掛金,09年11月1日～09年11月30日分仕入,8756,0,18062234
11875,0001-20091130-122-1851-1-4163,4,2009-11-30,312,買掛金,09年11月1日～09年11月30日分仕入,1224,0,18063458
11879,0001-20091130-123-1852-1-4165,1,2009-11-30,312,買掛金,09年11月1日～09年11月30日分仕入,20654,0,18084112
11882,0001-20091130-123-1852-1-4165,4,2009-11-30,312,買掛金,09年11月1日～09年11月30日分仕入,346887,0,18430999
11885,0001-20091130-123-1852-1-4165,7,2009-11-30,312,買掛金,09年11月1日～09年11月30日分仕入,251705,0,18682704
11888,0001-20091130-123-1852-1-4165,10,2009-11-30,312,買掛金,09年11月1日～09年11月30日分仕入,184522,0,18867226
11891,0001-20091130-123-1852-1-4165,13,2009-11-30,312,買掛金,09年11月1日～09年11月30日分仕入,194146,0,19061372
11894,0001-20091130-123-1852-1-4165,16,2009-11-30,312,買掛金,09年11月1日～09年11月30日分仕入,85819,0,19147191
11897,0001-20091130-123-1852-1-4165,19,2009-11-30,312,買掛金,09年11月1日～09年11月30日分仕入,15376,0,19162567
11900,0001-20091130-123-1852-1-4165,22,2009-11-30,312,買掛金,09年11月1日～09年11月30日分仕入,8568,0,19171135
11904,0001-20091130-124-1853-1-4167,1,2009-11-30,312,買掛金,09年11月1日～09年11月30日分仕入,218895,0,19390030
11907,0001-20091130-124-1853-1-4167,4,2009-11-30,312,買掛金,09年11月1日～09年11月30日分仕入,105923,0,19495953
11910,0001-20091130-124-1853-1-4167,7,2009-11-30,312,買掛金,09年11月1日～09年11月30日分仕入,73467,0,19569420
11913,0001-20091130-124-1853-1-4167,10,2009-11-30,312,買掛金,09年11月1日～09年11月30日分仕入,2448,0,19571868
11916,0001-20091130-124-1853-1-4167,13,2009-11-30,312,買掛金,09年11月1日～09年11月30日分仕入,4912,0,19576780
11920,0001-20091130-125-1854-1-4169,1,2009-11-30,312,買掛金,09年11月1日～09年11月30日分仕入,180537,0,19757317
11923,0001-20091130-125-1854-1-4169,4,2009-11-30,312,買掛金,09年11月1日～09年11月30日分仕入,192524,0,19949841
11926,0001-20091130-125-1854-1-4169,7,2009-11-30,312,買掛金,09年11月1日～09年11月30日分仕入,233210,0,20183051
11929,0001-20091130-125-1854-1-4169,10,2009-11-30,312,買掛金,09年11月1日～09年11月30日分仕入,23918,0,20206969
11932,0001-20091130-125-1854-1-4169,13,2009-11-30,312,買掛金,09年11月1日～09年11月30日分仕入,55019,0,20261988
11935,0001-20091130-125-1854-1-4169,16,2009-11-30,312,買掛金,09年11月1日～09年11月30日分仕入,4896,0,20266884
11939,0001-20091130-126-1855-1-4171,1,2009-11-30,312,買掛金,09年11月1日～09年11月30日分仕入,2203,0,20269087
11942,0001-20091130-126-1855-1-4171,4,2009-11-30,312,買掛金,09年11月1日～09年11月30日分仕入,9610,0,20278697
12008,0001-20091130-145-1868-1-4197,1,2009-11-30,322,未払金,運賃,6685,0,20285382
12024,0001-20091130-155-1871-1-4203,1,2009-11-30,322,未払金,点検整備,1210,0,20286592
12028,0001-20091130-36-1822-1-4105,1,2009-11-30,322,未払金,運賃　ヤマト運輸,86193,0,20372785
12031,0001-20091130-36-1822-1-4105,4,2009-11-30,322,未払金,運賃　佐川急便,64079,0,20436864
12034,0001-20091130-40-1823-1-4107,1,2009-11-30,322,未払金,広告掲載,2380,0,20439244
12038,0001-20091130-49-1824-1-4109,1,2009-11-30,111,現金,ガソリン代,6904,0,20446148
12042,0001-20091130-5-1821-1-4103,1,2009-11-30,131,普通預金,広告費,2500,0,20448648
12048,0001-20091130-55-1825-1-4111,1,2009-11-30,111,現金,車両管理費,595,0,20449243
12051,0001-20091130-55-1825-1-4111,4,2009-11-30,111,現金,駐車代,383,0,20449626
12059,0001-20091130-66-1827-1-4115,1,2009-11-30,131,普通預金,リース料,9992,0,20459618
12065,0001-20091130-69-1828-1-4117,1,2009-11-30,111,現金,洗剤代,35,0,20459653
12069,0001-20091130-70-1829-1-4119,1,2009-11-30,322,未払金,有線,300,0,20459953
12072,0001-20091130-70-1829-1-4119,4,2009-11-30,322,未払金,警備料,2619,0,20462572
12074,0001-20091130-70-1829-1-4119,6,2009-11-30,131,普通預金,高速料,3491,0,20466063
12079,0001-20091130-70-1829-1-4119,9,2009-11-30,322,未払金,清掃料,3500,0,20469563
12100,0001-20091130-77-1833-1-4127,1,2009-11-30,322,未払金,運賃,9361,0,20478924
12109,0001-20091130-96-1835-1-4131,1,2009-11-30,131,普通預金,警備料,1070,0,20479994
12115,0001-20091130-99-1836-1-4133,1,2009-11-30,322,未払金,運賃,40290,0,20520284
,,,2009-11,,※※月計※※,,2962047,0,
12119,0001-20091201-10-1872-1-4205,1,2009-12-01,111,現金,洗車代,142,0,20520426
12123,0001-20091201-143-1876-1-4213,1,2009-12-01,111,現金,点検作業料,1400,0,20521826
12127,0001-20091201-18-1873-1-4207,1,2009-12-01,111,現金,旅費,1404,0,20523230
12131,0001-20091201-56-1874-1-4209,1,2009-12-01,111,現金,旅費,2380,0,20525610
12134,0001-20091201-56-1874-1-4209,4,2009-12-01,111,現金,ＪＲ代,2000,0,20527610
12137,0001-20091201-85-1875-1-4211,1,2009-12-01,111,現金,旅費,942,0,20528552
12141,0001-20091202-19-1877-1-4215,1,2009-12-02,111,現金,旅費,1047,0,20529599
12145,0001-20091203-134-1878-1-4217,1,2009-12-03,111,現金,用紙,695,0,20530294
12149,0001-20091203-147-1879-1-4219,1,2009-12-03,322,未払金,ガソリン代,297,0,20530591
12153,0001-20091204-41-1880-1-4221,1,2009-12-04,111,現金,お歳暮　五越百貨店,3459,0,20534050
12156,0001-20091204-41-1880-1-4221,4,2009-12-04,111,現金,お歳暮　今井百貨店,2031,0,20536081
12158,0001-20091204-41-1880-1-4221,6,2009-12-04,111,現金,お歳暮　豊岡商店,797,0,20536878
12161,0001-20091205-133-1886-1-4233,1,2009-12-05,131,普通預金,税理士報酬,6652,0,20543530
12167,0001-20091205-50-1881-1-4223,1,2009-12-05,111,現金,高速代,166,0,20543696
12171,0001-20091205-86-1882-1-4225,1,2009-12-05,111,現金,ＪＲ代,571,0,20544267
12179,0001-20091205-95-1883-1-4227,3,2009-12-05,152,売掛金,09年12月5日伝票No380株式会社　渡辺産業,22,0,20544289
12187,0001-20091205-96-1884-1-4229,3,2009-12-05,152,売掛金,09年12月5日伝票No381佐々木販売株式会社,22,0,20544311
12196,0001-20091206-106-1888-1-4237,1,2009-12-06,111,現金,お歳暮　五越百貨店,3590,0,20547901
12199,0001-20091206-106-1888-1-4237,4,2009-12-06,111,現金,お歳暮　今井百貨店,2031,0,20549932
12202,0001-20091206-110-1889-1-4239,1,2009-12-06,111,現金,タクシー代,109,0,20550041
12206,0001-20091206-159-1890-1-4241,1,2009-12-06,111,現金,タクシー代,500,0,20550541
12210,0001-20091206-87-1887-1-4235,1,2009-12-06,111,現金,タクシー代,214,0,20550755
12214,0001-20091207-102-1897-1-4255,1,2009-12-07,111,現金,お歳暮　阿部商店,871,0,20551626
12218,0001-20091207-16-1891-1-4243,1,2009-12-07,111,現金,ガソリン代,142,0,20551768
12221,0001-20091207-16-1891-1-4243,4,2009-12-07,111,現金,駐車代,18,0,20551786
12224,0001-20091207-20-1892-1-4245,1,2009-12-07,111,現金,旅費,1857,0,20553643
12228,0001-20091207-21-1893-1-4247,1,2009-12-07,111,現金,JR代,3309,0,20556952
12232,0001-20091207-22-1894-1-4249,1,2009-12-07,111,現金,旅費,2380,0,20559332
12236,0001-20091207-58-1895-1-4251,1,2009-12-07,111,現金,旅費,3333,0,20562665
12240,0001-20091207-69-1896-1-4253,1,2009-12-07,111,現金,洗剤代,18,0,20562683
12243,0001-20091207-69-1896-1-4253,4,2009-12-07,111,現金,台所用品,135,0,20562818
12245,0001-20091207-69-1896-1-4253,6,2009-12-07,111,現金,洗剤代,42,0,20562860
12249,0001-20091208-142-1900-1-4261,1,2009-12-08,111,現金,高速代,155,0,20563015
12252,0001-20091208-142-1900-1-4261,4,2009-12-08,111,現金,高速代,468,0,20563483
12254,0001-20091208-142-1900-1-4261,6,2009-12-08,111,現金,高速代,170,0,20563653
12256,0001-20091208-142-1900-1-4261,8,2009-12-08,111,現金,高速代,311,0,20563964
12258,0001-20091208-142-1900-1-4261,10,2009-12-08,111,現金,高速代,217,0,20564181
12260,0001-20091208-142-1900-1-4261,12,2009-12-08,111,現金,ガソリン代,285,0,20564466
12263,0001-20091208-76-1898-1-4257,1,2009-12-08,322,未払金,社員夜食代,3609,0,20568075
12267,0001-20091208-77-1899-1-4259,1,2009-12-08,111,現金,ゴルフプレー代2名,704,0,20568779
12271,0001-20091209-112-1902-1-4265,1,2009-12-09,131,普通預金,電話代,8267,0,20577046
12277,0001-20091209-150-1903-1-4267,1,2009-12-09,111,現金,お歳暮　五越百貨店,3052,0,20580098
12280,0001-20091209-150-1903-1-4267,4,2009-12-09,111,現金,お歳暮　今井百貨店,1255,0,20581353
12283,0001-20091209-44-1901-1-4263,1,2009-12-09,111,現金,食事代　レストランフード3名,298,0,20581651
12291,0001-20091210-100-1915-1-4291,3,2009-12-10,152,売掛金,09年12月10日伝票No385株式会社　ミナミ,35,0,20581686
12301,0001-20091210-103-1918-1-4297,1,2009-12-10,111,現金,コーヒー代　喫茶まどい,127,0,20581813
12309,0001-20091210-110-1919-1-4299,1,2009-12-10,131,普通預金,家賃支払,60000,0,20641813
12315,0001-20091210-129-1920-1-4301,1,2009-12-10,131,普通預金,家賃支払い,19000,0,20660813
12326,0001-20091210-162-1922-1-4305,1,2009-12-10,111,現金,会議　食事代,1190,0,20662003
12330,0001-20091210-167-1923-1-4307,1,2009-12-10,131,普通預金,家賃支払い,30000,0,20692003
12335,0001-20091210-167-1923-1-4307,4,2009-12-10,131,普通預金,電話代,9554,0,20701557
12341,0001-20091210-168-1924-1-4309,1,2009-12-10,322,未払金,有線,300,0,20701857
12344,0001-20091210-168-1924-1-4309,4,2009-12-10,322,未払金,警備料,2142,0,20703999
12347,0001-20091210-33-1905-1-4271,1,2009-12-10,131,普通預金,家賃支払い,15238,0,20719237
12352,0001-20091210-33-1905-1-4271,4,2009-12-10,131,普通預金,電話代,6595,0,20725832
12373,0001-20091210-68-1908-1-4277,1,2009-12-10,131,普通預金,家賃支払,40000,0,20765832
12379,0001-20091210-69-1909-1-4279,1,2009-12-10,322,未払金,有線,250,0,20766082
12382,0001-20091210-69-1909-1-4279,4,2009-12-10,322,未払金,警備料,1714,0,20767796
12385,0001-20091210-82-1910-1-4281,1,2009-12-10,322,未払金,ガソリン代,812,0,20768608
12389,0001-20091210-85-1911-1-4283,1,2009-12-10,131,普通預金,電話代,3868,0,20772476
12395,0001-20091210-88-1912-1-4285,1,2009-12-10,111,現金,タクシー代,380,0,20772856
12399,0001-20091210-9-1904-1-4269,1,2009-12-10,111,現金,お歳暮　もみじデパート,3733,0,20776589
12410,0001-20091210-99-1914-1-4289,3,2009-12-10,152,売掛金,09年12月10日伝票No384株式会社　藤田東京本社,35,0,20776624
12417,0001-20091211-82-1925-1-4311,1,2009-12-11,111,現金,ガソリン代,200,0,20776824
12420,0001-20091211-82-1925-1-4311,4,2009-12-11,111,現金,高速代,28,0,20776852
12423,0001-20091212-70-1927-1-4315,1,2009-12-12,111,現金,お歳暮　五越百貨店,1363,0,20778215
12426,0001-20091212-70-1927-1-4315,4,2009-12-12,111,現金,お歳暮　今井百貨店,547,0,20778762
12429,0001-20091213-11-1929-1-4319,1,2009-12-13,111,現金,高速代,133,0,20778895
12432,0001-20091213-11-1929-1-4319,4,2009-12-13,111,現金,ガソリン代,219,0,20779114
12436,0001-20091213-141-1930-1-4321,1,2009-12-13,111,現金,JR代,1119,0,20780233
12440,0001-20091213-158-1931-1-4323,1,2009-12-13,111,現金,航空券,1619,0,20781852
12444,0001-20091213-7-1928-1-4317,1,2009-12-13,111,現金,飲食代　鳥仙人3名,755,0,20782607
12447,0001-20091213-7-1928-1-4317,4,2009-12-13,111,現金,飲食代　スナックさらら3名,874,0,20783481
12450,0001-20091214-23-1932-1-4325,1,2009-12-14,111,現金,旅費,1333,0,20784814
12453,0001-20091214-23-1932-1-4325,4,2009-12-14,111,現金,旅費,1476,0,20786290
12455,0001-20091214-23-1932-1-4325,6,2009-12-14,111,現金,旅費,1833,0,20788123
12458,0001-20091214-46-1933-1-4327,1,2009-12-14,111,現金,ガソリン代,371,0,20788494
12461,0001-20091214-46-1933-1-4327,4,2009-12-14,111,現金,駐車代,61,0,20788555
12463,0001-20091214-46-1933-1-4327,6,2009-12-14,111,現金,高速代,166,0,20788721
12466,0001-20091214-51-1934-1-4329,1,2009-12-14,111,現金,高速代,254,0,20788975
12469,0001-20091214-51-1934-1-4329,4,2009-12-14,111,現金,ガソリン代,319,0,20789294
12471,0001-20091214-51-1934-1-4329,6,2009-12-14,111,現金,駐車代,109,0,20789403
12474,0001-20091214-73-1935-1-4331,1,2009-12-14,111,現金,忘年会会費,380,0,20789783
12482,0001-20091215-104-1939-1-4339,3,2009-12-15,152,売掛金,09年12月15日伝票No387五越株式会社,40,0,20789823
12490,0001-20091215-105-1940-1-4341,3,2009-12-15,152,売掛金,09年12月15日伝票No388株式会社　エントリー,40,0,20789863
12498,0001-20091215-106-1941-1-4343,3,2009-12-15,152,売掛金,09年12月15日伝票No389タワー株式会社,40,0,20789903
12506,0001-20091215-107-1942-1-4345,3,2009-12-15,152,売掛金,09年12月15日伝票No390高橋物産株式会社,40,0,20789943
12519,0001-20091215-109-1944-1-4349,3,2009-12-15,152,売掛金,09年12月15日伝票No392株式会社　久城商事,15,0,20789958
12536,0001-20091215-4-1936-1-4333,1,2009-12-15,322,未払金,広告費,1500,0,20791458
12540,0001-20091215-83-1937-1-4335,1,2009-12-15,111,現金,ガソリン代,311,0,20791769
12543,0001-20091215-83-1937-1-4335,4,2009-12-15,111,現金,高速代,200,0,20791969
12545,0001-20091215-83-1937-1-4335,6,2009-12-15,111,現金,駐車代,40,0,20792009
12557,0001-20091216-136-1951-1-4363,1,2009-12-16,111,現金,ダスキン代,785,0,20792794
12561,0001-20091216-144-1952-1-4365,1,2009-12-16,111,現金,ウォッシャー液代,28,0,20792822
12564,0001-20091216-144-1952-1-4365,4,2009-12-16,111,現金,ガソリン代,311,0,20793133
12566,0001-20091216-144-1952-1-4365,6,2009-12-16,111,現金,ガソリン代,404,0,20793537
12569,0001-20091216-149-1953-1-4367,1,2009-12-16,111,現金,忘年会会費,476,0,20794013
12573,0001-20091216-152-1954-1-4369,1,2009-12-16,111,現金,忘年会会費,476,0,20794489
12577,0001-20091216-156-1955-1-4371,1,2009-12-16,111,現金,出張旅費,409,0,20794898
12581,0001-20091216-57-1948-1-4357,1,2009-12-16,111,現金,JR代,5269,0,20800167
12585,0001-20091216-61-1949-1-4359,1,2009-12-16,131,普通預金,電話代,6747,0,20806914
12591,0001-20091216-74-1950-1-4361,1,2009-12-16,111,現金,忘年会会費,476,0,20807390
12595,0001-20091217-12-1956-1-4373,1,2009-12-17,111,現金,ガソリン代,373,0,20807763
12598,0001-20091217-12-1956-1-4373,4,2009-12-17,111,現金,ガソリン代,142,0,20807905
12600,0001-20091217-12-1956-1-4373,6,2009-12-17,111,現金,ガソリン代,308,0,20808213
12602,0001-20091217-12-1956-1-4373,8,2009-12-17,111,現金,高速代,100,0,20808313
12605,0001-20091217-164-1960-1-4381,1,2009-12-17,111,現金,事務用品,569,0,20808882
12609,0001-20091217-32-1957-1-4375,1,2009-12-17,322,未払金,事務用品費,67,0,20808949
12613,0001-20091217-45-1958-1-4377,1,2009-12-17,111,現金,忘年会会費2名,952,0,20809901
12617,0001-20091217-52-1959-1-4379,1,2009-12-17,111,現金,高速代,54,0,20809955
12620,0001-20091217-52-1959-1-4379,4,2009-12-17,111,現金,高速代,54,0,20810009
12622,0001-20091217-52-1959-1-4379,6,2009-12-17,111,現金,高速代,71,0,20810080
12625,0001-20091218-104-1963-1-4387,1,2009-12-18,111,現金,忘年会会費,380,0,20810460
12629,0001-20091218-153-1964-1-4389,1,2009-12-18,111,現金,忘年会会費,380,0,20810840
12633,0001-20091218-8-1961-1-4383,1,2009-12-18,111,現金,定例ミーティング会費,952,0,20811792
12637,0001-20091218-86-1962-1-4385,1,2009-12-18,111,現金,切手代,761,0,20812553
12641,0001-20091219-148-1969-1-4399,1,2009-12-19,111,現金,ガソリン代,251,0,20812804
12645,0001-20091219-47-1966-1-4393,1,2009-12-19,111,現金,ガソリン代,120,0,20812924
12649,0001-20091219-59-1967-1-4395,1,2009-12-19,111,現金,旅費,2380,0,20815304
12653,0001-20091219-6-1965-1-4391,1,2009-12-19,111,現金,広告料,238,0,20815542
12657,0001-20091219-89-1968-1-4397,1,2009-12-19,111,現金,旅費,952,0,20816494
12668,0001-20091220-101-1981-1-4423,1,2009-12-20,322,未払金,広告料,2500,0,20818994
12672,0001-20091220-105-1982-1-4425,1,2009-12-20,111,現金,忘年会会費,476,0,20819470
12675,0001-20091220-105-1982-1-4425,4,2009-12-20,111,現金,景品代　阿部商店,500,0,20819970
12685,0001-20091220-112-1984-1-4429,3,2009-12-20,152,売掛金,09年12月20日伝票No394合同会社　たかだ,22,0,20819992
12693,0001-20091220-113-1985-1-4431,3,2009-12-20,152,売掛金,09年12月20日伝票No395株式会社　ＹＡＧ,35,0,20820027
12712,0001-20091220-118-1989-1-4439,1,2009-12-20,322,未払金,コピー代,391,0,20820418
12716,0001-20091220-135-1990-1-4441,1,2009-12-20,322,未払金,事務用品,225,0,20820643
12734,0001-20091220-24-1970-1-4401,1,2009-12-20,111,現金,JR回数券,3934,0,20824577
12738,0001-20091220-31-1971-1-4403,1,2009-12-20,322,未払金,コピー代,156,0,20824733
12742,0001-20091220-48-1972-1-4405,1,2009-12-20,111,現金,ガソリン代,204,0,20824937
12746,0001-20091220-71-1973-1-4407,1,2009-12-20,322,未払金,カウンター料金,1749,0,20826686
12750,0001-20091220-73-1974-1-4409,1,2009-12-20,322,未払金,有線,238,0,20826924
12754,0001-20091220-75-1975-1-4411,1,2009-12-20,111,現金,ガソリン代,142,0,20827066
12757,0001-20091220-75-1975-1-4411,4,2009-12-20,111,現金,駐車代,14,0,20827080
12759,0001-20091220-75-1975-1-4411,6,2009-12-20,111,現金,駐車代,19,0,20827099
12762,0001-20091220-76-1976-1-4413,1,2009-12-20,322,未払金,カウンター料金,300,0,20827399
12766,0001-20091220-80-1977-1-4415,1,2009-12-20,322,未払金,会費支払い,19875,0,20847274
12769,0001-20091220-80-1977-1-4415,4,2009-12-20,322,未払金,ファイル等,465,0,20847739
12772,0001-20091220-80-1977-1-4415,7,2009-12-20,322,未払金,飲料水,10508,0,20858247
12774,0001-20091220-80-1977-1-4415,9,2009-12-20,322,未払金,名刺代,470,0,20858717
12777,0001-20091220-97-1978-1-4417,1,2009-12-20,322,未払金,コピー代,1867,0,20860584
12781,0001-20091220-98-1979-1-4419,1,2009-12-20,322,未払金,事務用品,478,0,20861062
12785,0001-20091221-114-2001-1-4463,1,2009-12-21,111,現金,新聞代,126,0,20861188
12788,0001-20091221-114-2001-1-4463,4,2009-12-21,111,現金,新聞代,143,0,20861331
12794,0001-20091221-132-2003-1-4467,1,2009-12-21,131,普通預金,電気代,6979,0,20868310
12799,0001-20091221-132-2003-1-4467,4,2009-12-21,131,普通預金,水道代,386,0,20868696
12802,0001-20091221-169-2004-1-4469,1,2009-12-21,131,普通預金,電気料,6426,0,20875122
12807,0001-20091221-169-2004-1-4469,4,2009-12-21,131,普通預金,水道料,360,0,20875482
12810,0001-20091221-25-1995-1-4451,1,2009-12-21,111,現金,旅費,2666,0,20878148
12814,0001-20091221-3-1994-1-4449,1,2009-12-21,322,未払金,宿泊代,1434,0,20879582
12818,0001-20091221-34-1996-1-4453,1,2009-12-21,131,普通預金,電気代,4736,0,20884318
12823,0001-20091221-34-1996-1-4453,4,2009-12-21,131,普通預金,水道代,192,0,20884510
12826,0001-20091221-64-1997-1-4455,1,2009-12-21,131,普通預金,電気料,10787,0,20895297
12831,0001-20091221-64-1997-1-4455,4,2009-12-21,131,普通預金,水道料,454,0,20895751
12834,0001-20091221-75-1998-1-4457,1,2009-12-21,111,現金,忘年会会費,380,0,20896131
12838,0001-20091221-89-1999-1-4459,1,2009-12-21,131,普通預金,電気料,5534,0,20901665
12843,0001-20091221-89-1999-1-4459,4,2009-12-21,131,普通預金,水道料,236,0,20901901
12845,0001-20091221-89-1999-1-4459,6,2009-12-21,131,普通預金,ガス代,249,0,20902150
12848,0001-20091221-94-2000-1-4461,1,2009-12-21,111,現金,しめ飾り他,256,0,20902406
12852,0001-20091222-107-2013-1-4487,1,2009-12-22,111,現金,忘年会会費3名,1142,0,20903548
12861,0001-20091222-151-2015-1-4491,1,2009-12-22,111,現金,忘年会会費3名,1428,0,20904976
12865,0001-20091222-166-2016-1-4493,1,2009-12-22,111,現金,ダスキン代,90,0,20905066
12869,0001-20091222-170-2017-1-4495,1,2009-12-22,111,現金,新聞代,143,0,20905209
12873,0001-20091222-35-2005-1-4471,1,2009-12-22,111,現金,新聞代,186,0,20905395
12877,0001-20091222-53-2006-1-4473,1,2009-12-22,111,現金,高速代,19,0,20905414
12880,0001-20091222-53-2006-1-4473,4,2009-12-22,111,現金,駐車代,88,0,20905502
12883,0001-20091222-72-2007-1-4475,1,2009-12-22,111,現金,新聞代,143,0,20905645
12886,0001-20091222-72-2007-1-4475,4,2009-12-22,111,現金,新聞代,140,0,20905785
12888,0001-20091222-72-2007-1-4475,6,2009-12-22,111,現金,新聞代,169,0,20905954
12890,0001-20091222-72-2007-1-4475,8,2009-12-22,111,現金,しめ飾り、鏡もち他,429,0,20906383
12894,0001-20091222-74-2008-1-4477,1,2009-12-22,111,現金,しめ飾り他,223,0,20906606
12898,0001-20091222-84-2009-1-4479,1,2009-12-22,111,現金,ガソリン代,325,0,20906931
12902,0001-20091222-88-2010-1-4481,1,2009-12-22,111,現金,新聞代,169,0,20907100
12906,0001-20091222-90-2011-1-4483,1,2009-12-22,111,現金,ダスキン代,500,0,20907600
12910,0001-20091222-95-2012-1-4485,1,2009-12-22,322,未払金,清掃料,3413,0,20911013
12914,0001-20091223-140-2022-1-4505,1,2009-12-23,111,現金,旅費,470,0,20911483
12918,0001-20091223-26-2018-1-4497,1,2009-12-23,111,現金,旅費,1190,0,20912673
12922,0001-20091223-28-2019-1-4499,1,2009-12-23,322,未払金,タクシー代,115,0,20912788
12926,0001-20091223-64-2020-1-4501,1,2009-12-23,322,未払金,お茶代,890,0,20913678
12930,0001-20091223-71-2021-1-4503,1,2009-12-23,111,現金,しめ飾り他,228,0,20913906
12934,0001-20091224-120-2027-1-4515,1,2009-12-24,322,未払金,業務委託費,35000,0,20948906
12938,0001-20091224-146-2028-1-4517,1,2009-12-24,322,未払金,業務委託費,8000,0,20956906
12942,0001-20091224-154-2029-1-4519,1,2009-12-24,322,未払金,忘年会会費2名,571,0,20957477
12945,0001-20091224-154-2029-1-4519,4,2009-12-24,322,未払金,飲食代　スナックみわ,1520,0,20958997
12948,0001-20091224-38-2023-1-4507,1,2009-12-24,322,未払金,宿泊費,2808,0,20961805
12952,0001-20091224-54-2024-1-4509,1,2009-12-24,111,現金,高速代,90,0,20961895
12955,0001-20091224-54-2024-1-4509,4,2009-12-24,111,現金,ガソリン代,128,0,20962023
12958,0001-20091224-78-2025-1-4511,1,2009-12-24,322,未払金,業務委託費支払い,9000,0,20971023
12962,0001-20091224-87-2026-1-4513,1,2009-12-24,131,普通預金,携帯代,3293,0,20974316
12968,0001-20091225-111-2036-1-4533,1,2009-12-25,322,未払金,タクシー代,714,0,20975030
12979,0001-20091225-118-2038-1-4537,3,2009-12-25,152,売掛金,09年12月25日伝票No397株式会社　総合経営,35,0,20975065
12987,0001-20091225-119-2039-1-4539,3,2009-12-25,152,売掛金,09年12月25日伝票No398株式会社　鎌田商店,30,0,20975095
12995,0001-20091225-120-2040-1-4541,3,2009-12-25,152,売掛金,09年12月25日伝票No399株式会社　小林マーケット,40,0,20975135
12999,0001-20091225-121-2041-1-4543,1,2009-12-25,111,現金,お茶代,859,0,20975994
13003,0001-20091225-139-2042-1-4545,1,2009-12-25,322,未払金,社員夜食代,3240,0,20979234
13007,0001-20091225-160-2043-1-4547,1,2009-12-25,111,現金,出張旅費,3476,0,20982710
13011,0001-20091225-172-2044-1-4549,1,2009-12-25,322,未払金,業務委託費支払い,10238,0,20992948
13015,0001-20091225-29-2030-1-4521,1,2009-12-25,131,普通預金,携帯電話代,2369,0,20995317
13021,0001-20091225-37-2031-1-4523,1,2009-12-25,322,未払金,業務委託費,88047,0,21083364
13025,0001-20091225-79-2032-1-4525,1,2009-12-25,111,現金,景品代,3618,0,21086982
13029,0001-20091225-90-2033-1-4527,1,2009-12-25,111,現金,旅費,714,0,21087696
13214,0001-20091226-113-2049-1-4559,1,2009-12-26,131,普通預金,携帯代,4313,0,21092009
13220,0001-20091226-165-2050-1-4561,1,2009-12-26,111,現金,しめ飾り代他,238,0,21092247
13223,0001-20091226-165-2050-1-4561,4,2009-12-26,111,現金,洗剤他,57,0,21092304
13226,0001-20091226-39-2045-1-4551,1,2009-12-26,111,現金,会費,428,0,21092732
13230,0001-20091226-49-2046-1-4553,1,2009-12-26,111,現金,ガソリン代,5857,0,21098589
13233,0001-20091226-49-2046-1-4553,4,2009-12-26,111,現金,駐車代,130,0,21098719
13236,0001-20091226-49-2046-1-4553,7,2009-12-26,111,現金,高速代,59,0,21098778
13239,0001-20091226-62-2047-1-4555,1,2009-12-26,131,普通預金,携帯代,4455,0,21103233
13245,0001-20091226-81-2048-1-4557,1,2009-12-26,322,未払金,お茶代,1263,0,21104496
13249,0001-20091227-13-2051-1-4563,1,2009-12-27,111,現金,ガソリン代,619,0,21105115
13253,0001-20091227-14-2052-1-4565,1,2009-12-27,111,現金,洗車代,142,0,21105257
13257,0001-20091227-148-2054-1-4569,1,2009-12-27,111,現金,ガソリン代,271,0,21105528
13260,0001-20091227-148-2054-1-4569,4,2009-12-27,111,現金,洗車代,50,0,21105578
13263,0001-20091227-161-2055-1-4571,1,2009-12-27,111,現金,旅費,464,0,21106042
13267,0001-20091227-171-2056-1-4573,1,2009-12-27,131,普通預金,携帯代,4593,0,21110635
13278,0001-20091228-1-2057-1-4575,1,2009-12-28,322,未払金,運賃　佐川急便,27728,0,21138363
13282,0001-20091228-108-2067-1-4595,1,2009-12-28,111,現金,食事代　そば屋三品3名,107,0,21138470
13286,0001-20091228-145-2068-1-4597,1,2009-12-28,322,未払金,運賃,15485,0,21153955
13290,0001-20091228-27-2059-1-4579,1,2009-12-28,111,現金,旅費,1333,0,21155288
13293,0001-20091228-27-2059-1-4579,4,2009-12-28,111,現金,旅費,1476,0,21156764
13295,0001-20091228-27-2059-1-4579,6,2009-12-28,111,現金,旅費,1071,0,21157835
13298,0001-20091228-36-2060-1-4581,1,2009-12-28,322,未払金,運賃　ヤマト運輸,136861,0,21294696
13301,0001-20091228-36-2060-1-4581,4,2009-12-28,322,未払金,運賃　佐川急便,83473,0,21378169
13304,0001-20091228-40-2061-1-4583,1,2009-12-28,322,未払金,広告掲載,2380,0,21380549
13308,0001-20091228-5-2058-1-4577,1,2009-12-28,131,普通預金,広告費,2500,0,21383049
13314,0001-20091228-55-2062-1-4585,1,2009-12-28,111,現金,車両管理費,571,0,21383620
13321,0001-20091228-77-2064-1-4589,1,2009-12-28,322,未払金,運賃,16730,0,21400350
13325,0001-20091228-83-2065-1-4591,1,2009-12-28,111,現金,車両管理費,2438,0,21402788
13328,0001-20091228-83-2065-1-4591,4,2009-12-28,111,現金,ガソリン代,928,0,21403716
13331,0001-20091228-99-2066-1-4593,1,2009-12-28,322,未払金,運賃,78367,0,21482083
13351,0001-20091230-100-2072-1-4605,1,2009-12-30,111,現金,会費,285,0,21482368
13355,0001-20091230-109-2073-1-4607,1,2009-12-30,322,未払金,ガソリン代,2937,0,21485305
13367,0001-20091230-137-2076-1-4613,1,2009-12-30,322,未払金,有線,300,0,21485605
13370,0001-20091230-137-2076-1-4613,4,2009-12-30,322,未払金,警備料,2142,0,21487747
13372,0001-20091230-137-2076-1-4613,6,2009-12-30,131,普通預金,高速料,2538,0,21490285
13377,0001-20091230-137-2076-1-4613,9,2009-12-30,322,未払金,清掃料,3500,0,21493785
13381,0001-20091230-138-2077-1-4615,1,2009-12-30,111,現金,駐車場代,170,0,21493955
13384,0001-20091230-138-2077-1-4615,4,2009-12-30,111,現金,高速代,126,0,21494081
13386,0001-20091230-138-2077-1-4615,6,2009-12-30,111,現金,高速代,183,0,21494264
13388,0001-20091230-138-2077-1-4615,8,2009-12-30,111,現金,高速代,54,0,21494318
13390,0001-20091230-138-2077-1-4615,10,2009-12-30,111,現金,高速代,150,0,21494468
13392,0001-20091230-138-2077-1-4615,12,2009-12-30,111,現金,高速代,54,0,21494522
13394,0001-20091230-138-2077-1-4615,14,2009-12-30,111,現金,ガソリン代,190,0,21494712
13397,0001-20091230-155-2078-1-4617,1,2009-12-30,111,現金,車両管理費,1190,0,21495902
13401,0001-20091230-70-2070-1-4601,1,2009-12-30,322,未払金,有線,300,0,21496202
13404,0001-20091230-70-2070-1-4601,4,2009-12-30,322,未払金,警備料,2619,0,21498821
13406,0001-20091230-70-2070-1-4601,6,2009-12-30,131,普通預金,高速料,2552,0,21501373
13411,0001-20091230-70-2070-1-4601,9,2009-12-30,322,未払金,清掃料,3500,0,21504873
13415,0001-20091230-96-2071-1-4603,1,2009-12-30,131,普通預金,警備料,1070,0,21505943
13520,0001-20091231-126-2090-1-4641,3,2009-12-31,152,売掛金,09年12月31日伝票No400マークマーケット,40,0,21505983
13528,0001-20091231-127-2091-1-4643,3,2009-12-31,152,売掛金,09年12月31日伝票No401株式会社　ＡＢＣ,40,0,21506023
13542,0001-20091231-130-2094-1-4649,3,2009-12-31,152,売掛金,09年12月31日伝票No404株式会社　畠山商事,30,0,21506053
13550,0001-20091231-131-2095-1-4651,3,2009-12-31,152,売掛金,09年12月31日伝票No405株式会社　千代サービス,10,0,21506063
13554,0001-20091231-132-2096-1-4653,1,2009-12-31,312,買掛金,09年12月1日～09年12月31日分仕入,4896,0,21510959
13557,0001-20091231-132-2096-1-4653,4,2009-12-31,312,買掛金,09年12月1日～09年12月31日分仕入,17299,0,21528258
13561,0001-20091231-133-2097-1-4655,1,2009-12-31,312,買掛金,09年12月1日～09年12月31日分仕入,217617,0,21745875
13564,0001-20091231-133-2097-1-4655,4,2009-12-31,312,買掛金,09年12月1日～09年12月31日分仕入,239567,0,21985442
13567,0001-20091231-133-2097-1-4655,7,2009-12-31,312,買掛金,09年12月1日～09年12月31日分仕入,98539,0,22083981
13570,0001-20091231-133-2097-1-4655,10,2009-12-31,312,買掛金,09年12月1日～09年12月31日分仕入,515329,0,22599310
13573,0001-20091231-133-2097-1-4655,13,2009-12-31,312,買掛金,09年12月1日～09年12月31日分仕入,398937,0,22998247
13576,0001-20091231-133-2097-1-4655,16,2009-12-31,312,買掛金,09年12月1日～09年12月31日分仕入,51681,0,23049928
13579,0001-20091231-133-2097-1-4655,19,2009-12-31,312,買掛金,09年12月1日～09年12月31日分仕入,31378,0,23081306
13582,0001-20091231-133-2097-1-4655,22,2009-12-31,312,買掛金,09年12月1日～09年12月31日分仕入,11995,0,23093301
13586,0001-20091231-134-2098-1-4657,1,2009-12-31,312,買掛金,09年12月1日～09年12月31日分仕入,137927,0,23231228
13589,0001-20091231-134-2098-1-4657,4,2009-12-31,312,買掛金,09年12月1日～09年12月31日分仕入,87633,0,23318861
13592,0001-20091231-134-2098-1-4657,7,2009-12-31,312,買掛金,09年12月1日～09年12月31日分仕入,329589,0,23648450
13595,0001-20091231-134-2098-1-4657,10,2009-12-31,312,買掛金,09年12月1日～09年12月31日分仕入,8756,0,23657206
13598,0001-20091231-134-2098-1-4657,13,2009-12-31,312,買掛金,09年12月1日～09年12月31日分仕入,1224,0,23658430
13602,0001-20091231-135-2099-1-4659,1,2009-12-31,312,買掛金,09年12月1日～09年12月31日分仕入,300066,0,23958496
13605,0001-20091231-135-2099-1-4659,4,2009-12-31,312,買掛金,09年12月1日～09年12月31日分仕入,71556,0,24030052
13608,0001-20091231-135-2099-1-4659,7,2009-12-31,312,買掛金,09年12月1日～09年12月31日分仕入,276081,0,24306133
13611,0001-20091231-135-2099-1-4659,10,2009-12-31,312,買掛金,09年12月1日～09年12月31日分仕入,328204,0,24634337
13614,0001-20091231-135-2099-1-4659,13,2009-12-31,312,買掛金,09年12月1日～09年12月31日分仕入,4896,0,24639233
13617,0001-20091231-135-2099-1-4659,16,2009-12-31,312,買掛金,09年12月1日～09年12月31日分仕入,8756,0,24647989
13621,0001-20091231-136-2100-1-4661,1,2009-12-31,312,買掛金,09年12月1日～09年12月31日分仕入,3672,0,24651661
13624,0001-20091231-136-2100-1-4661,4,2009-12-31,312,買掛金,09年12月1日～09年12月31日分仕入,3844,0,24655505
,,,2009-12,,※※月計※※,,4135221,0,
13745,0001-20100101-18-2114-1-4689,1,2010-01-01,111,現金,旅費,928,0,24656433
13749,0001-20100102-19-2115-1-4691,1,2010-01-02,111,現金,旅費,523,0,24656956
13753,0001-20100103-134-2116-1-4693,1,2010-01-03,322,未払金,用紙,400,0,24657356
13757,0001-20100104-116-2118-1-4697,1,2010-01-04,131,普通預金,リース料,4000,0,24661356
13763,0001-20100104-66-2117-1-4695,1,2010-01-04,131,普通預金,リース料,9992,0,24671348
13769,0001-20100105-143-2122-1-4705,1,2010-01-05,111,現金,点検作業料,1485,0,24672833
13777,0001-20100105-86-2119-1-4699,3,2010-01-05,152,売掛金,10年1月5日伝票No406株式会社　渡辺産業,22,0,24672855
13785,0001-20100105-87-2120-1-4701,3,2010-01-05,152,売掛金,10年1月5日伝票No407佐々木販売株式会社,22,0,24672877
13794,0001-20100106-110-2123-1-4707,1,2010-01-06,111,現金,タクシー代,109,0,24672986
13798,0001-20100106-123-2124-1-4709,1,2010-01-06,111,現金,切手代,380,0,24673366
13805,0001-20100107-102-2130-1-4721,1,2010-01-07,111,現金,差し入れ,50,0,24673416
13809,0001-20100107-106-2131-1-4723,1,2010-01-07,111,現金,新年会会費2名,952,0,24674368
13813,0001-20100107-133-2132-1-4725,1,2010-01-07,131,普通預金,税理士報酬,6652,0,24681020
13819,0001-20100107-20-2127-1-4715,1,2010-01-07,111,現金,旅費,1857,0,24682877
13823,0001-20100107-21-2128-1-4717,1,2010-01-07,111,現金,JR代,3309,0,24686186
13827,0001-20100107-22-2129-1-4719,1,2010-01-07,111,現金,旅費,2380,0,24688566
13831,0001-20100107-7-2126-1-4713,1,2010-01-07,111,現金,新年会会費　エイム,476,0,24689042
13835,0001-20100108-150-2137-1-4735,1,2010-01-08,111,現金,新年会会費2名,761,0,24689803
13839,0001-20100108-45-2133-1-4727,1,2010-01-08,111,現金,新年会会費,571,0,24690374
13843,0001-20100108-50-2134-1-4729,1,2010-01-08,111,現金,高速代,57,0,24690431
13847,0001-20100108-75-2135-1-4731,1,2010-01-08,111,現金,飲食代　スナックランディ,1260,0,24691691
13851,0001-20100108-79-2136-1-4733,1,2010-01-08,111,現金,景品代,1884,0,24693575
13855,0001-20100109-112-2139-1-4739,1,2010-01-09,131,普通預金,電話代,8145,0,24701720
13861,0001-20100109-85-2138-1-4737,1,2010-01-09,131,普通預金,電話代,5075,0,24706795
13872,0001-20100110-142-2155-1-4771,1,2010-01-10,111,現金,高速代,169,0,24706964
13875,0001-20100110-142-2155-1-4771,4,2010-01-10,111,現金,駐車代,267,0,24707231
13877,0001-20100110-142-2155-1-4771,6,2010-01-10,111,現金,高速代,111,0,24707342
13879,0001-20100110-142-2155-1-4771,8,2010-01-10,111,現金,高速代,215,0,24707557
13881,0001-20100110-142-2155-1-4771,10,2010-01-10,111,現金,高速代,21,0,24707578
13884,0001-20100110-149-2156-1-4773,1,2010-01-10,111,現金,新年会会費,571,0,24708149
13888,0001-20100110-152-2157-1-4775,1,2010-01-10,111,現金,新年会会費,476,0,24708625
13892,0001-20100110-159-2158-1-4777,1,2010-01-10,111,現金,タクシー代,200,0,24708825
13896,0001-20100110-16-2140-1-4741,1,2010-01-10,111,現金,高速代,19,0,24708844
13899,0001-20100110-16-2140-1-4741,4,2010-01-10,111,現金,駐車代,38,0,24708882
13902,0001-20100110-162-2159-1-4779,1,2010-01-10,111,現金,会議　食事代,1190,0,24710072
13906,0001-20100110-168-2160-1-4781,1,2010-01-10,322,未払金,有線,300,0,24710372
13909,0001-20100110-168-2160-1-4781,4,2010-01-10,322,未払金,警備料,2142,0,24712514
13912,0001-20100110-42-2141-1-4743,1,2010-01-10,111,現金,年始挨拶手土産品　五越百貨店,1155,0,24713669
13916,0001-20100110-44-2142-1-4745,1,2010-01-10,111,現金,新年会会費,571,0,24714240
13920,0001-20100110-56-2143-1-4747,1,2010-01-10,111,現金,旅費,942,0,24715182
13939,0001-20100110-67-2146-1-4753,1,2010-01-10,322,未払金,有線,250,0,24715432
13942,0001-20100110-67-2146-1-4753,4,2010-01-10,322,未払金,警備料,1714,0,24717146
13945,0001-20100110-71-2147-1-4755,1,2010-01-10,111,現金,お茶他,150,0,24717296
13956,0001-20100110-90-2149-1-4759,3,2010-01-10,152,売掛金,10年1月10日伝票No410株式会社　藤田東京本社,35,0,24717331
13964,0001-20100110-91-2150-1-4761,3,2010-01-10,152,売掛金,10年1月10日伝票No411株式会社　ミナミ,35,0,24717366
13979,0001-20100111-129-2167-1-4795,1,2010-01-11,131,普通預金,家賃支払い,19000,0,24736366
13985,0001-20100111-147-2168-1-4797,1,2010-01-11,322,未払金,ガソリン代,313,0,24736679
13989,0001-20100111-167-2169-1-4799,1,2010-01-11,131,普通預金,家賃支払い,30000,0,24766679
13994,0001-20100111-167-2169-1-4799,4,2010-01-11,131,普通預金,電話代,5788,0,24772467
14000,0001-20100111-33-2161-1-4783,1,2010-01-11,131,普通預金,家賃支払い,15238,0,24787705
14005,0001-20100111-33-2161-1-4783,4,2010-01-11,131,普通預金,電話代,8427,0,24796132
14011,0001-20100111-65-2162-1-4785,1,2010-01-11,131,普通預金,家賃支払,60000,0,24856132
14017,0001-20100111-66-2163-1-4787,1,2010-01-11,131,普通預金,家賃支払,40000,0,24896132
14023,0001-20100111-73-2164-1-4789,1,2010-01-11,111,現金,新年会会費2名,761,0,24896893
14027,0001-20100111-76-2165-1-4791,1,2010-01-11,322,未払金,社員食事代,1376,0,24898269
14031,0001-20100111-94-2166-1-4793,1,2010-01-11,111,現金,お茶代他,96,0,24898365
14035,0001-20100112-151-2173-1-4807,1,2010-01-12,111,現金,飲食代　居酒屋佐助4名,887,0,24899252
14039,0001-20100112-153-2174-1-4809,1,2010-01-12,111,現金,新年会会費2名,761,0,24900013
14043,0001-20100112-43-2171-1-4803,1,2010-01-12,111,現金,コーヒー代3名,75,0,24900088
14047,0001-20100112-57-2172-1-4805,1,2010-01-12,111,現金,JR代,5031,0,24905119
14051,0001-20100112-9-2170-1-4801,1,2010-01-12,111,現金,新年会会費　たかだ,333,0,24905452
14055,0001-20100113-11-2175-1-4811,1,2010-01-13,111,現金,ガソリン代,152,0,24905604
14059,0001-20100113-17-2176-1-4813,1,2010-01-13,111,現金,駐車代,14,0,24905618
14062,0001-20100113-17-2176-1-4813,4,2010-01-13,111,現金,駐車代,38,0,24905656
14065,0001-20100114-23-2177-1-4815,1,2010-01-14,111,現金,旅費,1333,0,24906989
14068,0001-20100114-23-2177-1-4815,4,2010-01-14,111,現金,旅費,1476,0,24908465
14070,0001-20100114-23-2177-1-4815,6,2010-01-14,111,現金,旅費,1833,0,24910298
14073,0001-20100114-46-2178-1-4817,1,2010-01-14,111,現金,ガソリン代,117,0,24910415
14076,0001-20100114-46-2178-1-4817,4,2010-01-14,111,現金,ガソリン代,238,0,24910653
14078,0001-20100114-46-2178-1-4817,6,2010-01-14,111,現金,ガソリン代,244,0,24910897
14081,0001-20100114-51-2179-1-4819,1,2010-01-14,111,現金,高速代,75,0,24910972
14084,0001-20100114-51-2179-1-4819,4,2010-01-14,111,現金,高速代,30,0,24911002
14086,0001-20100114-51-2179-1-4819,6,2010-01-14,111,現金,高速代,40,0,24911042
14088,0001-20100114-51-2179-1-4819,8,2010-01-14,111,現金,高速代,54,0,24911096
14090,0001-20100114-51-2179-1-4819,10,2010-01-14,111,現金,高速代,54,0,24911150
14092,0001-20100114-51-2179-1-4819,12,2010-01-14,111,現金,高速代,54,0,24911204
14094,0001-20100114-51-2179-1-4819,14,2010-01-14,111,現金,高速代,47,0,24911251
14097,0001-20100114-61-2180-1-4821,1,2010-01-14,131,普通預金,電話代,5792,0,24917043
14107,0001-20100115-100-2190-1-4841,3,2010-01-15,152,売掛金,10年1月15日伝票No418株式会社　久城商事,15,0,24917058
14116,0001-20100115-103-2192-1-4845,1,2010-01-15,111,現金,コーヒー代2名,60,0,24917118
14120,0001-20100115-109-2193-1-4847,1,2010-01-15,322,未払金,ガソリン代,2400,0,24919518
14129,0001-20100115-156-2195-1-4851,1,2010-01-15,111,現金,出張旅費,366,0,24919884
14133,0001-20100115-165-2196-1-4853,1,2010-01-15,111,現金,電池代他,47,0,24919931
14137,0001-20100115-4-2181-1-4823,1,2010-01-15,322,未払金,広告費,1500,0,24921431
14141,0001-20100115-58-2182-1-4825,1,2010-01-15,111,現金,旅費,4095,0,24925526
14145,0001-20100115-81-2183-1-4827,1,2010-01-15,111,現金,ＪＲ代,571,0,24926097
14162,0001-20100115-95-2185-1-4831,3,2010-01-15,152,売掛金,10年1月15日伝票No413五越株式会社,40,0,24926137
14170,0001-20100115-96-2186-1-4833,3,2010-01-15,152,売掛金,10年1月15日伝票No414株式会社　エントリー,40,0,24926177
14178,0001-20100115-97-2187-1-4835,3,2010-01-15,152,売掛金,10年1月15日伝票No415タワー株式会社,40,0,24926217
14186,0001-20100115-98-2188-1-4837,3,2010-01-15,152,売掛金,10年1月15日伝票No416高橋物産株式会社,40,0,24926257
14198,0001-20100116-136-2200-1-4861,1,2010-01-16,111,現金,ダスキン代,785,0,24927042
14202,0001-20100116-157-2201-1-4863,1,2010-01-16,131,普通預金,航空券代,1842,0,24928884
14208,0001-20100116-73-2197-1-4855,1,2010-01-16,111,現金,ゴルフプレー代2名,1333,0,24930217
14212,0001-20100116-74-2198-1-4857,1,2010-01-16,111,現金,新年会会費,476,0,24930693
14216,0001-20100117-104-2204-1-4869,1,2010-01-17,111,現金,手土産代　阿部商店,100,0,24930793
14220,0001-20100117-47-2202-1-4865,1,2010-01-17,111,現金,ガソリン代,120,0,24930913
14224,0001-20100117-52-2203-1-4867,1,2010-01-17,111,現金,高速代,54,0,24930967
14227,0001-20100117-52-2203-1-4867,4,2010-01-17,111,現金,高速代,54,0,24931021
14229,0001-20100117-52-2203-1-4867,6,2010-01-17,111,現金,高速代,71,0,24931092
14232,0001-20100118-148-2207-1-4875,1,2010-01-18,111,現金,ガソリン代,330,0,24931422
14235,0001-20100118-148-2207-1-4875,4,2010-01-18,111,現金,高速代,30,0,24931452
14238,0001-20100118-68-2205-1-4871,1,2010-01-18,111,現金,飲食代　居酒屋田舎3名,556,0,24932008
14242,0001-20100118-82-2206-1-4873,1,2010-01-18,111,現金,タクシー代,238,0,24932246
14246,0001-20100119-105-2209-1-4879,1,2010-01-19,111,現金,飲食代　和食ダイニング彩6名,1168,0,24933414
14249,0001-20100119-105-2209-1-4879,4,2010-01-19,111,現金,飲食代　スナック北新地,1954,0,24935368
14251,0001-20100119-105-2209-1-4879,6,2010-01-19,111,現金,飲食代　スナック寺地,1066,0,24936434
14254,0001-20100119-69-2208-1-4877,1,2010-01-19,111,現金,お茶代他,130,0,24936564
14258,0001-20100120-101-2226-1-4913,1,2010-01-20,322,未払金,広告料,2500,0,24939064
14269,0001-20100120-103-2228-1-4917,3,2010-01-20,152,売掛金,10年1月20日伝票No420合同会社　たかだ,22,0,24939086
14277,0001-20100120-104-2229-1-4919,3,2010-01-20,152,売掛金,10年1月20日伝票No421株式会社　ＹＡＧ,35,0,24939121
14294,0001-20100120-118-2233-1-4927,1,2010-01-20,322,未払金,コピー代,380,0,24939501
14298,0001-20100120-119-2234-1-4929,1,2010-01-20,322,未払金,事務用品,179,0,24939680
14302,0001-20100120-12-2211-1-4883,1,2010-01-20,111,現金,ガソリン代,238,0,24939918
14305,0001-20100120-12-2211-1-4883,4,2010-01-20,111,現金,ガソリン代,221,0,24940139
14308,0001-20100120-132-2235-1-4931,1,2010-01-20,131,普通預金,電気代,5303,0,24945442
14313,0001-20100120-132-2235-1-4931,4,2010-01-20,131,普通預金,水道代,294,0,24945736
14322,0001-20100120-144-2237-1-4935,1,2010-01-20,111,現金,ガソリン代,217,0,24945953
14325,0001-20100120-144-2237-1-4935,4,2010-01-20,111,現金,ガソリン代,358,0,24946311
14327,0001-20100120-144-2237-1-4935,6,2010-01-20,111,現金,ガソリン代,15,0,24946326
14330,0001-20100120-169-2238-1-4937,1,2010-01-20,131,普通預金,電気料,4726,0,24951052
14335,0001-20100120-169-2238-1-4937,4,2010-01-20,131,普通預金,水道料,304,0,24951356
14338,0001-20100120-24-2212-1-4885,1,2010-01-20,111,現金,JR回数券,3934,0,24955290
14342,0001-20100120-31-2213-1-4887,1,2010-01-20,322,未払金,コピー代,150,0,24955440
14346,0001-20100120-34-2214-1-4889,1,2010-01-20,131,普通預金,電気代,3459,0,24958899
14351,0001-20100120-34-2214-1-4889,4,2010-01-20,131,普通預金,水道代,186,0,24959085
14354,0001-20100120-48-2215-1-4891,1,2010-01-20,111,現金,ガソリン代,204,0,24959289
14358,0001-20100120-53-2216-1-4893,1,2010-01-20,111,現金,高速代,19,0,24959308
14361,0001-20100120-53-2216-1-4893,4,2010-01-20,111,現金,高速代,50,0,24959358
14363,0001-20100120-53-2216-1-4893,6,2010-01-20,111,現金,高速代,50,0,24959408
14366,0001-20100120-6-2210-1-4881,1,2010-01-20,111,現金,広告料,238,0,24959646
14370,0001-20100120-63-2217-1-4895,1,2010-01-20,322,未払金,お茶代,480,0,24960126
14374,0001-20100120-64-2218-1-4897,1,2010-01-20,131,普通預金,電気料,8445,0,24968571
14379,0001-20100120-64-2218-1-4897,4,2010-01-20,131,普通預金,水道料,387,0,24968958
14382,0001-20100120-70-2219-1-4899,1,2010-01-20,322,未払金,有線,238,0,24969196
14386,0001-20100120-71-2220-1-4901,1,2010-01-20,322,未払金,事務用品,175,0,24969371
14389,0001-20100120-71-2220-1-4901,4,2010-01-20,322,未払金,カウンター料金,1756,0,24971127
14392,0001-20100120-72-2221-1-4903,1,2010-01-20,322,未払金,カウンター料金,300,0,24971427
14396,0001-20100120-76-2222-1-4905,1,2010-01-20,322,未払金,ファイル等,507,0,24971934
14399,0001-20100120-76-2222-1-4905,4,2010-01-20,322,未払金,飲料水,11100,0,24983034
14401,0001-20100120-76-2222-1-4905,6,2010-01-20,322,未払金,名刺代,2190,0,24985224
14404,0001-20100120-89-2223-1-4907,1,2010-01-20,131,普通預金,電気料,4491,0,24989715
14409,0001-20100120-89-2223-1-4907,4,2010-01-20,131,普通預金,水道料,201,0,24989916
14411,0001-20100120-89-2223-1-4907,6,2010-01-20,131,普通預金,ガス代,225,0,24990141
14414,0001-20100120-97-2224-1-4909,1,2010-01-20,322,未払金,コピー代,1899,0,24992040
14418,0001-20100120-98-2225-1-4911,1,2010-01-20,322,未払金,事務用品,336,0,24992376
14425,0001-20100121-160-2244-1-4949,1,2010-01-21,111,現金,出張旅費,3333,0,24995709
14432,0001-20100121-25-2240-1-4941,1,2010-01-21,111,現金,旅費,2666,0,24998375
14436,0001-20100121-69-2241-1-4943,1,2010-01-21,111,現金,お茶代他,113,0,24998488
14440,0001-20100121-8-2239-1-4939,1,2010-01-21,111,現金,定例ミーティング会費,952,0,24999440
14444,0001-20100121-82-2242-1-4945,1,2010-01-21,322,未払金,ガソリン代,1015,0,25000455
14448,0001-20100122-138-2249-1-4959,1,2010-01-22,111,現金,駐車代,221,0,25000676
14451,0001-20100122-138-2249-1-4959,4,2010-01-22,111,現金,高速代,405,0,25001081
14453,0001-20100122-138-2249-1-4959,6,2010-01-22,111,現金,高速代,58,0,25001139
14455,0001-20100122-138-2249-1-4959,8,2010-01-22,111,現金,高速代,311,0,25001450
14457,0001-20100122-138-2249-1-4959,10,2010-01-22,111,現金,高速代,107,0,25001557
14459,0001-20100122-138-2249-1-4959,12,2010-01-22,111,現金,ガソリン代,452,0,25002009
14462,0001-20100122-161-2250-1-4961,1,2010-01-22,111,現金,旅費,345,0,25002354
14466,0001-20100122-166-2251-1-4963,1,2010-01-22,111,現金,ダスキン代,90,0,25002444
14470,0001-20100122-3-2246-1-4953,1,2010-01-22,322,未払金,宿泊代,1211,0,25003655
14474,0001-20100122-90-2247-1-4955,1,2010-01-22,111,現金,ダスキン代,500,0,25004155
14478,0001-20100122-95-2248-1-4957,1,2010-01-22,322,未払金,清掃料,3413,0,25007568
14482,0001-20100123-140-2255-1-4971,1,2010-01-23,111,現金,旅費,236,0,25007804
14486,0001-20100123-158-2256-1-4973,1,2010-01-23,111,現金,出張旅費,452,0,25008256
14490,0001-20100123-26-2252-1-4965,1,2010-01-23,111,現金,旅費,523,0,25008779
14494,0001-20100123-28-2253-1-4967,1,2010-01-23,322,未払金,タクシー代,115,0,25008894
14498,0001-20100123-54-2254-1-4969,1,2010-01-23,111,現金,高速代,90,0,25008984
14501,0001-20100123-54-2254-1-4969,4,2010-01-23,111,現金,高速代,128,0,25009112
14504,0001-20100124-108-2257-1-4975,1,2010-01-24,111,現金,コーヒー代2名,64,0,25009176
14508,0001-20100124-114-2258-1-4977,1,2010-01-24,111,現金,新聞代,126,0,25009302
14511,0001-20100124-114-2258-1-4977,4,2010-01-24,111,現金,新聞代,143,0,25009445
14514,0001-20100124-120-2259-1-4979,1,2010-01-24,322,未払金,業務委託費,31000,0,25040445
14518,0001-20100124-137-2260-1-4981,1,2010-01-24,322,未払金,有線,300,0,25040745
14521,0001-20100124-137-2260-1-4981,4,2010-01-24,322,未払金,警備料,2142,0,25042887
14523,0001-20100124-137-2260-1-4981,6,2010-01-24,131,普通預金,高速料,1121,0,25044008
14528,0001-20100124-137-2260-1-4981,9,2010-01-24,322,未払金,清掃料,3120,0,25047128
14531,0001-20100124-137-2260-1-4981,12,2010-01-24,111,現金,ガソリン代,629,0,25047757
14535,0001-20100124-146-2261-1-4983,1,2010-01-24,322,未払金,業務委託費,8000,0,25055757
14539,0001-20100124-155-2262-1-4985,1,2010-01-24,111,現金,ガソリン代,338,0,25056095
14550,0001-20100125-109-2268-1-4997,3,2010-01-25,152,売掛金,10年1月25日伝票No423株式会社　総合経営,35,0,25056130
14558,0001-20100125-110-2269-1-4999,3,2010-01-25,152,売掛金,10年1月25日伝票No424株式会社　鎌田商店,30,0,25056160
14562,0001-20100125-111-2270-1-5001,1,2010-01-25,322,未払金,タクシー代,646,0,25056806
14569,0001-20100125-111-2270-1-5001,6,2010-01-25,152,売掛金,10年1月25日伝票No425株式会社　小林マーケット,40,0,25056846
14578,0001-20100125-171-2272-1-5005,1,2010-01-25,131,普通預金,携帯代,4455,0,25061301
14584,0001-20100125-172-2273-1-5007,1,2010-01-25,322,未払金,業務委託費支払い,6857,0,25068158
14588,0001-20100125-62-2263-1-4987,1,2010-01-25,131,普通預金,携帯代,3786,0,25071944
14594,0001-20100125-72-2264-1-4989,1,2010-01-25,111,現金,新聞代,143,0,25072087
14597,0001-20100125-72-2264-1-4989,4,2010-01-25,111,現金,新聞代,140,0,25072227
14599,0001-20100125-72-2264-1-4989,6,2010-01-25,111,現金,新聞代,169,0,25072396
14717,0001-20100125-88-2266-1-4993,1,2010-01-25,111,現金,新聞代,169,0,25072565
14724,0001-20100126-113-2280-1-5021,1,2010-01-26,131,普通預金,携帯代,4779,0,25077344
14730,0001-20100126-29-2274-1-5009,1,2010-01-26,131,普通預金,携帯電話代,3699,0,25081043
14736,0001-20100126-37-2275-1-5011,1,2010-01-26,322,未払金,業務委託費,64661,0,25145704
14740,0001-20100126-59-2276-1-5013,1,2010-01-26,111,現金,旅費,2000,0,25147704
14744,0001-20100126-78-2277-1-5015,1,2010-01-26,322,未払金,業務委託費支払い,9000,0,25156704
14748,0001-20100126-87-2278-1-5017,1,2010-01-26,131,普通預金,携帯代,2742,0,25159446
14754,0001-20100127-121-2285-1-5031,1,2010-01-27,111,現金,お茶代,528,0,25159974
14758,0001-20100127-14-2281-1-5023,1,2010-01-27,111,現金,ガソリン代,142,0,25160116
14762,0001-20100127-170-2286-1-5033,1,2010-01-27,111,現金,新聞代,143,0,25160259
14771,0001-20100127-38-2283-1-5027,1,2010-01-27,322,未払金,宿泊費,2293,0,25162552
14775,0001-20100127-39-2284-1-5029,1,2010-01-27,111,現金,会費,428,0,25162980
14779,0001-20100128-13-2287-1-5035,1,2010-01-28,111,現金,タイヤ交換代,120,0,25163100
14783,0001-20100128-27-2288-1-5037,1,2010-01-28,111,現金,旅費,1333,0,25164433
14786,0001-20100128-27-2288-1-5037,4,2010-01-28,111,現金,旅費,1476,0,25165909
14788,0001-20100128-27-2288-1-5037,6,2010-01-28,111,現金,旅費,1071,0,25166980
14791,0001-20100128-35-2289-1-5039,1,2010-01-28,111,現金,新聞代,186,0,25167166
14795,0001-20100128-81-2290-1-5041,1,2010-01-28,322,未払金,お茶代,961,0,25168127
14799,0001-20100128-83-2291-1-5043,1,2010-01-28,111,現金,車両管理費,2142,0,25170269
14803,0001-20100129-32-2292-1-5045,1,2010-01-29,322,未払金,事務用品費,122,0,25170391
14807,0001-20100130-100-2299-1-5059,1,2010-01-30,111,現金,会費,285,0,25170676
14816,0001-20100130-116-2301-1-5063,1,2010-01-30,131,普通預金,リース料,4000,0,25174676
14838,0001-20100130-154-2303-1-5067,1,2010-01-30,322,未払金,お花代,500,0,25175176
14843,0001-20100130-49-2293-1-5047,1,2010-01-30,322,未払金,ガソリン代,7784,0,25182960
14846,0001-20100130-49-2293-1-5047,4,2010-01-30,111,現金,ガソリン代,131,0,25183091
14849,0001-20100130-49-2293-1-5047,7,2010-01-30,111,現金,ガソリン代,286,0,25183377
14852,0001-20100130-55-2294-1-5049,1,2010-01-30,111,現金,車両管理費,1190,0,25184567
14855,0001-20100130-55-2294-1-5049,4,2010-01-30,111,現金,車両管理費,1333,0,25185900
14857,0001-20100130-55-2294-1-5049,6,2010-01-30,111,現金,高速代,383,0,25186283
14860,0001-20100130-70-2295-1-5051,1,2010-01-30,322,未払金,有線,300,0,25186583
14863,0001-20100130-70-2295-1-5051,4,2010-01-30,322,未払金,警備料,2619,0,25189202
14865,0001-20100130-70-2295-1-5051,6,2010-01-30,131,普通預金,高速料,3491,0,25192693
14870,0001-20100130-70-2295-1-5051,9,2010-01-30,322,未払金,清掃料,3500,0,25196193
14874,0001-20100130-80-2296-1-5053,1,2010-01-30,111,現金,ガソリン代,291,0,25196484
14878,0001-20100130-83-2297-1-5055,1,2010-01-30,111,現金,ＪＲ代,428,0,25196912
14882,0001-20100130-96-2298-1-5057,1,2010-01-30,131,普通預金,警備料,1070,0,25197982
14888,0001-20100131-1-2304-1-5069,1,2010-01-31,322,未払金,運賃　佐川急便,25359,0,25223341
15005,0001-20100131-117-2322-1-5105,3,2010-01-31,152,売掛金,10年1月31日伝票No426マークマーケット,40,0,25223381
15013,0001-20100131-118-2323-1-5107,3,2010-01-31,152,売掛金,10年1月31日伝票No427株式会社　ＡＢＣ,40,0,25223421
15027,0001-20100131-121-2326-1-5113,3,2010-01-31,152,売掛金,10年1月31日伝票No430株式会社　畠山商事,30,0,25223451
15035,0001-20100131-122-2327-1-5115,3,2010-01-31,152,売掛金,10年1月31日伝票No431株式会社　千代サービス,10,0,25223461
15039,0001-20100131-123-2328-1-5117,1,2010-01-31,312,買掛金,10年1月1日～10年1月31日分仕入,3672,0,25227133
15042,0001-20100131-123-2328-1-5117,4,2010-01-31,312,買掛金,10年1月1日～10年1月31日分仕入,854,0,25227987
15046,0001-20100131-124-2329-1-5119,1,2010-01-31,312,買掛金,10年1月1日～10年1月31日分仕入,206847,0,25434834
15049,0001-20100131-124-2329-1-5119,4,2010-01-31,312,買掛金,10年1月1日～10年1月31日分仕入,227400,0,25662234
15052,0001-20100131-124-2329-1-5119,7,2010-01-31,312,買掛金,10年1月1日～10年1月31日分仕入,90899,0,25753133
15055,0001-20100131-124-2329-1-5119,10,2010-01-31,312,買掛金,10年1月1日～10年1月31日分仕入,401248,0,26154381
15058,0001-20100131-124-2329-1-5119,13,2010-01-31,312,買掛金,10年1月1日～10年1月31日分仕入,288083,0,26442464
15061,0001-20100131-124-2329-1-5119,16,2010-01-31,312,買掛金,10年1月1日～10年1月31日分仕入,51040,0,26493504
15064,0001-20100131-124-2329-1-5119,19,2010-01-31,312,買掛金,10年1月1日～10年1月31日分仕入,6120,0,26499624
15067,0001-20100131-124-2329-1-5119,22,2010-01-31,312,買掛金,10年1月1日～10年1月31日分仕入,24626,0,26524250
15071,0001-20100131-125-2330-1-5121,1,2010-01-31,312,買掛金,10年1月1日～10年1月31日分仕入,124781,0,26649031
15074,0001-20100131-125-2330-1-5121,4,2010-01-31,312,買掛金,10年1月1日～10年1月31日分仕入,80599,0,26729630
15077,0001-20100131-125-2330-1-5121,7,2010-01-31,312,買掛金,10年1月1日～10年1月31日分仕入,250257,0,26979887
15080,0001-20100131-125-2330-1-5121,10,2010-01-31,312,買掛金,10年1月1日～10年1月31日分仕入,3672,0,26983559
15084,0001-20100131-126-2331-1-5123,1,2010-01-31,312,買掛金,10年1月1日～10年1月31日分仕入,268996,0,27252555
15087,0001-20100131-126-2331-1-5123,4,2010-01-31,312,買掛金,10年1月1日～10年1月31日分仕入,69832,0,27322387
15090,0001-20100131-126-2331-1-5123,7,2010-01-31,312,買掛金,10年1月1日～10年1月31日分仕入,226652,0,27549039
15093,0001-20100131-126-2331-1-5123,10,2010-01-31,312,買掛金,10年1月1日～10年1月31日分仕入,238923,0,27787962
15096,0001-20100131-126-2331-1-5123,13,2010-01-31,312,買掛金,10年1月1日～10年1月31日分仕入,12814,0,27800776
15099,0001-20100131-126-2331-1-5123,16,2010-01-31,312,買掛金,10年1月1日～10年1月31日分仕入,5875,0,27806651
15103,0001-20100131-127-2332-1-5125,1,2010-01-31,312,買掛金,10年1月1日～10年1月31日分仕入,854,0,27807505
15106,0001-20100131-127-2332-1-5125,4,2010-01-31,312,買掛金,10年1月1日～10年1月31日分仕入,1224,0,27808729
15178,0001-20100131-141-2345-1-5151,1,2010-01-31,111,現金,JR代,500,0,27809229
15194,0001-20100131-145-2347-1-5155,4,2010-01-31,322,未払金,運賃,8075,0,27817304
15211,0001-20100131-164-2350-1-5161,1,2010-01-31,111,現金,事務用品,62,0,27817366
15215,0001-20100131-36-2306-1-5073,1,2010-01-31,322,未払金,運賃　ヤマト運輸,135453,0,27952819
15218,0001-20100131-36-2306-1-5073,4,2010-01-31,322,未払金,運賃　佐川急便,60168,0,28012987
15221,0001-20100131-40-2307-1-5075,1,2010-01-31,322,未払金,広告掲載,2380,0,28015367
15225,0001-20100131-5-2305-1-5071,1,2010-01-31,131,普通預金,広告費,2500,0,28017867
15236,0001-20100131-66-2309-1-5079,1,2010-01-31,131,普通預金,リース料,9992,0,28027859
15262,0001-20100131-77-2314-1-5089,1,2010-01-31,322,未払金,運賃,10460,0,28038319
15266,0001-20100131-99-2315-1-5091,1,2010-01-31,322,未払金,運賃,67924,0,28106243
,,,2010-01,,※※月計※※,,3450738,0,
15270,0001-20100201-67-2351-1-5163,1,2010-02-01,111,現金,ティッシュ他,49,0,28106292
15274,0001-20100202-102-2354-1-5169,1,2010-02-02,111,現金,ゴルフ景品代　阿部商店,250,0,28106542
15278,0001-20100202-150-2355-1-5171,1,2010-02-02,111,現金,飲食代　居酒屋華ゆう4名,708,0,28107250
15281,0001-20100202-150-2355-1-5171,4,2010-02-02,111,現金,飲食代　バー薩摩4名,773,0,28108023
15284,0001-20100202-18-2352-1-5165,1,2010-02-02,111,現金,旅費,690,0,28108713
15288,0001-20100202-94-2353-1-5167,1,2010-02-02,111,現金,台所用品他,48,0,28108761
15292,0001-20100203-134-2357-1-5175,1,2010-02-03,322,未払金,用紙,500,0,28109261
15299,0001-20100204-147-2359-1-5179,1,2010-02-04,322,未払金,ガソリン代,318,0,28109579
15303,0001-20100204-19-2358-1-5177,1,2010-02-04,111,現金,旅費,404,0,28109983
15307,0001-20100205-133-2365-1-5191,1,2010-02-05,131,普通預金,税理士報酬,6652,0,28116635
15313,0001-20100205-142-2366-1-5193,1,2010-02-05,111,現金,高速代,249,0,28116884
15316,0001-20100205-142-2366-1-5193,4,2010-02-05,111,現金,高速代,150,0,28117034
15318,0001-20100205-142-2366-1-5193,6,2010-02-05,111,現金,高速代,228,0,28117262
15321,0001-20100205-161-2367-1-5195,1,2010-02-05,111,現金,旅費,332,0,28117594
15325,0001-20100205-20-2360-1-5181,1,2010-02-05,111,現金,旅費,2000,0,28119594
15329,0001-20100205-76-2361-1-5183,1,2010-02-05,322,未払金,社員食事代,743,0,28120337
15337,0001-20100205-85-2362-1-5185,3,2010-02-05,152,売掛金,10年2月5日伝票No432株式会社　渡辺産業,22,0,28120359
15345,0001-20100205-86-2363-1-5187,3,2010-02-05,152,売掛金,10年2月5日伝票No433佐々木販売株式会社,22,0,28120381
15354,0001-20100206-106-2369-1-5199,1,2010-02-06,111,現金,ゴルフプレー代,885,0,28121266
15358,0001-20100206-110-2370-1-5201,1,2010-02-06,111,現金,タクシー代,109,0,28121375
15362,0001-20100206-149-2371-1-5203,1,2010-02-06,111,現金,コーヒー代2名,60,0,28121435
15366,0001-20100206-21-2368-1-5197,1,2010-02-06,111,現金,JR代,2838,0,28124273
15370,0001-20100207-143-2374-1-5209,1,2010-02-07,111,現金,車両管理料,1104,0,28125377
15374,0001-20100207-43-2372-1-5205,1,2010-02-07,111,現金,コーヒー代他2名,105,0,28125482
15378,0001-20100207-58-2373-1-5207,1,2010-02-07,111,現金,旅費,3333,0,28128815
15382,0001-20100208-164-2377-1-5215,1,2010-02-08,111,現金,事務用品,42,0,28128857
15386,0001-20100208-50-2375-1-5211,1,2010-02-08,111,現金,高速代,57,0,28128914
15390,0001-20100208-75-2376-1-5213,1,2010-02-08,111,現金,ガソリン代,331,0,28129245
15393,0001-20100208-75-2376-1-5213,4,2010-02-08,111,現金,高速代,114,0,28129359
15395,0001-20100208-75-2376-1-5213,6,2010-02-08,111,現金,駐車代,38,0,28129397
15398,0001-20100209-152-2378-1-5217,1,2010-02-09,111,現金,ゴルフプレー代,571,0,28129968
15402,0001-20100210-10-2379-1-5219,1,2010-02-10,111,現金,ガソリン代,142,0,28130110
15411,0001-20100210-162-2392-1-5245,1,2010-02-10,111,現金,会議　食事代,1190,0,28131300
15415,0001-20100210-168-2393-1-5247,1,2010-02-10,322,未払金,有線,300,0,28131600
15418,0001-20100210-168-2393-1-5247,4,2010-02-10,322,未払金,警備料,2142,0,28133742
15436,0001-20100210-65-2382-1-5225,1,2010-02-10,322,未払金,有線,250,0,28133992
15439,0001-20100210-65-2382-1-5225,4,2010-02-10,322,未払金,警備料,1714,0,28135706
15442,0001-20100210-76-2383-1-5227,1,2010-02-10,111,現金,ガソリン代,286,0,28135992
15446,0001-20100210-79-2384-1-5229,1,2010-02-10,111,現金,旅費,1047,0,28137039
15457,0001-20100210-89-2386-1-5233,3,2010-02-10,152,売掛金,10年2月10日伝票No436株式会社　藤田東京本社,35,0,28137074
15465,0001-20100210-90-2387-1-5235,3,2010-02-10,152,売掛金,10年2月10日伝票No437株式会社　ミナミ,35,0,28137109
15480,0001-20100211-112-2401-1-5263,1,2010-02-11,131,普通預金,電話代,7587,0,28144696
15486,0001-20100211-129-2402-1-5265,1,2010-02-11,131,普通預金,家賃支払い,19000,0,28163696
15492,0001-20100211-141-2403-1-5267,1,2010-02-11,111,現金,JR代,1023,0,28164719
15496,0001-20100211-165-2404-1-5269,1,2010-02-11,111,現金,ティッシュ代他,63,0,28164782
15500,0001-20100211-167-2405-1-5271,1,2010-02-11,131,普通預金,家賃支払い,30000,0,28194782
15505,0001-20100211-167-2405-1-5271,4,2010-02-11,131,普通預金,電話代,6221,0,28201003
15511,0001-20100211-22-2394-1-5249,1,2010-02-11,111,現金,旅費,1095,0,28202098
15515,0001-20100211-33-2395-1-5251,1,2010-02-11,131,普通預金,家賃支払い,15238,0,28217336
15520,0001-20100211-33-2395-1-5251,4,2010-02-11,131,普通預金,電話代,8156,0,28225492
15526,0001-20100211-63-2396-1-5253,1,2010-02-11,131,普通預金,家賃支払,60000,0,28285492
15532,0001-20100211-64-2397-1-5255,1,2010-02-11,131,普通預金,家賃支払,40000,0,28325492
15538,0001-20100211-73-2398-1-5257,1,2010-02-11,111,現金,食事代,1263,0,28326755
15542,0001-20100211-80-2399-1-5259,1,2010-02-11,111,現金,ＪＲ代,476,0,28327231
15546,0001-20100211-85-2400-1-5261,1,2010-02-11,131,普通預金,電話代,3963,0,28331194
15552,0001-20100212-44-2406-1-5273,1,2010-02-12,111,現金,飲食代　スナックランディ5名,1604,0,28332798
15556,0001-20100212-69-2407-1-5275,1,2010-02-12,111,現金,ゴルフプレー代,600,0,28333398
15560,0001-20100212-71-2408-1-5277,1,2010-02-12,111,現金,ゴルフプレー代,650,0,28334048
15564,0001-20100213-17-2409-1-5279,1,2010-02-13,111,現金,駐車代,19,0,28334067
15567,0001-20100213-17-2409-1-5279,4,2010-02-13,111,現金,高速代,100,0,28334167
15570,0001-20100213-23-2410-1-5281,1,2010-02-13,111,現金,旅費,1190,0,28335357
15573,0001-20100213-23-2410-1-5281,4,2010-02-13,111,現金,旅費,3142,0,28338499
15576,0001-20100213-82-2411-1-5283,1,2010-02-13,322,未払金,ガソリン代,1501,0,28340000
15580,0001-20100214-46-2412-1-5285,1,2010-02-14,111,現金,ガソリン代,117,0,28340117
15583,0001-20100214-46-2412-1-5285,4,2010-02-14,111,現金,ガソリン代,238,0,28340355
15585,0001-20100214-46-2412-1-5285,6,2010-02-14,111,現金,ガソリン代,244,0,28340599
15588,0001-20100214-51-2413-1-5287,1,2010-02-14,111,現金,高速代,75,0,28340674
15591,0001-20100214-51-2413-1-5287,4,2010-02-14,111,現金,高速代,30,0,28340704
15593,0001-20100214-51-2413-1-5287,6,2010-02-14,111,現金,高速代,40,0,28340744
15595,0001-20100214-51-2413-1-5287,8,2010-02-14,111,現金,高速代,54,0,28340798
15597,0001-20100214-51-2413-1-5287,10,2010-02-14,111,現金,高速代,54,0,28340852
15599,0001-20100214-51-2413-1-5287,12,2010-02-14,111,現金,高速代,54,0,28340906
15601,0001-20100214-51-2413-1-5287,14,2010-02-14,111,現金,高速代,47,0,28340953
15604,0001-20100214-70-2414-1-5289,1,2010-02-14,111,現金,ゴルフプレー代,409,0,28341362
15619,0001-20100215-151-2427-1-5315,1,2010-02-15,111,現金,飲食代　居酒屋ラッキー,607,0,28341969
15623,0001-20100215-158-2428-1-5317,1,2010-02-15,111,現金,出張旅費,666,0,28342635
15627,0001-20100215-4-2415-1-5291,1,2010-02-15,322,未払金,広告費,1500,0,28344135
15631,0001-20100215-57-2416-1-5293,1,2010-02-15,111,現金,JR代,3271,0,28347406
15645,0001-20100215-94-2418-1-5297,3,2010-02-15,152,売掛金,10年2月15日伝票No439五越株式会社,40,0,28347446
15653,0001-20100215-95-2419-1-5299,3,2010-02-15,152,売掛金,10年2月15日伝票No440株式会社　エントリー,40,0,28347486
15661,0001-20100215-96-2420-1-5301,3,2010-02-15,152,売掛金,10年2月15日伝票No441タワー株式会社,40,0,28347526
15669,0001-20100215-97-2421-1-5303,3,2010-02-15,152,売掛金,10年2月15日伝票No442高橋物産株式会社,40,0,28347566
15682,0001-20100215-99-2423-1-5307,3,2010-02-15,152,売掛金,10年2月15日伝票No444株式会社　久城商事,15,0,28347581
15686,0001-20100216-11-2430-1-5321,1,2010-02-16,111,現金,ガソリン代,152,0,28347733
15690,0001-20100216-136-2433-1-5327,1,2010-02-16,111,現金,ダスキン代,785,0,28348518
15694,0001-20100216-148-2434-1-5329,1,2010-02-16,111,現金,ガソリン代,170,0,28348688
15698,0001-20100216-154-2435-1-5331,1,2010-02-16,322,未払金,手土産代　大塚物産,311,0,28348999
15701,0001-20100216-154-2435-1-5331,4,2010-02-16,322,未払金,飲食代　スナック帰り道4名,941,0,28349940
15704,0001-20100216-61-2431-1-5323,1,2010-02-16,131,普通預金,電話代,8405,0,28358345
15710,0001-20100216-7-2429-1-5319,1,2010-02-16,111,現金,昼食代　かりん2名,178,0,28358523
15714,0001-20100216-79-2432-1-5325,1,2010-02-16,111,現金,景品代,1876,0,28360399
15718,0001-20100217-47-2436-1-5333,1,2010-02-17,111,現金,ガソリン代,120,0,28360519
15722,0001-20100217-52-2437-1-5335,1,2010-02-17,111,現金,高速代,54,0,28360573
15725,0001-20100217-52-2437-1-5335,4,2010-02-17,111,現金,高速代,54,0,28360627
15727,0001-20100217-52-2437-1-5335,6,2010-02-17,111,現金,高速代,71,0,28360698
15730,0001-20100217-74-2438-1-5337,1,2010-02-17,111,現金,食事代　レストランファミリー5名,410,0,28361108
15734,0001-20100218-159-2439-1-5339,1,2010-02-18,111,現金,タクシー代,361,0,28361469
15738,0001-20100219-103-2442-1-5345,1,2010-02-19,111,現金,食事代　弁当差し入れ　ベントース,102,0,28361571
15742,0001-20100219-138-2443-1-5347,1,2010-02-19,111,現金,高速代,359,0,28361930
15745,0001-20100219-138-2443-1-5347,4,2010-02-19,111,現金,駐車代,154,0,28362084
15747,0001-20100219-138-2443-1-5347,6,2010-02-19,111,現金,高速代,15,0,28362099
15749,0001-20100219-138-2443-1-5347,8,2010-02-19,111,現金,高速代,416,0,28362515
15751,0001-20100219-138-2443-1-5347,10,2010-02-19,111,現金,高速代,259,0,28362774
15754,0001-20100219-160-2444-1-5349,1,2010-02-19,111,現金,出張旅費,3319,0,28366093
15758,0001-20100219-45-2440-1-5341,1,2010-02-19,111,現金,飲食代　居酒屋旬5名,999,0,28367092
15761,0001-20100219-45-2440-1-5341,4,2010-02-19,111,現金,飲食代　スナック新世界,1418,0,28368510
15764,0001-20100219-59-2441-1-5343,1,2010-02-19,111,現金,旅費,2171,0,28370681
15768,0001-20100220-101-2458-1-5377,1,2010-02-20,322,未払金,広告料,2500,0,28373181
15778,0001-20100220-102-2459-1-5379,3,2010-02-20,152,売掛金,10年2月20日伝票No446合同会社　たかだ,22,0,28373203
15786,0001-20100220-103-2460-1-5381,3,2010-02-20,152,売掛金,10年2月20日伝票No447株式会社　ＹＡＧ,35,0,28373238
15803,0001-20100220-118-2464-1-5389,1,2010-02-20,322,未払金,コピー代,381,0,28373619
15807,0001-20100220-132-2465-1-5391,1,2010-02-20,131,普通預金,電気代,4164,0,28377783
15812,0001-20100220-132-2465-1-5391,4,2010-02-20,131,普通預金,水道代,282,0,28378065
15815,0001-20100220-135-2466-1-5393,1,2010-02-20,322,未払金,事務用品,113,0,28378178
15819,0001-20100220-144-2467-1-5395,1,2010-02-20,111,現金,ガソリン代,214,0,28378392
15822,0001-20100220-144-2467-1-5395,4,2010-02-20,111,現金,ガソリン代,295,0,28378687
15825,0001-20100220-153-2468-1-5397,1,2010-02-20,111,現金,食事代　和食処川よし2名,474,0,28379161
15832,0001-20100220-169-2470-1-5401,1,2010-02-20,131,普通預金,電気料,4154,0,28383315
15837,0001-20100220-169-2470-1-5401,4,2010-02-20,131,普通預金,水道料,292,0,28383607
15840,0001-20100220-31-2445-1-5351,1,2010-02-20,322,未払金,コピー代,148,0,28383755
15844,0001-20100220-34-2446-1-5353,1,2010-02-20,131,普通預金,電気代,3268,0,28387023
15849,0001-20100220-34-2446-1-5353,4,2010-02-20,131,普通預金,水道代,181,0,28387204
15852,0001-20100220-38-2447-1-5355,1,2010-02-20,322,未払金,宿泊費,2293,0,28389497
15856,0001-20100220-48-2448-1-5357,1,2010-02-20,111,現金,ガソリン代,204,0,28389701
15860,0001-20100220-53-2449-1-5359,1,2010-02-20,111,現金,高速代,19,0,28389720
15863,0001-20100220-53-2449-1-5359,4,2010-02-20,111,現金,高速代,50,0,28389770
15865,0001-20100220-53-2449-1-5359,6,2010-02-20,111,現金,高速代,50,0,28389820
15868,0001-20100220-64-2450-1-5361,1,2010-02-20,131,普通預金,電気料,7843,0,28397663
15873,0001-20100220-64-2450-1-5361,4,2010-02-20,131,普通預金,水道料,359,0,28398022
15876,0001-20100220-66-2451-1-5363,1,2010-02-20,322,未払金,有線,238,0,28398260
15880,0001-20100220-68-2452-1-5365,1,2010-02-20,322,未払金,カウンター料金,300,0,28398560
15884,0001-20100220-71-2453-1-5367,1,2010-02-20,322,未払金,事務用品,75,0,28398635
15887,0001-20100220-71-2453-1-5367,4,2010-02-20,322,未払金,カウンター料金,1704,0,28400339
15890,0001-20100220-74-2454-1-5369,1,2010-02-20,322,未払金,ファイル等,969,0,28401308
15893,0001-20100220-74-2454-1-5369,4,2010-02-20,322,未払金,飲料水,11645,0,28412953
15895,0001-20100220-74-2454-1-5369,6,2010-02-20,322,未払金,名刺代,2604,0,28415557
15898,0001-20100220-89-2455-1-5371,1,2010-02-20,131,普通預金,電気料,3206,0,28418763
15903,0001-20100220-89-2455-1-5371,4,2010-02-20,131,普通預金,水道料,153,0,28418916
15905,0001-20100220-89-2455-1-5371,6,2010-02-20,131,普通預金,ガス代,176,0,28419092
15908,0001-20100220-97-2456-1-5373,1,2010-02-20,322,未払金,コピー代,1905,0,28420997
15912,0001-20100220-98-2457-1-5375,1,2010-02-20,322,未払金,事務用品,150,0,28421147
15916,0001-20100221-137-2476-1-5413,1,2010-02-21,322,未払金,有線,300,0,28421447
15919,0001-20100221-137-2476-1-5413,4,2010-02-21,322,未払金,警備料,2142,0,28423589
15921,0001-20100221-137-2476-1-5413,6,2010-02-21,131,普通預金,高速料,644,0,28424233
15926,0001-20100221-137-2476-1-5413,9,2010-02-21,322,未払金,清掃料,2686,0,28426919
15930,0001-20100221-25-2473-1-5407,1,2010-02-21,111,現金,旅費,2666,0,28429585
15934,0001-20100221-27-2474-1-5409,1,2010-02-21,111,現金,旅費,2095,0,28431680
15937,0001-20100221-27-2474-1-5409,4,2010-02-21,111,現金,旅費,1419,0,28433099
15939,0001-20100221-27-2474-1-5409,6,2010-02-21,111,現金,旅費,1503,0,28434602
15942,0001-20100221-6-2471-1-5403,1,2010-02-21,111,現金,広告料,238,0,28434840
15946,0001-20100221-8-2472-1-5405,1,2010-02-21,111,現金,定例ミーティング会費,952,0,28435792
15950,0001-20100221-80-2475-1-5411,1,2010-02-21,322,未払金,会費支払い,19875,0,28455667
15954,0001-20100222-12-2477-1-5415,1,2010-02-22,111,現金,ガソリン代,190,0,28455857
15957,0001-20100222-12-2477-1-5415,4,2010-02-22,111,現金,ガソリン代,285,0,28456142
15960,0001-20100222-155-2480-1-5421,1,2010-02-22,111,現金,ガソリン代,296,0,28456438
15964,0001-20100222-166-2481-1-5423,1,2010-02-22,111,現金,ダスキン代,90,0,28456528
15968,0001-20100222-90-2478-1-5417,1,2010-02-22,111,現金,ダスキン代,500,0,28457028
15972,0001-20100222-95-2479-1-5419,1,2010-02-22,322,未払金,清掃料,3413,0,28460441
15976,0001-20100223-140-2489-1-5439,1,2010-02-23,111,現金,旅費,352,0,28460793
15980,0001-20100223-156-2490-1-5441,1,2010-02-23,111,現金,出張旅費,452,0,28461245
15984,0001-20100223-26-2484-1-5429,1,2010-02-23,111,現金,旅費,523,0,28461768
15988,0001-20100223-28-2485-1-5431,1,2010-02-23,322,未払金,タクシー代,115,0,28461883
15992,0001-20100223-3-2482-1-5425,1,2010-02-23,322,未払金,宿泊代,1372,0,28463255
15996,0001-20100223-54-2486-1-5433,1,2010-02-23,111,現金,高速代,90,0,28463345
15999,0001-20100223-54-2486-1-5433,4,2010-02-23,111,現金,高速代,128,0,28463473
16002,0001-20100223-61-2487-1-5435,1,2010-02-23,322,未払金,お茶代,527,0,28464000
16123,0001-20100223-9-2483-1-5427,3,2010-02-23,111,現金,花代,600,0,28464600
16126,0001-20100224-104-2495-1-5451,1,2010-02-24,111,現金,コーヒー代3名,90,0,28464690
16130,0001-20100224-120-2496-1-5453,1,2010-02-24,322,未払金,業務委託費,15000,0,28479690
16134,0001-20100224-157-2497-1-5455,1,2010-02-24,131,普通預金,航空券代,2095,0,28481785
16140,0001-20100224-172-2498-1-5457,1,2010-02-24,322,未払金,業務委託費支払い,5809,0,28487594
16144,0001-20100224-75-2491-1-5443,1,2010-02-24,111,現金,コーヒー代2名,60,0,28487654
16148,0001-20100224-78-2492-1-5445,1,2010-02-24,322,未払金,業務委託費支払い,9000,0,28496654
16152,0001-20100224-83-2493-1-5447,1,2010-02-24,111,現金,車両管理費,1842,0,28498496
16156,0001-20100224-87-2494-1-5449,1,2010-02-24,131,普通預金,携帯代,3407,0,28501903
16169,0001-20100225-108-2504-1-5469,3,2010-02-25,152,売掛金,10年2月25日伝票No449株式会社　総合経営,35,0,28501938
16177,0001-20100225-109-2505-1-5471,3,2010-02-25,152,売掛金,10年2月25日伝票No450株式会社　鎌田商店,30,0,28501968
16185,0001-20100225-110-2506-1-5473,3,2010-02-25,152,売掛金,10年2月25日伝票No451株式会社　小林マーケット,40,0,28502008
16189,0001-20100225-111-2507-1-5475,1,2010-02-25,322,未払金,タクシー代,702,0,28502710
16193,0001-20100225-121-2508-1-5477,1,2010-02-25,111,現金,お茶代,452,0,28503162
16197,0001-20100225-24-2499-1-5459,1,2010-02-25,111,現金,JR回数券,2659,0,28505821
16201,0001-20100225-35-2500-1-5461,1,2010-02-25,111,現金,新聞代,186,0,28506007
16205,0001-20100225-37-2501-1-5463,1,2010-02-25,322,未払金,業務委託費,35909,0,28541916
16209,0001-20100225-60-2502-1-5465,1,2010-02-25,111,現金,旅費,500,0,28542416
16213,0001-20100226-109-2514-1-5489,1,2010-02-26,322,未払金,ガソリン代,2213,0,28544629
16217,0001-20100226-113-2515-1-5491,1,2010-02-26,131,普通預金,携帯代,2849,0,28547478
16223,0001-20100226-114-2516-1-5493,1,2010-02-26,111,現金,新聞代,126,0,28547604
16226,0001-20100226-114-2516-1-5493,4,2010-02-26,111,現金,新聞代,143,0,28547747
16234,0001-20100226-146-2518-1-5497,1,2010-02-26,322,未払金,業務委託費,8000,0,28555747
16238,0001-20100226-170-2519-1-5499,1,2010-02-26,111,現金,新聞代,143,0,28555890
16242,0001-20100226-29-2509-1-5479,1,2010-02-26,131,普通預金,携帯電話代,3178,0,28559068
16248,0001-20100226-62-2510-1-5481,1,2010-02-26,131,普通預金,携帯代,3459,0,28562527
16254,0001-20100226-72-2511-1-5483,1,2010-02-26,111,現金,新聞代,143,0,28562670
16257,0001-20100226-72-2511-1-5483,4,2010-02-26,111,現金,新聞代,140,0,28562810
16259,0001-20100226-72-2511-1-5483,6,2010-02-26,111,現金,新聞代,169,0,28562979
16262,0001-20100226-82-2512-1-5485,1,2010-02-26,111,現金,タクシー代,214,0,28563193
16266,0001-20100226-88-2513-1-5487,1,2010-02-26,111,現金,新聞代,169,0,28563362
16270,0001-20100227-15-2520-1-5501,1,2010-02-27,111,現金,高速代,100,0,28563462
16274,0001-20100227-171-2524-1-5509,1,2010-02-27,131,普通預金,携帯代,2447,0,28565909
16285,0001-20100227-39-2522-1-5505,1,2010-02-27,111,現金,会費,428,0,28566337
16289,0001-20100227-77-2523-1-5507,1,2010-02-27,111,現金,ガソリン代,244,0,28566581
16292,0001-20100227-77-2523-1-5507,4,2010-02-27,111,現金,洗車代,57,0,28566638
16295,0001-20100228-1-2531-1-5523,1,2010-02-28,322,未払金,運賃　佐川急便,6182,0,28572820
16299,0001-20100228-100-2546-1-5553,1,2010-02-28,111,現金,会費,285,0,28573105
16317,0001-20100228-108-2528-1-5517,1,2010-02-28,111,現金,飲食代　ホテルラフォーネ3名,1015,0,28574120
16420,0001-20100228-116-2529-1-5519,1,2010-02-28,131,普通預金,リース料,4000,0,28578120
16430,0001-20100228-116-2553-1-5567,3,2010-02-28,152,売掛金,10年2月28日伝票No452マークマーケット,40,0,28578160
16438,0001-20100228-117-2554-1-5569,3,2010-02-28,152,売掛金,10年2月28日伝票No453株式会社　ＡＢＣ,40,0,28578200
16452,0001-20100228-120-2557-1-5575,3,2010-02-28,152,売掛金,10年2月28日伝票No456株式会社　畠山商事,30,0,28578230
16460,0001-20100228-121-2558-1-5577,3,2010-02-28,152,売掛金,10年2月28日伝票No457株式会社　千代サービス,10,0,28578240
16464,0001-20100228-122-2559-1-5579,1,2010-02-28,312,買掛金,10年2月1日～10年2月28日分仕入,10701,0,28588941
16467,0001-20100228-122-2559-1-5579,4,2010-02-28,312,買掛金,10年2月1日～10年2月28日分仕入,1248,0,28590189
16471,0001-20100228-123-2560-1-5581,1,2010-02-28,312,買掛金,10年2月1日～10年2月28日分仕入,161226,0,28751415
16474,0001-20100228-123-2560-1-5581,4,2010-02-28,312,買掛金,10年2月1日～10年2月28日分仕入,177397,0,28928812
16477,0001-20100228-123-2560-1-5581,7,2010-02-28,312,買掛金,10年2月1日～10年2月28日分仕入,61508,0,28990320
16480,0001-20100228-123-2560-1-5581,10,2010-02-28,312,買掛金,10年2月1日～10年2月28日分仕入,224022,0,29214342
16483,0001-20100228-123-2560-1-5581,13,2010-02-28,312,買掛金,10年2月1日～10年2月28日分仕入,174356,0,29388698
16486,0001-20100228-123-2560-1-5581,16,2010-02-28,312,買掛金,10年2月1日～10年2月28日分仕入,12168,0,29400866
16489,0001-20100228-123-2560-1-5581,19,2010-02-28,312,買掛金,10年2月1日～10年2月28日分仕入,17222,0,29418088
16492,0001-20100228-123-2560-1-5581,22,2010-02-28,312,買掛金,10年2月1日～10年2月28日分仕入,26425,0,29444513
16496,0001-20100228-124-2561-1-5583,1,2010-02-28,312,買掛金,10年2月1日～10年2月28日分仕入,97222,0,29541735
16499,0001-20100228-124-2561-1-5583,4,2010-02-28,312,買掛金,10年2月1日～10年2月28日分仕入,54508,0,29596243
16502,0001-20100228-124-2561-1-5583,7,2010-02-28,312,買掛金,10年2月1日～10年2月28日分仕入,153404,0,29749647
16505,0001-20100228-124-2561-1-5583,10,2010-02-28,312,買掛金,10年2月1日～10年2月28日分仕入,5022,0,29754669
16508,0001-20100228-124-2561-1-5583,13,2010-02-28,312,買掛金,10年2月1日～10年2月28日分仕入,2496,0,29757165
16512,0001-20100228-125-2562-1-5585,1,2010-02-28,312,買掛金,10年2月1日～10年2月28日分仕入,201712,0,29958877
16515,0001-20100228-125-2562-1-5585,4,2010-02-28,312,買掛金,10年2月1日～10年2月28日分仕入,49798,0,30008675
16518,0001-20100228-125-2562-1-5585,7,2010-02-28,312,買掛金,10年2月1日～10年2月28日分仕入,126484,0,30135159
16521,0001-20100228-125-2562-1-5585,10,2010-02-28,312,買掛金,10年2月1日～10年2月28日分仕入,153269,0,30288428
16524,0001-20100228-125-2562-1-5585,13,2010-02-28,312,買掛金,10年2月1日～10年2月28日分仕入,25551,0,30313979
16527,0001-20100228-125-2562-1-5585,16,2010-02-28,312,買掛金,10年2月1日～10年2月28日分仕入,2496,0,30316475
16531,0001-20100228-126-2563-1-5587,1,2010-02-28,312,買掛金,10年2月1日～10年2月28日分仕入,1248,0,30317723
16534,0001-20100228-126-2563-1-5587,4,2010-02-28,312,買掛金,10年2月1日～10年2月28日分仕入,7861,0,30325584
16629,0001-20100228-145-2578-1-5617,1,2010-02-28,322,未払金,運賃,8007,0,30333591
16645,0001-20100228-36-2533-1-5527,1,2010-02-28,322,未払金,運賃　ヤマト運輸,78449,0,30412040
16648,0001-20100228-36-2533-1-5527,4,2010-02-28,322,未払金,運賃　佐川急便,36658,0,30448698
16651,0001-20100228-40-2534-1-5529,1,2010-02-28,322,未払金,広告掲載,2380,0,30451078
16655,0001-20100228-49-2535-1-5531,1,2010-02-28,322,未払金,ガソリン代,7784,0,30458862
16658,0001-20100228-49-2535-1-5531,4,2010-02-28,111,現金,ガソリン代,131,0,30458993
16661,0001-20100228-49-2535-1-5531,7,2010-02-28,111,現金,ガソリン代,286,0,30459279
16664,0001-20100228-5-2532-1-5525,1,2010-02-28,131,普通預金,広告費,2500,0,30461779
16670,0001-20100228-55-2536-1-5533,1,2010-02-28,111,現金,車両管理費,1190,0,30462969
16673,0001-20100228-55-2536-1-5533,4,2010-02-28,111,現金,車両管理費,1333,0,30464302
16675,0001-20100228-55-2536-1-5533,6,2010-02-28,111,現金,高速代,383,0,30464685
16683,0001-20100228-66-2525-1-5511,1,2010-02-28,131,普通預金,リース料,9992,0,30474677
16692,0001-20100228-70-2538-1-5537,1,2010-02-28,322,未払金,有線,300,0,30474977
16695,0001-20100228-70-2538-1-5537,4,2010-02-28,322,未払金,警備料,2619,0,30477596
16697,0001-20100228-70-2538-1-5537,6,2010-02-28,131,普通預金,高速料,3491,0,30481087
16702,0001-20100228-70-2538-1-5537,9,2010-02-28,322,未払金,清掃料,3500,0,30484587
16716,0001-20100228-77-2541-1-5543,1,2010-02-28,322,未払金,運賃,6743,0,30491330
16727,0001-20100228-81-2527-1-5515,1,2010-02-28,322,未払金,お茶代,947,0,30492277
16731,0001-20100228-93-2543-1-5547,1,2010-02-28,322,未払金,修繕費,850,0,30493127
16735,0001-20100228-96-2544-1-5549,1,2010-02-28,131,普通預金,警備料,1070,0,30494197
16741,0001-20100228-99-2545-1-5551,1,2010-02-28,322,未払金,運賃,38030,0,30532227
,,,2010-02,,※※月計※※,,2425984,0,
16745,0001-20100301-66-2580-1-5621,1,2010-03-01,111,現金,ティッシュ他,204,0,30532431
16749,0001-20100302-164-2581-1-5623,1,2010-03-02,111,現金,事務用品,350,0,30532781
16753,0001-20100303-134-2585-1-5631,1,2010-03-03,322,未払金,用紙,1500,0,30534281
16757,0001-20100303-142-2586-1-5633,1,2010-03-03,111,現金,高速代,10,0,30534291
16760,0001-20100303-142-2586-1-5633,4,2010-03-03,111,現金,ガソリン代,166,0,30534457
16762,0001-20100303-142-2586-1-5633,6,2010-03-03,111,現金,高速代,261,0,30534718
16764,0001-20100303-142-2586-1-5633,8,2010-03-03,111,現金,高速代,123,0,30534841
16766,0001-20100303-142-2586-1-5633,10,2010-03-03,111,現金,高速代,168,0,30535009
16768,0001-20100303-142-2586-1-5633,12,2010-03-03,111,現金,高速代,405,0,30535414
16771,0001-20100303-19-2582-1-5625,1,2010-03-03,111,現金,旅費,1828,0,30537242
16775,0001-20100303-41-2583-1-5627,1,2010-03-03,111,現金,結婚式会費,714,0,30537956
16778,0001-20100303-41-2583-1-5627,4,2010-03-03,111,現金,祝い金,476,0,30538432
16781,0001-20100303-56-2584-1-5629,1,2010-03-03,111,現金,旅費,2030,0,30540462
16785,0001-20100305-133-2593-1-5647,1,2010-03-05,131,普通預金,税理士報酬,6652,0,30547114
16791,0001-20100305-42-2587-1-5635,1,2010-03-05,111,現金,食事代　トン吉2名,214,0,30547328
16795,0001-20100305-43-2588-1-5637,1,2010-03-05,111,現金,手土産代　五越百貨店,363,0,30547691
16799,0001-20100305-58-2589-1-5639,1,2010-03-05,111,現金,旅費,3323,0,30551014
16807,0001-20100305-84-2590-1-5641,3,2010-03-05,152,売掛金,10年3月5日伝票No458株式会社　渡辺産業,22,0,30551036
16815,0001-20100305-85-2591-1-5643,3,2010-03-05,152,売掛金,10年3月5日伝票No459佐々木販売株式会社,22,0,30551058
16824,0001-20100306-110-2596-1-5653,1,2010-03-06,111,現金,タクシー代,109,0,30551167
16828,0001-20100306-147-2597-1-5655,1,2010-03-06,322,未払金,ガソリン代,301,0,30551468
16832,0001-20100306-22-2595-1-5651,1,2010-03-06,111,現金,旅費,1566,0,30553034
16836,0001-20100306-7-2594-1-5649,1,2010-03-06,111,現金,飲食代　居酒屋いろは7名,1040,0,30554074
16840,0001-20100307-10-2598-1-5657,1,2010-03-07,111,現金,駐車代,14,0,30554088
16844,0001-20100307-102-2603-1-5667,1,2010-03-07,111,現金,手土産代　阿部商店,100,0,30554188
16848,0001-20100307-161-2604-1-5669,1,2010-03-07,111,現金,旅費,263,0,30554451
16852,0001-20100307-69-2599-1-5659,1,2010-03-07,111,現金,トイレットペーパー代,66,0,30554517
16856,0001-20100307-77-2600-1-5661,1,2010-03-07,111,現金,旅費,1666,0,30556183
16860,0001-20100307-78-2601-1-5663,1,2010-03-07,111,現金,ＪＲ代,357,0,30556540
16864,0001-20100307-79-2602-1-5665,1,2010-03-07,111,現金,タクシー代,109,0,30556649
16868,0001-20100308-151-2606-1-5673,1,2010-03-08,111,現金,ゴルフプレー代,400,0,30557049
16872,0001-20100308-50-2605-1-5671,1,2010-03-08,111,現金,高速代,57,0,30557106
16876,0001-20100309-20-2607-1-5675,1,2010-03-09,111,現金,旅費,2438,0,30559544
16880,0001-20100310-11-2608-1-5677,1,2010-03-10,111,現金,ガソリン代,220,0,30559764
16884,0001-20100310-129-2623-1-5707,1,2010-03-10,131,普通預金,家賃支払い,19000,0,30578764
16895,0001-20100310-143-2625-1-5711,1,2010-03-10,111,現金,点検作業料,595,0,30579359
16899,0001-20100310-150-2626-1-5713,1,2010-03-10,111,現金,ゴルフプレー代,400,0,30579759
16903,0001-20100310-162-2627-1-5715,1,2010-03-10,111,現金,会議　食事代,1190,0,30580949
16907,0001-20100310-167-2628-1-5717,1,2010-03-10,131,普通預金,家賃支払い,30000,0,30610949
16912,0001-20100310-167-2628-1-5717,4,2010-03-10,131,普通預金,電話代,8344,0,30619293
16918,0001-20100310-168-2629-1-5719,1,2010-03-10,322,未払金,有線,300,0,30619593
16921,0001-20100310-168-2629-1-5719,4,2010-03-10,322,未払金,警備料,2142,0,30621735
16924,0001-20100310-33-2609-1-5679,1,2010-03-10,131,普通預金,家賃支払い,15238,0,30636973
16929,0001-20100310-33-2609-1-5679,4,2010-03-10,131,普通預金,電話代,6779,0,30643752
16935,0001-20100310-57-2610-1-5681,1,2010-03-10,111,現金,JR代,4809,0,30648561
16949,0001-20100310-63-2612-1-5685,1,2010-03-10,131,普通預金,家賃支払,60000,0,30708561
16955,0001-20100310-64-2613-1-5687,1,2010-03-10,131,普通預金,家賃支払,40000,0,30748561
16961,0001-20100310-65-2614-1-5689,1,2010-03-10,322,未払金,有線,250,0,30748811
16964,0001-20100310-65-2614-1-5689,4,2010-03-10,322,未払金,警備料,1714,0,30750525
16967,0001-20100310-76-2615-1-5691,1,2010-03-10,322,未払金,社員夜食代,3593,0,30754118
16971,0001-20100310-78-2616-1-5693,1,2010-03-10,111,現金,ガソリン代,281,0,30754399
16974,0001-20100310-78-2616-1-5693,4,2010-03-10,111,現金,高速代,85,0,30754484
16984,0001-20100310-88-2618-1-5697,3,2010-03-10,152,売掛金,10年3月10日伝票No462株式会社　藤田東京本社,35,0,30754519
16992,0001-20100310-89-2619-1-5699,3,2010-03-10,152,売掛金,10年3月10日伝票No463株式会社　ミナミ,35,0,30754554
17007,0001-20100311-112-2631-1-5723,1,2010-03-11,131,普通預金,電話代,12773,0,30767327
17013,0001-20100311-85-2630-1-5721,1,2010-03-11,131,普通預金,電話代,2683,0,30770010
17019,0001-20100312-68-2632-1-5725,1,2010-03-12,111,現金,電池代,30,0,30770040
17023,0001-20100312-73-2633-1-5727,1,2010-03-12,111,現金,飲食代　居酒屋栗の木2名,464,0,30770504
17027,0001-20100312-86-2634-1-5729,1,2010-03-12,111,現金,切手代,380,0,30770884
17031,0001-20100313-144-2636-1-5733,1,2010-03-13,111,現金,ガソリン代,119,0,30771003
17034,0001-20100313-144-2636-1-5733,4,2010-03-13,111,現金,ガソリン代,374,0,30771377
17036,0001-20100313-144-2636-1-5733,6,2010-03-13,111,現金,高速代,383,0,30771760
17039,0001-20100313-158-2637-1-5735,1,2010-03-13,111,現金,航空券,2714,0,30774474
17043,0001-20100313-21-2635-1-5731,1,2010-03-13,111,現金,JR代,4262,0,30778736
17047,0001-20100314-17-2638-1-5737,1,2010-03-14,111,現金,ウォッシャー液,17,0,30778753
17051,0001-20100314-46-2639-1-5739,1,2010-03-14,111,現金,ガソリン代,117,0,30778870
17054,0001-20100314-46-2639-1-5739,4,2010-03-14,111,現金,ガソリン代,238,0,30779108
17056,0001-20100314-46-2639-1-5739,6,2010-03-14,111,現金,ガソリン代,244,0,30779352
17059,0001-20100314-51-2640-1-5741,1,2010-03-14,111,現金,高速代,75,0,30779427
17062,0001-20100314-51-2640-1-5741,4,2010-03-14,111,現金,高速代,30,0,30779457
17064,0001-20100314-51-2640-1-5741,6,2010-03-14,111,現金,高速代,40,0,30779497
17066,0001-20100314-51-2640-1-5741,8,2010-03-14,111,現金,高速代,54,0,30779551
17068,0001-20100314-51-2640-1-5741,10,2010-03-14,111,現金,高速代,54,0,30779605
17070,0001-20100314-51-2640-1-5741,12,2010-03-14,111,現金,高速代,54,0,30779659
17072,0001-20100314-51-2640-1-5741,14,2010-03-14,111,現金,高速代,47,0,30779706
17075,0001-20100314-61-2641-1-5743,1,2010-03-14,131,普通預金,電話代,6414,0,30786120
17081,0001-20100314-82-2642-1-5745,1,2010-03-14,322,未払金,ガソリン代,1495,0,30787615
17090,0001-20100315-4-2643-1-5747,1,2010-03-15,322,未払金,広告費,1500,0,30789115
17094,0001-20100315-59-2644-1-5749,1,2010-03-15,111,現金,旅費,2142,0,30791257
17097,0001-20100315-59-2644-1-5749,4,2010-03-15,111,現金,ＪＲ代,1523,0,30792780
17100,0001-20100315-74-2645-1-5751,1,2010-03-15,111,現金,飲食代　スナックかりん,1030,0,30793810
17117,0001-20100315-93-2647-1-5755,3,2010-03-15,152,売掛金,10年3月15日伝票No465五越株式会社,40,0,30793850
17125,0001-20100315-94-2648-1-5757,3,2010-03-15,152,売掛金,10年3月15日伝票No466株式会社　エントリー,40,0,30793890
17133,0001-20100315-95-2649-1-5759,3,2010-03-15,152,売掛金,10年3月15日伝票No467タワー株式会社,40,0,30793930
17141,0001-20100315-96-2650-1-5761,3,2010-03-15,152,売掛金,10年3月15日伝票No468高橋物産株式会社,40,0,30793970
17154,0001-20100315-98-2652-1-5765,3,2010-03-15,152,売掛金,10年3月15日伝票No470株式会社　久城商事,15,0,30793985
17163,0001-20100316-103-2655-1-5771,1,2010-03-16,111,現金,食事代　串揚げ一心2名,270,0,30794255
17170,0001-20100316-136-2657-1-5775,1,2010-03-16,111,現金,ダスキン代,785,0,30795040
17174,0001-20100316-148-2658-1-5777,1,2010-03-16,111,現金,ガソリン代,265,0,30795305
17178,0001-20100316-149-2659-1-5779,1,2010-03-16,111,現金,手土産代　五越百貨店,174,0,30795479
17181,0001-20100316-149-2659-1-5779,4,2010-03-16,111,現金,コーヒー代他2名,116,0,30795595
17184,0001-20100317-23-2660-1-5781,1,2010-03-17,111,現金,旅費,2704,0,30798299
17187,0001-20100317-23-2660-1-5781,4,2010-03-17,111,現金,旅費,2000,0,30800299
17189,0001-20100317-23-2660-1-5781,6,2010-03-17,111,現金,旅費,2847,0,30803146
17192,0001-20100317-47-2661-1-5783,1,2010-03-17,111,現金,ガソリン代,120,0,30803266
17196,0001-20100317-52-2662-1-5785,1,2010-03-17,111,現金,高速代,54,0,30803320
17199,0001-20100317-52-2662-1-5785,4,2010-03-17,111,現金,高速代,54,0,30803374
17201,0001-20100317-52-2662-1-5785,6,2010-03-17,111,現金,高速代,71,0,30803445
17204,0001-20100317-94-2663-1-5787,1,2010-03-17,111,現金,トイレットペーパー他,148,0,30803593
17208,0001-20100318-152-2664-1-5789,1,2010-03-18,111,現金,飲食代　バー湯の瀬2名,450,0,30804043
17215,0001-20100319-160-2669-1-5799,1,2010-03-19,111,現金,出張旅費,2842,0,30806885
17219,0001-20100319-71-2667-1-5795,1,2010-03-19,111,現金,ゴルフプレー代2名,1333,0,30808218
17223,0001-20100319-8-2666-1-5793,1,2010-03-19,111,現金,定例ミーティング会費,952,0,30809170
17227,0001-20100319-80-2668-1-5797,1,2010-03-19,111,現金,旅費,571,0,30809741
17234,0001-20100320-101-2682-1-5825,1,2010-03-20,322,未払金,広告料,2500,0,30812241
17241,0001-20100320-101-2682-1-5825,6,2010-03-20,152,売掛金,10年3月20日伝票No472合同会社　たかだ,22,0,30812263
17249,0001-20100320-102-2683-1-5827,3,2010-03-20,152,売掛金,10年3月20日伝票No473株式会社　ＹＡＧ,35,0,30812298
17268,0001-20100320-109-2687-1-5835,1,2010-03-20,322,未払金,ガソリン代,3761,0,30816059
17272,0001-20100320-118-2688-1-5837,1,2010-03-20,322,未払金,コピー代,404,0,30816463
17276,0001-20100320-135-2689-1-5839,1,2010-03-20,322,未払金,事務用品,129,0,30816592
17290,0001-20100320-141-2692-1-5845,1,2010-03-20,111,現金,JR代,2523,0,30819115
17301,0001-20100320-156-2694-1-5849,1,2010-03-20,111,現金,出張旅費,761,0,30819876
17305,0001-20100320-159-2695-1-5851,1,2010-03-20,111,現金,タクシー代,419,0,30820295
17309,0001-20100320-165-2696-1-5853,1,2010-03-20,111,現金,懇親会会費,476,0,30820771
17313,0001-20100320-31-2670-1-5801,1,2010-03-20,322,未払金,コピー代,166,0,30820937
17317,0001-20100320-45-2671-1-5803,1,2010-03-20,111,現金,コーヒー代2名,60,0,30820997
17321,0001-20100320-48-2672-1-5805,1,2010-03-20,111,現金,ガソリン代,204,0,30821201
17325,0001-20100320-53-2673-1-5807,1,2010-03-20,111,現金,高速代,19,0,30821220
17328,0001-20100320-53-2673-1-5807,4,2010-03-20,111,現金,高速代,50,0,30821270
17330,0001-20100320-53-2673-1-5807,6,2010-03-20,111,現金,高速代,50,0,30821320
17333,0001-20100320-67-2674-1-5809,1,2010-03-20,322,未払金,有線,238,0,30821558
17337,0001-20100320-69-2675-1-5811,1,2010-03-20,322,未払金,カウンター料金,300,0,30821858
17341,0001-20100320-71-2676-1-5813,1,2010-03-20,322,未払金,事務用品,172,0,30822030
17344,0001-20100320-71-2676-1-5813,4,2010-03-20,322,未払金,カウンター料金,1905,0,30823935
17347,0001-20100320-73-2677-1-5815,1,2010-03-20,322,未払金,ファイル等,1963,0,30825898
17350,0001-20100320-73-2677-1-5815,4,2010-03-20,322,未払金,飲料水,12190,0,30838088
17352,0001-20100320-73-2677-1-5815,6,2010-03-20,322,未払金,名刺代,3238,0,30841326
17355,0001-20100320-79-2678-1-5817,1,2010-03-20,111,現金,景品代,4691,0,30846017
17359,0001-20100320-97-2679-1-5819,1,2010-03-20,322,未払金,コピー代,1958,0,30847975
17363,0001-20100320-98-2680-1-5821,1,2010-03-20,322,未払金,事務用品,308,0,30848283
17367,0001-20100321-132-2702-1-5865,1,2010-03-21,131,普通預金,電気代,5749,0,30854032
17372,0001-20100321-132-2702-1-5865,4,2010-03-21,131,普通預金,水道代,313,0,30854345
17378,0001-20100321-169-2704-1-5869,1,2010-03-21,131,普通預金,電気料,6106,0,30860451
17383,0001-20100321-169-2704-1-5869,4,2010-03-21,131,普通預金,水道料,316,0,30860767
17386,0001-20100321-25-2698-1-5857,1,2010-03-21,111,現金,旅費,2666,0,30863433
17390,0001-20100321-34-2699-1-5859,1,2010-03-21,131,普通預金,電気代,5359,0,30868792
17395,0001-20100321-34-2699-1-5859,4,2010-03-21,131,普通預金,水道代,286,0,30869078
17398,0001-20100321-6-2697-1-5855,1,2010-03-21,111,現金,広告料,238,0,30869316
17402,0001-20100321-64-2700-1-5861,1,2010-03-21,131,普通預金,電気料,10802,0,30880118
17407,0001-20100321-64-2700-1-5861,4,2010-03-21,131,普通預金,水道料,413,0,30880531
17410,0001-20100321-89-2701-1-5863,1,2010-03-21,131,普通預金,電気料,4805,0,30885336
17415,0001-20100321-89-2701-1-5863,4,2010-03-21,131,普通預金,水道料,247,0,30885583
17417,0001-20100321-89-2701-1-5863,6,2010-03-21,131,普通預金,ガス代,277,0,30885860
17420,0001-20100322-107-2710-1-5881,1,2010-03-22,111,現金,お見舞い,476,0,30886336
17424,0001-20100322-157-2711-1-5883,1,2010-03-22,131,普通預金,航空券代,1895,0,30888231
17430,0001-20100322-166-2712-1-5885,1,2010-03-22,111,現金,ダスキン代,90,0,30888321
17434,0001-20100322-24-2706-1-5873,1,2010-03-22,111,現金,JR回数券,4380,0,30892701
17438,0001-20100322-3-2705-1-5871,1,2010-03-22,322,未払金,宿泊代,1532,0,30894233
17442,0001-20100322-74-2707-1-5875,1,2010-03-22,111,現金,ガソリン代,338,0,30894571
17445,0001-20100322-74-2707-1-5875,4,2010-03-22,111,現金,高速代,257,0,30894828
17448,0001-20100322-90-2708-1-5877,1,2010-03-22,111,現金,ダスキン代,452,0,30895280
17452,0001-20100322-95-2709-1-5879,1,2010-03-22,322,未払金,清掃料,3413,0,30898693
17456,0001-20100323-12-2713-1-5887,1,2010-03-23,111,現金,ガソリン代,164,0,30898857
17459,0001-20100323-12-2713-1-5887,4,2010-03-23,111,現金,駐車代,38,0,30898895
17462,0001-20100323-140-2718-1-5897,1,2010-03-23,111,現金,旅費,585,0,30899480
17466,0001-20100323-28-2714-1-5889,1,2010-03-23,322,未払金,タクシー代,115,0,30899595
17470,0001-20100323-54-2715-1-5891,1,2010-03-23,111,現金,高速代,90,0,30899685
17473,0001-20100323-54-2715-1-5891,4,2010-03-23,111,現金,高速代,128,0,30899813
17476,0001-20100323-75-2716-1-5893,1,2010-03-23,111,現金,ガソリン代,284,0,30900097
17595,0001-20100324-108-2723-1-5907,1,2010-03-24,111,現金,食事代,64,0,30900161
17599,0001-20100324-146-2724-1-5909,1,2010-03-24,322,未払金,業務委託費,8000,0,30908161
17603,0001-20100324-154-2725-1-5911,1,2010-03-24,322,未払金,お花代　結婚式,600,0,30908761
17608,0001-20100324-172-2726-1-5913,1,2010-03-24,322,未払金,業務委託費支払い,9000,0,30917761
17612,0001-20100324-26-2719-1-5899,1,2010-03-24,111,現金,旅費,1476,0,30919237
17616,0001-20100324-29-2720-1-5901,1,2010-03-24,131,普通預金,携帯電話代,3794,0,30923031
17622,0001-20100324-60-2721-1-5903,1,2010-03-24,322,未払金,お茶代,976,0,30924007
17626,0001-20100324-81-2722-1-5905,1,2010-03-24,322,未払金,お茶代,2180,0,30926187
17637,0001-20100325-107-2729-1-5919,3,2010-03-25,152,売掛金,10年3月25日伝票No475株式会社　総合経営,35,0,30926222
17645,0001-20100325-108-2730-1-5921,3,2010-03-25,152,売掛金,10年3月25日伝票No476株式会社　鎌田商店,30,0,30926252
17653,0001-20100325-109-2731-1-5923,3,2010-03-25,152,売掛金,10年3月25日伝票No477株式会社　小林マーケット,40,0,30926292
17657,0001-20100325-111-2732-1-5925,1,2010-03-25,322,未払金,タクシー代,804,0,30927096
17661,0001-20100325-120-2733-1-5927,1,2010-03-25,322,未払金,業務委託費,45000,0,30972096
17665,0001-20100325-121-2734-1-5929,1,2010-03-25,111,現金,お茶代,785,0,30972881
17674,0001-20100325-138-2736-1-5933,1,2010-03-25,111,現金,高速代,217,0,30973098
17677,0001-20100325-138-2736-1-5933,4,2010-03-25,111,現金,ガソリン代,170,0,30973268
17679,0001-20100325-138-2736-1-5933,6,2010-03-25,111,現金,高速代,284,0,30973552
17681,0001-20100325-138-2736-1-5933,8,2010-03-25,111,現金,高速代,214,0,30973766
17683,0001-20100325-138-2736-1-5933,10,2010-03-25,111,現金,高速代,128,0,30973894
17685,0001-20100325-138-2736-1-5933,12,2010-03-25,111,現金,高速代,54,0,30973948
17687,0001-20100325-138-2736-1-5933,14,2010-03-25,111,現金,駐車代,168,0,30974116
17693,0001-20100325-78-2727-1-5915,1,2010-03-25,322,未払金,業務委託費支払い,9000,0,30983116
17697,0001-20100326-105-2745-1-5951,1,2010-03-26,111,現金,飲食代　居酒屋ラッキー4名,593,0,30983709
17700,0001-20100326-105-2745-1-5951,4,2010-03-26,111,現金,飲食代　スナック北新地,1254,0,30984963
17703,0001-20100326-113-2746-1-5953,1,2010-03-26,131,普通預金,携帯代,5260,0,30990223
17709,0001-20100326-139-2747-1-5955,1,2010-03-26,322,未払金,社員夜食代,3097,0,30993320
17713,0001-20100326-171-2748-1-5957,1,2010-03-26,131,普通預金,携帯代,2718,0,30996038
17719,0001-20100326-35-2738-1-5937,1,2010-03-26,111,現金,新聞代,186,0,30996224
17723,0001-20100326-37-2739-1-5939,1,2010-03-26,322,未払金,業務委託費,72952,0,31069176
17727,0001-20100326-38-2740-1-5941,1,2010-03-26,322,未払金,宿泊費,2293,0,31071469
17731,0001-20100326-62-2741-1-5943,1,2010-03-26,131,普通預金,携帯代,4740,0,31076209
17737,0001-20100326-75-2742-1-5945,1,2010-03-26,111,現金,コーヒー代2名,60,0,31076269
17741,0001-20100326-76-2743-1-5947,1,2010-03-26,111,現金,ガソリン代,248,0,31076517
17744,0001-20100326-76-2743-1-5947,4,2010-03-26,111,現金,駐車代,28,0,31076545
17747,0001-20100326-88-2744-1-5949,1,2010-03-26,111,現金,新聞代,169,0,31076714
17751,0001-20100327-114-2755-1-5971,1,2010-03-27,111,現金,新聞代,126,0,31076840
17754,0001-20100327-114-2755-1-5971,4,2010-03-27,111,現金,新聞代,143,0,31076983
17757,0001-20100327-14-2749-1-5959,1,2010-03-27,111,現金,ガソリン代,142,0,31077125
17766,0001-20100327-32-2751-1-5963,1,2010-03-27,322,未払金,事務用品費,147,0,31077272
17770,0001-20100327-60-2752-1-5965,1,2010-03-27,111,現金,旅費,533,0,31077805
17774,0001-20100327-72-2753-1-5967,1,2010-03-27,111,現金,新聞代,143,0,31077948
17777,0001-20100327-72-2753-1-5967,4,2010-03-27,111,現金,新聞代,140,0,31078088
17779,0001-20100327-72-2753-1-5967,6,2010-03-27,111,現金,新聞代,169,0,31078257
17782,0001-20100327-87-2754-1-5969,1,2010-03-27,131,普通預金,携帯代,1978,0,31080235
17788,0001-20100328-137-2759-1-5979,1,2010-03-28,322,未払金,有線,300,0,31080535
17791,0001-20100328-137-2759-1-5979,4,2010-03-28,322,未払金,警備料,2142,0,31082677
17793,0001-20100328-137-2759-1-5979,6,2010-03-28,131,普通預金,高速料,2031,0,31084708
17798,0001-20100328-137-2759-1-5979,9,2010-03-28,322,未払金,清掃料,2766,0,31087474
17802,0001-20100328-170-2760-1-5981,1,2010-03-28,111,現金,新聞代,143,0,31087617
17806,0001-20100328-39-2757-1-5975,1,2010-03-28,111,現金,会費,428,0,31088045
17810,0001-20100328-81-2758-1-5977,1,2010-03-28,111,現金,ＪＲ代,466,0,31088511
17814,0001-20100328-9-2756-1-5973,1,2010-03-28,111,現金,手土産代　総合経営,250,0,31088761
17818,0001-20100329-27-2761-1-5983,1,2010-03-29,111,現金,旅費,2216,0,31090977
17821,0001-20100329-27-2761-1-5983,4,2010-03-29,111,現金,旅費,2800,0,31093777
17823,0001-20100329-27-2761-1-5983,6,2010-03-29,111,現金,旅費,1542,0,31095319
17826,0001-20100329-83-2762-1-5985,1,2010-03-29,111,現金,車両管理費,2452,0,31097771
17844,0001-20100330-155-2765-1-5991,1,2010-03-30,111,現金,ガソリン代,340,0,31098111
17847,0001-20100330-155-2765-1-5991,4,2010-03-30,111,現金,高速代,57,0,31098168
17850,0001-20100331-1-2766-1-5993,1,2010-03-31,322,未払金,運賃　佐川急便,11629,0,31109797
17854,0001-20100331-100-2785-1-6031,1,2010-03-31,111,現金,会費,285,0,31110082
17957,0001-20100331-115-2791-1-6043,3,2010-03-31,152,売掛金,10年3月31日伝票No478マークマーケット,40,0,31110122
17969,0001-20100331-116-2792-1-6045,3,2010-03-31,152,売掛金,10年3月31日伝票No479株式会社　ＡＢＣ,40,0,31110162
17972,0001-20100331-116-2792-1-6045,6,2010-03-31,131,普通預金,リース料,4000,0,31114162
17988,0001-20100331-119-2795-1-6051,3,2010-03-31,152,売掛金,10年3月31日伝票No482株式会社　畠山商事,30,0,31114192
17996,0001-20100331-120-2796-1-6053,3,2010-03-31,152,売掛金,10年3月31日伝票No483株式会社　千代サービス,10,0,31114202
18000,0001-20100331-121-2797-1-6055,1,2010-03-31,312,買掛金,10年3月1日～10年3月31日分仕入,4896,0,31119098
18003,0001-20100331-121-2797-1-6055,4,2010-03-31,312,買掛金,10年3月1日～10年3月31日分仕入,7689,0,31126787
18007,0001-20100331-122-2798-1-6057,1,2010-03-31,312,買掛金,10年3月1日～10年3月31日分仕入,76407,0,31203194
18010,0001-20100331-122-2798-1-6057,4,2010-03-31,312,買掛金,10年3月1日～10年3月31日分仕入,33746,0,31236940
18013,0001-20100331-122-2798-1-6057,7,2010-03-31,312,買掛金,10年3月1日～10年3月31日分仕入,157444,0,31394384
18016,0001-20100331-122-2798-1-6057,10,2010-03-31,312,買掛金,10年3月1日～10年3月31日分仕入,183852,0,31578236
18019,0001-20100331-122-2798-1-6057,13,2010-03-31,312,買掛金,10年3月1日～10年3月31日分仕入,369393,0,31947629
18022,0001-20100331-122-2798-1-6057,16,2010-03-31,312,買掛金,10年3月1日～10年3月31日分仕入,273145,0,32220774
18025,0001-20100331-122-2798-1-6057,19,2010-03-31,312,買掛金,10年3月1日～10年3月31日分仕入,17675,0,32238449
18028,0001-20100331-122-2798-1-6057,22,2010-03-31,312,買掛金,10年3月1日～10年3月31日分仕入,2203,0,32240652
18032,0001-20100331-123-2799-1-6059,1,2010-03-31,312,買掛金,10年3月1日～10年3月31日分仕入,116050,0,32356702
18035,0001-20100331-123-2799-1-6059,4,2010-03-31,312,買掛金,10年3月1日～10年3月31日分仕入,75783,0,32432485
18038,0001-20100331-123-2799-1-6059,7,2010-03-31,312,買掛金,10年3月1日～10年3月31日分仕入,201499,0,32633984
18041,0001-20100331-123-2799-1-6059,10,2010-03-31,312,買掛金,10年3月1日～10年3月31日分仕入,4896,0,32638880
18044,0001-20100331-123-2799-1-6059,13,2010-03-31,312,買掛金,10年3月1日～10年3月31日分仕入,15271,0,32654151
18048,0001-20100331-124-2800-1-6061,1,2010-03-31,312,買掛金,10年3月1日～10年3月31日分仕入,219768,0,32873919
18051,0001-20100331-124-2800-1-6061,4,2010-03-31,312,買掛金,10年3月1日～10年3月31日分仕入,209639,0,33083558
18054,0001-20100331-124-2800-1-6061,7,2010-03-31,312,買掛金,10年3月1日～10年3月31日分仕入,50335,0,33133893
18057,0001-20100331-124-2800-1-6061,10,2010-03-31,312,買掛金,10年3月1日～10年3月31日分仕入,7344,0,33141237
18060,0001-20100331-124-2800-1-6061,13,2010-03-31,312,買掛金,10年3月1日～10年3月31日分仕入,177367,0,33318604
18063,0001-20100331-124-2800-1-6061,16,2010-03-31,312,買掛金,10年3月1日～10年3月31日分仕入,29472,0,33348076
18066,0001-20100331-124-2800-1-6061,19,2010-03-31,312,買掛金,10年3月1日～10年3月31日分仕入,2040,0,33350116
18070,0001-20100331-125-2801-1-6063,1,2010-03-31,312,買掛金,10年3月1日～10年3月31日分仕入,10359,0,33360475
18073,0001-20100331-125-2801-1-6063,4,2010-03-31,312,買掛金,10年3月1日～10年3月31日分仕入,4896,0,33365371
18093,0001-20100331-13-2768-1-5997,1,2010-03-31,111,現金,ガソリン代,476,0,33365847
18165,0001-20100331-145-2816-1-6093,1,2010-03-31,322,未払金,運賃,30266,0,33396113
18184,0001-20100331-15-2769-1-5999,1,2010-03-31,111,現金,洗車代,142,0,33396255
18219,0001-20100331-36-2770-1-6001,1,2010-03-31,322,未払金,運賃　ヤマト運輸,68848,0,33465103
18222,0001-20100331-36-2770-1-6001,4,2010-03-31,322,未払金,運賃　佐川急便,39641,0,33504744
18225,0001-20100331-40-2771-1-6003,1,2010-03-31,322,未払金,広告掲載,2380,0,33507124
18229,0001-20100331-49-2772-1-6005,1,2010-03-31,322,未払金,ガソリン代,7784,0,33514908
18232,0001-20100331-49-2772-1-6005,4,2010-03-31,111,現金,ガソリン代,131,0,33515039
18235,0001-20100331-49-2772-1-6005,7,2010-03-31,111,現金,ガソリン代,286,0,33515325
18238,0001-20100331-5-2767-1-5995,1,2010-03-31,131,普通預金,広告費,2500,0,33517825
18244,0001-20100331-55-2773-1-6007,1,2010-03-31,111,現金,車両管理費,1190,0,33519015
18247,0001-20100331-55-2773-1-6007,4,2010-03-31,111,現金,車両管理費,1333,0,33520348
18249,0001-20100331-55-2773-1-6007,6,2010-03-31,111,現金,高速代,383,0,33520731
18266,0001-20100331-66-2776-1-6013,1,2010-03-31,131,普通預金,リース料,9992,0,33530723
18275,0001-20100331-70-2778-1-6017,1,2010-03-31,322,未払金,有線,300,0,33531023
18278,0001-20100331-70-2778-1-6017,4,2010-03-31,322,未払金,警備料,2619,0,33533642
18280,0001-20100331-70-2778-1-6017,6,2010-03-31,131,普通預金,高速料,3491,0,33537133
18285,0001-20100331-70-2778-1-6017,9,2010-03-31,322,未払金,清掃料,3500,0,33540633
18298,0001-20100331-77-2780-1-6021,1,2010-03-31,322,未払金,運賃,9647,0,33550280
18309,0001-20100331-93-2782-1-6025,1,2010-03-31,322,未払金,修繕費,850,0,33551130
18326,0001-20100331-96-2783-1-6027,1,2010-03-31,131,普通預金,警備料,1070,0,33552200
18332,0001-20100331-99-2784-1-6029,1,2010-03-31,322,未払金,運賃,46543,0,33598743
,,,2010-03,,※※月計※※,,3066516,0,33598743
