num,GL02,GL02-GL55,date,contra_acct,contra_acct_name,note,dbt_amount,cdt_amount,balance
,,,,322,未払金,,97455856,98918891,-1463035
53,0001-20090405-139-12-1-485,0,2009-04-05,724,福利厚生費,制服代,0,52981,-52981
54,0001-20090405-139-12-1-485,1,2009-04-05,191,仮払消費税等,制服代,0,2649,-55630
81,0001-20090405-76-10-1-481,0,2009-04-05,724,福利厚生費,制服代,0,53334,-108964
82,0001-20090405-76-10-1-481,1,2009-04-05,191,仮払消費税等,制服代,0,2666,-111630
106,0001-20090406-147-23-1-507,0,2009-04-06,740,車両費,ガソリン代,0,4882,-116512
107,0001-20090406-147-23-1-507,1,2009-04-06,191,仮払消費税等,ガソリン代,0,244,-116756
216,0001-20090410-168-46-1-553,0,2009-04-10,791,雑費,有線,0,6000,-122756
217,0001-20090410-168-46-1-553,1,2009-04-10,191,仮払消費税等,有線,0,300,-123056
219,0001-20090410-168-46-1-553,3,2009-04-10,791,雑費,警備料,0,42858,-165914
220,0001-20090410-168-46-1-553,4,2009-04-10,191,仮払消費税等,警備料,0,2142,-168056
244,0001-20090410-234-50-1-561,0,2009-04-10,791,雑費,有線,0,5000,-173056
245,0001-20090410-234-50-1-561,1,2009-04-10,191,仮払消費税等,有線,0,250,-173306
247,0001-20090410-234-50-1-561,3,2009-04-10,791,雑費,警備料,0,34286,-207592
248,0001-20090410-234-50-1-561,4,2009-04-10,191,仮払消費税等,警備料,0,1714,-209306
462,0001-20090415-4-73-1-607,0,2009-04-15,732,広告宣伝費,広告費,0,30000,-239306
463,0001-20090415-4-73-1-607,1,2009-04-15,191,仮払消費税等,広告費,0,1500,-240806
519,0001-20090420-101-109-1-679,0,2009-04-20,732,広告宣伝費,広告料,0,50000,-290806
520,0001-20090420-101-109-1-679,1,2009-04-20,191,仮払消費税等,広告料,0,2500,-293306
523,0001-20090420-118-110-1-681,0,2009-04-20,754,事務用消耗品費,コピー代,0,6678,-299984
524,0001-20090420-118-110-1-681,1,2009-04-20,191,仮払消費税等,コピー代,0,333,-300317
535,0001-20090420-135-112-1-685,0,2009-04-20,754,事務用消耗品費,事務用品,0,2972,-303289
536,0001-20090420-135-112-1-685,1,2009-04-20,191,仮払消費税等,事務用品,0,148,-303437
560,0001-20090420-235-117-1-695,0,2009-04-20,754,事務用消耗品費,カウンター料金,0,6000,-309437
561,0001-20090420-235-117-1-695,1,2009-04-20,191,仮払消費税等,カウンター料金,0,300,-309737
568,0001-20090420-241-118-1-697,0,2009-04-20,737,消耗品費,ファイル等,0,33981,-343718
569,0001-20090420-241-118-1-697,1,2009-04-20,191,仮払消費税等,ファイル等,0,1699,-345417
571,0001-20090420-241-118-1-697,3,2009-04-20,737,消耗品費,飲料水,0,239048,-584465
572,0001-20090420-241-118-1-697,4,2009-04-20,191,仮払消費税等,飲料水,0,11952,-596417
573,0001-20090420-241-118-1-697,5,2009-04-20,737,消耗品費,名刺代,0,79048,-675465
574,0001-20090420-241-118-1-697,6,2009-04-20,191,仮払消費税等,名刺代,0,3952,-679417
614,0001-20090420-31-98-1-657,0,2009-04-20,754,事務用消耗品費,コピー代,0,2552,-681969
615,0001-20090420-31-98-1-657,1,2009-04-20,191,仮払消費税等,コピー代,0,127,-682096
660,0001-20090420-71-104-1-669,0,2009-04-20,754,事務用消耗品費,事務用品,0,2458,-684554
661,0001-20090420-71-104-1-669,1,2009-04-20,191,仮払消費税等,事務用品,0,122,-684676
663,0001-20090420-71-104-1-669,3,2009-04-20,754,事務用消耗品費,事務用品,0,16169,-700845
664,0001-20090420-71-104-1-669,4,2009-04-20,191,仮払消費税等,事務用品,0,808,-701653
665,0001-20090420-71-104-1-669,5,2009-04-20,754,事務用消耗品費,カウンター料金,0,30464,-732117
666,0001-20090420-71-104-1-669,6,2009-04-20,191,仮払消費税等,カウンター料金,0,1523,-733640
678,0001-20090420-94-106-1-673,0,2009-04-20,791,雑費,有線,0,4762,-738402
679,0001-20090420-94-106-1-673,1,2009-04-20,191,仮払消費税等,有線,0,238,-738640
682,0001-20090420-97-107-1-675,0,2009-04-20,754,事務用消耗品費,コピー代,0,37264,-775904
683,0001-20090420-97-107-1-675,1,2009-04-20,191,仮払消費税等,コピー代,0,1863,-777767
686,0001-20090420-98-108-1-677,0,2009-04-20,754,事務用消耗品費,事務用品,0,15000,-792767
687,0001-20090420-98-108-1-677,1,2009-04-20,191,仮払消費税等,事務用品,0,750,-793517
740,0001-20090422-3-130-1-721,0,2009-04-22,724,福利厚生費,宿泊代,0,28489,-822006
741,0001-20090422-3-130-1-721,1,2009-04-22,191,仮払消費税等,宿泊代,0,1424,-823430
744,0001-20090422-38-131-1-723,0,2009-04-22,724,福利厚生費,宿泊費,0,45871,-869301
745,0001-20090422-38-131-1-723,1,2009-04-22,191,仮払消費税等,宿泊費,0,2293,-871594
752,0001-20090422-95-133-1-727,0,2009-04-22,791,雑費,清掃料,0,68262,-939856
753,0001-20090422-95-133-1-727,1,2009-04-22,191,仮払消費税等,清掃料,0,3413,-943269
772,0001-20090423-28-142-1-745,0,2009-04-23,726,旅費交通費,タクシー代,0,2305,-945574
773,0001-20090423-28-142-1-745,1,2009-04-23,191,仮払消費税等,タクシー代,0,115,-945689
776,0001-20090423-32-143-1-747,0,2009-04-23,754,事務用消耗品費,事務用品費,0,1762,-947451
777,0001-20090423-32-143-1-747,1,2009-04-23,191,仮払消費税等,事務用品費,0,88,-947539
804,0001-20090425-111-156-1-773,0,2009-04-25,726,旅費交通費,タクシー代,0,11810,-959349
805,0001-20090425-111-156-1-773,1,2009-04-25,191,仮払消費税等,タクシー代,0,590,-959939
829,0001-20090425-146-161-1-783,0,2009-04-25,728,業務委託費,業務委託費,0,140000,-1099939
830,0001-20090425-146-161-1-783,1,2009-04-25,191,仮払消費税等,業務委託費,0,7000,-1106939
843,0001-20090425-172-164-1-789,0,2009-04-25,728,業務委託費,業務委託費支払い,0,134286,-1241225
844,0001-20090425-172-164-1-789,1,2009-04-25,191,仮払消費税等,業務委託費支払い,0,6714,-1247939
1001,0001-20090425-92-155-1-771,0,2009-04-25,753,修繕維持費,コピー機修繕,0,17143,-1265082
1002,0001-20090425-92-155-1-771,1,2009-04-25,191,仮払消費税等,コピー機修繕,0,857,-1265939
1005,0001-20090426-109-173-1-807,0,2009-04-26,740,車両費,ガソリン代,0,6770,-1272709
1006,0001-20090426-109-173-1-807,1,2009-04-26,191,仮払消費税等,ガソリン代,0,338,-1273047
1009,0001-20090426-120-174-1-809,0,2009-04-26,728,業務委託費,業務委託費,0,500000,-1773047
1010,0001-20090426-120-174-1-809,1,2009-04-26,191,仮払消費税等,業務委託費,0,25000,-1798047
1041,0001-20090426-78-171-1-803,0,2009-04-26,728,業務委託費,業務委託費支払い,0,180000,-1978047
1042,0001-20090426-78-171-1-803,1,2009-04-26,191,仮払消費税等,業務委託費支払い,0,9000,-1987047
1049,0001-20090427-1-177-1-815,0,2009-04-27,731,運賃,運賃　佐川急便,0,85543,-2072590
1050,0001-20090427-1-177-1-815,1,2009-04-27,191,仮払消費税等,運賃　佐川急便,0,4277,-2076867
1053,0001-20090427-13-179-1-819,0,2009-04-27,740,車両費,ガソリン代,0,11990,-2088857
1054,0001-20090427-13-179-1-819,1,2009-04-27,191,仮払消費税等,ガソリン代,0,599,-2089456
1070,0001-20090427-37-183-1-827,0,2009-04-27,728,業務委託費,業務委託費,0,1203810,-3293266
1071,0001-20090427-37-183-1-827,1,2009-04-27,191,仮払消費税等,業務委託費,0,60190,-3353456
1104,0001-20090428-93-187-1-835,0,2009-04-28,753,修繕維持費,修繕費,0,17000,-3370456
1105,0001-20090428-93-187-1-835,1,2009-04-28,191,仮払消費税等,修繕費,0,850,-3371306
1126,0001-20090430-137-209-1-879,0,2009-04-30,791,雑費,有線,0,6000,-3377306
1127,0001-20090430-137-209-1-879,1,2009-04-30,191,仮払消費税等,有線,0,300,-3377606
1129,0001-20090430-137-209-1-879,3,2009-04-30,791,雑費,警備料,0,42858,-3420464
1130,0001-20090430-137-209-1-879,4,2009-04-30,191,仮払消費税等,警備料,0,2142,-3422606
1136,0001-20090430-137-209-1-879,8,2009-04-30,791,雑費,清掃料,0,70000,-3492606
1137,0001-20090430-137-209-1-879,9,2009-04-30,191,仮払消費税等,清掃料,0,3500,-3496106
1146,0001-20090430-145-211-1-883,0,2009-04-30,731,運賃,運賃,0,145334,-3641440
1147,0001-20090430-145-211-1-883,1,2009-04-30,191,仮払消費税等,運賃,0,7266,-3648706
1150,0001-20090430-154-212-1-885,0,2009-04-30,733,交際接待費,お花代,0,12000,-3660706
1151,0001-20090430-154-212-1-885,1,2009-04-30,191,仮払消費税等,お花代,0,600,-3661306
1153,0001-20090430-154-212-1-885,3,2009-04-30,733,交際接待費,香典代,0,10000,-3671306
1469,0001-20090430-306-242-1-945,1,2009-04-30,131,普通預金,3月分支払,7584692,0,3913386
1490,0001-20090430-36-190-1-841,0,2009-04-30,731,運賃,運賃　ヤマト運輸,0,1536351,2377035
1491,0001-20090430-36-190-1-841,1,2009-04-30,191,仮払消費税等,運賃　ヤマト運輸,0,76817,2300218
1493,0001-20090430-36-190-1-841,3,2009-04-30,731,運賃,運賃　佐川急便,0,1041181,1259037
1494,0001-20090430-36-190-1-841,4,2009-04-30,191,仮払消費税等,運賃　佐川急便,0,52059,1206978
1496,0001-20090430-40-191-1-843,0,2009-04-30,732,広告宣伝費,広告掲載,0,47620,1159358
1497,0001-20090430-40-191-1-843,1,2009-04-30,191,仮払消費税等,広告掲載,0,2380,1156978
1500,0001-20090430-49-192-1-845,0,2009-04-30,740,車両費,ガソリン代,0,155686,1001292
1501,0001-20090430-49-192-1-845,1,2009-04-30,191,仮払消費税等,ガソリン代,0,7784,993508
1543,0001-20090430-70-198-1-857,0,2009-04-30,791,雑費,有線,0,6000,987508
1544,0001-20090430-70-198-1-857,1,2009-04-30,191,仮払消費税等,有線,0,300,987208
1546,0001-20090430-70-198-1-857,3,2009-04-30,791,雑費,警備料,0,52381,934827
1547,0001-20090430-70-198-1-857,4,2009-04-30,191,仮払消費税等,警備料,0,2619,932208
1548,0001-20090430-70-198-1-857,5,2009-04-30,791,雑費,清掃料,0,70000,862208
1549,0001-20090430-70-198-1-857,6,2009-04-30,191,仮払消費税等,清掃料,0,3500,858708
1552,0001-20090430-77-199-1-859,0,2009-04-30,731,運賃,運賃,0,167205,691503
1553,0001-20090430-77-199-1-859,1,2009-04-30,191,仮払消費税等,運賃,0,8360,683143
1556,0001-20090430-81-200-1-861,0,2009-04-30,724,福利厚生費,お茶代,0,20000,663143
1557,0001-20090430-81-200-1-861,1,2009-04-30,191,仮払消費税等,お茶代,0,1000,662143
1560,0001-20090430-82-201-1-863,0,2009-04-30,740,車両費,ガソリン代,0,21016,641127
1561,0001-20090430-82-201-1-863,1,2009-04-30,191,仮払消費税等,ガソリン代,0,1050,640077
1574,0001-20090430-99-204-1-869,0,2009-04-30,731,運賃,運賃,0,556791,83286
1575,0001-20090430-99-204-1-869,1,2009-04-30,191,仮払消費税等,運賃,0,27839,55447
,,,2009-04,,※※月計※※,,7584692,7529245,
1578,0001-20090501-148-247-1-955,0,2009-05-01,724,福利厚生費,制服代,0,50953,4494
1579,0001-20090501-148-247-1-955,1,2009-05-01,191,仮払消費税等,制服代,0,2547,1947
1593,0001-20090502-149-250-1-961,0,2009-05-02,724,福利厚生費,制服代,0,66977,-65030
1594,0001-20090502-149-250-1-961,1,2009-05-02,191,仮払消費税等,制服代,0,3348,-68378
1605,0001-20090505-139-258-1-977,0,2009-05-05,724,福利厚生費,制服代,0,52981,-121359
1606,0001-20090505-139-258-1-977,1,2009-05-05,191,仮払消費税等,制服代,0,2649,-124008
1694,0001-20090508-147-275-1-1011,0,2009-05-08,740,車両費,ガソリン代,0,6326,-130334
1695,0001-20090508-147-275-1-1011,1,2009-05-08,191,仮払消費税等,ガソリン代,0,316,-130650
1739,0001-20090510-168-293-1-1047,0,2009-05-10,791,雑費,有線,0,6000,-136650
1740,0001-20090510-168-293-1-1047,1,2009-05-10,191,仮払消費税等,有線,0,300,-136950
1742,0001-20090510-168-293-1-1047,3,2009-05-10,791,雑費,警備料,0,42858,-179808
1743,0001-20090510-168-293-1-1047,4,2009-05-10,191,仮払消費税等,警備料,0,2142,-181950
1767,0001-20090510-68-281-1-1023,0,2009-05-10,791,雑費,有線,0,5000,-186950
1768,0001-20090510-68-281-1-1023,1,2009-05-10,191,仮払消費税等,有線,0,250,-187200
1770,0001-20090510-68-281-1-1023,3,2009-05-10,791,雑費,警備料,0,34286,-221486
1771,0001-20090510-68-281-1-1023,4,2009-05-10,191,仮払消費税等,警備料,0,1714,-223200
1969,0001-20090515-61-316-1-1093,0,2009-05-15,732,広告宣伝費,広告費,0,30000,-253200
1970,0001-20090515-61-316-1-1093,1,2009-05-15,191,仮払消費税等,広告費,0,1500,-254700
2025,0001-20090517-94-332-1-1125,0,2009-05-17,791,雑費,印刷代,0,10000,-264700
2026,0001-20090517-94-332-1-1125,1,2009-05-17,191,仮払消費税等,印刷代,0,500,-265200
2033,0001-20090518-109-335-1-1131,0,2009-05-18,740,車両費,ガソリン代,0,6258,-271458
2034,0001-20090518-109-335-1-1131,1,2009-05-18,191,仮払消費税等,ガソリン代,0,312,-271770
2051,0001-20090520-101-349-1-1159,0,2009-05-20,732,広告宣伝費,広告料,0,50000,-321770
2052,0001-20090520-101-349-1-1159,1,2009-05-20,191,仮払消費税等,広告料,0,2500,-324270
2089,0001-20090520-118-356-1-1173,0,2009-05-20,754,事務用消耗品費,コピー代,0,7681,-331951
2090,0001-20090520-118-356-1-1173,1,2009-05-20,191,仮払消費税等,コピー代,0,384,-332335
2093,0001-20090520-119-357-1-1175,0,2009-05-20,754,事務用消耗品費,事務用品,0,3936,-336271
2094,0001-20090520-119-357-1-1175,1,2009-05-20,191,仮払消費税等,事務用品,0,196,-336467
2118,0001-20090520-31-340-1-1141,0,2009-05-20,754,事務用消耗品費,コピー代,0,3293,-339760
2119,0001-20090520-31-340-1-1141,1,2009-05-20,191,仮払消費税等,コピー代,0,164,-339924
2126,0001-20090520-70-342-1-1145,0,2009-05-20,791,雑費,有線,0,4762,-344686
2127,0001-20090520-70-342-1-1145,1,2009-05-20,191,仮払消費税等,有線,0,238,-344924
2130,0001-20090520-71-343-1-1147,0,2009-05-20,754,事務用消耗品費,事務用品,0,5050,-349974
2131,0001-20090520-71-343-1-1147,1,2009-05-20,191,仮払消費税等,事務用品,0,252,-350226
2133,0001-20090520-71-343-1-1147,3,2009-05-20,754,事務用消耗品費,カウンター料金,0,34274,-384500
2134,0001-20090520-71-343-1-1147,4,2009-05-20,191,仮払消費税等,カウンター料金,0,1713,-386213
2135,0001-20090520-71-343-1-1147,5,2009-05-20,754,事務用消耗品費,カウンター料金,0,6000,-392213
2136,0001-20090520-71-343-1-1147,6,2009-05-20,191,仮払消費税等,カウンター料金,0,300,-392513
2139,0001-20090520-76-344-1-1149,0,2009-05-20,737,消耗品費,ファイル等,0,29762,-422275
2140,0001-20090520-76-344-1-1149,1,2009-05-20,191,仮払消費税等,ファイル等,0,1488,-423763
2142,0001-20090520-76-344-1-1149,3,2009-05-20,737,消耗品費,飲料水,0,190620,-614383
2143,0001-20090520-76-344-1-1149,4,2009-05-20,191,仮払消費税等,飲料水,0,9530,-623913
2144,0001-20090520-76-344-1-1149,5,2009-05-20,737,消耗品費,名刺代,0,49810,-673723
2145,0001-20090520-76-344-1-1149,6,2009-05-20,191,仮払消費税等,名刺代,0,2490,-676213
2147,0001-20090520-82-345-1-1151,0,2009-05-20,740,車両費,ガソリン代,0,18861,-695074
2148,0001-20090520-82-345-1-1151,1,2009-05-20,191,仮払消費税等,ガソリン代,0,943,-696017
2150,0001-20090520-82-345-1-1151,3,2009-05-20,740,車両費,ウォッシャー液,0,369,-696386
2151,0001-20090520-82-345-1-1151,4,2009-05-20,191,仮払消費税等,ウォッシャー液,0,18,-696404
2157,0001-20090520-97-347-1-1155,0,2009-05-20,754,事務用消耗品費,コピー代,0,38217,-734621
2158,0001-20090520-97-347-1-1155,1,2009-05-20,191,仮払消費税等,コピー代,0,1910,-736531
2161,0001-20090520-98-348-1-1157,0,2009-05-20,754,事務用消耗品費,事務用品,0,36743,-773274
2162,0001-20090520-98-348-1-1157,1,2009-05-20,191,仮払消費税等,事務用品,0,1837,-775111
2244,0001-20090522-38-371-1-1203,0,2009-05-22,724,福利厚生費,宿泊費,0,50477,-825588
2245,0001-20090522-38-371-1-1203,1,2009-05-22,191,仮払消費税等,宿泊費,0,2523,-828111
2266,0001-20090522-95-375-1-1211,0,2009-05-22,791,雑費,清掃料,0,68262,-896373
2267,0001-20090522-95-375-1-1211,1,2009-05-22,191,仮払消費税等,清掃料,0,3413,-899786
2286,0001-20090523-28-381-1-1223,0,2009-05-23,726,旅費交通費,タクシー代,0,2305,-902091
2287,0001-20090523-28-381-1-1223,1,2009-05-23,191,仮払消費税等,タクシー代,0,115,-902206
2304,0001-20090524-120-389-1-1239,0,2009-05-24,728,業務委託費,業務委託費,0,400000,-1302206
2305,0001-20090524-120-389-1-1239,1,2009-05-24,191,仮払消費税等,業務委託費,0,20000,-1322206
2308,0001-20090524-37-387-1-1235,0,2009-05-24,728,業務委託費,業務委託費,0,1135715,-2457921
2309,0001-20090524-37-387-1-1235,1,2009-05-24,191,仮払消費税等,業務委託費,0,56785,-2514706
2318,0001-20090525-111-398-1-1257,0,2009-05-25,726,旅費交通費,タクシー代,0,13581,-2528287
2319,0001-20090525-111-398-1-1257,1,2009-05-25,191,仮払消費税等,タクシー代,0,679,-2528966
2350,0001-20090525-172-402-1-1265,0,2009-05-25,728,業務委託費,業務委託費支払い,0,89524,-2618490
2351,0001-20090525-172-402-1-1265,1,2009-05-25,191,仮払消費税等,業務委託費支払い,0,4476,-2622966
2360,0001-20090525-3-390-1-1241,0,2009-05-25,724,福利厚生費,宿泊代,0,36191,-2659157
2361,0001-20090525-3-390-1-1241,1,2009-05-25,191,仮払消費税等,宿泊代,0,1809,-2660966
2490,0001-20090525-92-395-1-1251,0,2009-05-25,753,修繕維持費,コピー機修繕,0,100000,-2760966
2491,0001-20090525-92-395-1-1251,1,2009-05-25,191,仮払消費税等,コピー機修繕,0,5000,-2765966
2504,0001-20090526-146-411-1-1283,0,2009-05-26,728,業務委託費,業務委託費,0,140000,-2905966
2505,0001-20090526-146-411-1-1283,1,2009-05-26,191,仮払消費税等,業務委託費,0,7000,-2912966
2538,0001-20090526-78-407-1-1275,0,2009-05-26,728,業務委託費,業務委託費支払い,0,180000,-3092966
2539,0001-20090526-78-407-1-1275,1,2009-05-26,191,仮払消費税等,業務委託費支払い,0,9000,-3101966
2598,0001-20090528-32-422-1-1305,0,2009-05-28,754,事務用消耗品費,事務用品費,0,3286,-3105252
2599,0001-20090528-32-422-1-1305,1,2009-05-28,191,仮払消費税等,事務用品費,0,164,-3105416
2602,0001-20090528-93-423-1-1307,0,2009-05-28,753,修繕維持費,修繕費,0,16858,-3122274
2603,0001-20090528-93-423-1-1307,1,2009-05-28,191,仮払消費税等,修繕費,0,842,-3123116
2630,0001-20090529-62-425-1-1311,0,2009-05-29,733,交際接待費,飲食代,0,34338,-3157454
2631,0001-20090529-62-425-1-1311,1,2009-05-29,191,仮払消費税等,飲食代,0,1716,-3159170
2647,0001-20090530-137-433-1-1327,0,2009-05-30,791,雑費,有線,0,6000,-3165170
2648,0001-20090530-137-433-1-1327,1,2009-05-30,191,仮払消費税等,有線,0,300,-3165470
2650,0001-20090530-137-433-1-1327,3,2009-05-30,791,雑費,警備料,0,42858,-3208328
2651,0001-20090530-137-433-1-1327,4,2009-05-30,191,仮払消費税等,警備料,0,2142,-3210470
2657,0001-20090530-137-433-1-1327,8,2009-05-30,791,雑費,清掃料,0,70000,-3280470
2658,0001-20090530-137-433-1-1327,9,2009-05-30,191,仮払消費税等,清掃料,0,3500,-3283970
2669,0001-20090530-70-429-1-1319,0,2009-05-30,791,雑費,有線,0,6000,-3289970
2670,0001-20090530-70-429-1-1319,1,2009-05-30,191,仮払消費税等,有線,0,300,-3290270
2672,0001-20090530-70-429-1-1319,3,2009-05-30,791,雑費,警備料,0,52381,-3342651
2673,0001-20090530-70-429-1-1319,4,2009-05-30,191,仮払消費税等,警備料,0,2619,-3345270
2677,0001-20090530-70-429-1-1319,8,2009-05-30,791,雑費,清掃料,0,70000,-3415270
2678,0001-20090530-70-429-1-1319,9,2009-05-30,191,仮払消費税等,清掃料,0,3500,-3418770
2687,0001-20090531-1-436-1-1333,0,2009-05-31,731,運賃,運賃　佐川急便,0,84896,-3503666
2688,0001-20090531-1-436-1-1333,1,2009-05-31,191,仮払消費税等,運賃　佐川急便,0,4244,-3507910
3017,0001-20090531-145-478-1-1417,0,2009-05-31,731,運賃,運賃,0,162762,-3670672
3018,0001-20090531-145-478-1-1417,1,2009-05-31,191,仮払消費税等,運賃,0,8138,-3678810
3045,0001-20090531-154-483-1-1427,0,2009-05-31,733,交際接待費,お花代,0,12000,-3690810
3046,0001-20090531-154-483-1-1427,1,2009-05-31,191,仮払消費税等,お花代,0,600,-3691410
3048,0001-20090531-154-483-1-1427,3,2009-05-31,733,交際接待費,香典代,0,10000,-3701410
3071,0001-20090531-36-437-1-1335,0,2009-05-31,731,運賃,運賃　ヤマト運輸,0,1456324,-5157734
3072,0001-20090531-36-437-1-1335,1,2009-05-31,191,仮払消費税等,運賃　ヤマト運輸,0,72816,-5230550
3074,0001-20090531-36-437-1-1335,3,2009-05-31,731,運賃,運賃　佐川急便,0,952915,-6183465
3075,0001-20090531-36-437-1-1335,4,2009-05-31,191,仮払消費税等,運賃　佐川急便,0,47645,-6231110
3077,0001-20090531-40-438-1-1337,0,2009-05-31,732,広告宣伝費,広告掲載,0,47620,-6278730
3078,0001-20090531-40-438-1-1337,1,2009-05-31,191,仮払消費税等,広告掲載,0,2380,-6281110
3120,0001-20090531-77-447-1-1355,0,2009-05-31,731,運賃,運賃　ヤマト運輸,0,145262,-6426372
3121,0001-20090531-77-447-1-1355,1,2009-05-31,191,仮払消費税等,運賃　ヤマト運輸,0,7263,-6433635
3124,0001-20090531-81-448-1-1357,0,2009-05-31,724,福利厚生費,お茶代,0,25048,-6458683
3125,0001-20090531-81-448-1-1357,1,2009-05-31,191,仮払消費税等,お茶代,0,1252,-6459935
3129,0001-20090531-87-449-1-1359,1,2009-05-31,131,普通預金,4月分支払,7529245,0,1069310
3133,0001-20090531-99-450-1-1361,0,2009-05-31,731,運賃,運賃,0,712715,356595
3134,0001-20090531-99-450-1-1361,1,2009-05-31,191,仮払消費税等,運賃,0,35635,320960
,,,2009-05,,※※月計※※,,7529245,7263732,
3143,0001-20090601-147-488-1-1437,0,2009-06-01,740,車両費,ガソリン代,0,5416,315544
3144,0001-20090601-147-488-1-1437,1,2009-06-01,191,仮払消費税等,ガソリン代,0,270,315274
3146,0001-20090601-147-488-1-1437,3,2009-06-01,740,車両費,高速代,0,572,314702
3147,0001-20090601-147-488-1-1437,4,2009-06-01,191,仮払消費税等,高速代,0,28,314674
3339,0001-20090610-168-536-1-1533,0,2009-06-10,791,雑費,有線,0,6000,308674
3340,0001-20090610-168-536-1-1533,1,2009-06-10,191,仮払消費税等,有線,0,300,308374
3342,0001-20090610-168-536-1-1533,3,2009-06-10,791,雑費,警備料,0,42858,265516
3343,0001-20090610-168-536-1-1533,4,2009-06-10,191,仮払消費税等,警備料,0,2142,263374
3372,0001-20090610-72-524-1-1509,0,2009-06-10,791,雑費,有線,0,5000,258374
3373,0001-20090610-72-524-1-1509,1,2009-06-10,191,仮払消費税等,有線,0,250,258124
3375,0001-20090610-72-524-1-1509,3,2009-06-10,791,雑費,警備料,0,34286,223838
3376,0001-20090610-72-524-1-1509,4,2009-06-10,191,仮払消費税等,警備料,0,1714,222124
3378,0001-20090610-76-525-1-1511,0,2009-06-10,724,福利厚生費,社員夜食代,0,11905,210219
3379,0001-20090610-76-525-1-1511,1,2009-06-10,191,仮払消費税等,社員夜食代,0,595,209624
3559,0001-20090616-83-564-1-1589,0,2009-06-16,740,車両費,ガソリン代,0,4721,204903
3560,0001-20090616-83-564-1-1589,1,2009-06-16,191,仮払消費税等,ガソリン代,0,236,204667
3571,0001-20090617-4-566-1-1593,0,2009-06-17,732,広告宣伝費,広告費,0,30000,174667
3572,0001-20090617-4-566-1-1593,1,2009-06-17,191,仮払消費税等,広告費,0,1500,173167
3583,0001-20090618-82-569-1-1599,0,2009-06-18,740,車両費,ガソリン代,0,29607,143560
3584,0001-20090618-82-569-1-1599,1,2009-06-18,191,仮払消費税等,ガソリン代,0,1480,142080
3595,0001-20090620-101-590-1-1641,0,2009-06-20,732,広告宣伝費,広告料,0,50000,92080
3596,0001-20090620-101-590-1-1641,1,2009-06-20,191,仮払消費税等,広告料,0,2500,89580
3633,0001-20090620-118-597-1-1655,0,2009-06-20,754,事務用消耗品費,コピー代,0,6784,82796
3634,0001-20090620-118-597-1-1655,1,2009-06-20,191,仮払消費税等,コピー代,0,339,82457
3645,0001-20090620-134-599-1-1659,0,2009-06-20,754,事務用消耗品費,用紙,0,21905,60552
3646,0001-20090620-134-599-1-1659,1,2009-06-20,191,仮払消費税等,用紙,0,1095,59457
3649,0001-20090620-135-600-1-1661,0,2009-06-20,754,事務用消耗品費,事務用品,0,6955,52502
3650,0001-20090620-135-600-1-1661,1,2009-06-20,191,仮払消費税等,事務用品,0,347,52155
3680,0001-20090620-3-573-1-1607,0,2009-06-20,724,福利厚生費,宿泊代,0,29724,22431
3681,0001-20090620-3-573-1-1607,1,2009-06-20,191,仮払消費税等,宿泊代,0,1486,20945
3684,0001-20090620-31-575-1-1611,0,2009-06-20,754,事務用消耗品費,コピー代,0,2622,18323
3685,0001-20090620-31-575-1-1611,1,2009-06-20,191,仮払消費税等,コピー代,0,131,18192
3719,0001-20090620-66-580-1-1621,0,2009-06-20,724,福利厚生費,お茶代,0,10000,8192
3720,0001-20090620-66-580-1-1621,1,2009-06-20,191,仮払消費税等,お茶代,0,500,7692
3723,0001-20090620-71-581-1-1623,0,2009-06-20,754,事務用消耗品費,事務用品,0,1505,6187
3724,0001-20090620-71-581-1-1623,1,2009-06-20,191,仮払消費税等,事務用品,0,75,6112
3726,0001-20090620-71-581-1-1623,3,2009-06-20,754,事務用消耗品費,カウンター料金,0,31854,-25742
3727,0001-20090620-71-581-1-1623,4,2009-06-20,191,仮払消費税等,カウンター料金,0,1592,-27334
3729,0001-20090620-74-582-1-1625,0,2009-06-20,791,雑費,有線,0,4762,-32096
3730,0001-20090620-74-582-1-1625,1,2009-06-20,191,仮払消費税等,有線,0,238,-32334
3737,0001-20090620-76-584-1-1629,0,2009-06-20,754,事務用消耗品費,カウンター料金,0,6000,-38334
3738,0001-20090620-76-584-1-1629,1,2009-06-20,191,仮払消費税等,カウンター料金,0,300,-38634
3741,0001-20090620-80-585-1-1631,0,2009-06-20,724,福利厚生費,会費支払い,0,397500,-436134
3742,0001-20090620-80-585-1-1631,1,2009-06-20,191,仮払消費税等,会費支払い,0,19875,-456009
3745,0001-20090620-81-586-1-1633,0,2009-06-20,737,消耗品費,ファイル等,0,16667,-472676
3746,0001-20090620-81-586-1-1633,1,2009-06-20,191,仮払消費税等,ファイル等,0,833,-473509
3748,0001-20090620-81-586-1-1633,3,2009-06-20,737,消耗品費,飲料水,0,210000,-683509
3749,0001-20090620-81-586-1-1633,4,2009-06-20,191,仮払消費税等,飲料水,0,10500,-694009
3750,0001-20090620-81-586-1-1633,5,2009-06-20,737,消耗品費,名刺代,0,31905,-725914
3751,0001-20090620-81-586-1-1633,6,2009-06-20,191,仮払消費税等,名刺代,0,1595,-727509
3763,0001-20090620-97-588-1-1637,0,2009-06-20,754,事務用消耗品費,コピー代,0,36996,-764505
3764,0001-20090620-97-588-1-1637,1,2009-06-20,191,仮払消費税等,コピー代,0,1849,-766354
3767,0001-20090620-98-589-1-1639,0,2009-06-20,754,事務用消耗品費,事務用品,0,2277,-768631
3768,0001-20090620-98-589-1-1639,1,2009-06-20,191,仮払消費税等,事務用品,0,113,-768744
3791,0001-20090622-109-612-1-1685,0,2009-06-22,740,車両費,ガソリン代,0,6631,-775375
3792,0001-20090622-109-612-1-1685,1,2009-06-22,191,仮払消費税等,ガソリン代,0,331,-775706
3824,0001-20090622-95-611-1-1683,0,2009-06-22,791,雑費,清掃料,0,68262,-843968
3825,0001-20090622-95-611-1-1683,1,2009-06-22,191,仮払消費税等,清掃料,0,3413,-847381
3836,0001-20090623-28-618-1-1697,0,2009-06-23,726,旅費交通費,タクシー代,0,2305,-849686
3837,0001-20090623-28-618-1-1697,1,2009-06-23,191,仮払消費税等,タクシー代,0,115,-849801
3840,0001-20090623-38-619-1-1699,0,2009-06-23,724,福利厚生費,宿泊費,0,45871,-895672
3841,0001-20090623-38-619-1-1699,1,2009-06-23,191,仮払消費税等,宿泊費,0,2293,-897965
3853,0001-20090624-154-626-1-1713,0,2009-06-24,733,交際接待費,ゴルフプレー代,0,17372,-915337
3854,0001-20090624-154-626-1-1713,1,2009-06-24,191,仮払消費税等,ゴルフプレー代,0,868,-916205
3867,0001-20090624-81-624-1-1709,0,2009-06-24,724,福利厚生費,お茶代,0,17143,-933348
3868,0001-20090624-81-624-1-1709,1,2009-06-24,191,仮払消費税等,お茶代,0,857,-934205
3871,0001-20090625-111-632-1-1725,0,2009-06-25,726,旅費交通費,タクシー代,0,9334,-943539
3872,0001-20090625-111-632-1-1725,1,2009-06-25,191,仮払消費税等,タクシー代,0,466,-944005
4069,0001-20090626-120-648-1-1757,0,2009-06-26,728,業務委託費,業務委託費,0,450000,-1394005
4070,0001-20090626-120-648-1-1757,1,2009-06-26,191,仮払消費税等,業務委託費,0,22500,-1416505
4085,0001-20090626-146-650-1-1761,0,2009-06-26,728,業務委託費,業務委託費,0,140000,-1556505
4086,0001-20090626-146-650-1-1761,1,2009-06-26,191,仮払消費税等,業務委託費,0,7000,-1563505
4089,0001-20090626-172-651-1-1763,0,2009-06-26,728,業務委託費,業務委託費支払い,0,138096,-1701601
4090,0001-20090626-172-651-1-1763,1,2009-06-26,191,仮払消費税等,業務委託費支払い,0,6904,-1708505
4093,0001-20090626-37-642-1-1745,0,2009-06-26,728,業務委託費,業務委託費,0,1257143,-2965648
4094,0001-20090626-37-642-1-1745,1,2009-06-26,191,仮払消費税等,業務委託費,0,62857,-3028505
4126,0001-20090627-78-655-1-1771,0,2009-06-27,728,業務委託費,業務委託費支払い,0,180000,-3208505
4127,0001-20090627-78-655-1-1771,1,2009-06-27,191,仮払消費税等,業務委託費支払い,0,9000,-3217505
4154,0001-20090628-93-658-1-1777,0,2009-06-28,753,修繕維持費,修繕費,0,17000,-3234505
4155,0001-20090628-93-658-1-1777,1,2009-06-28,191,仮払消費税等,修繕費,0,850,-3235355
4162,0001-20090630-1-662-1-1785,0,2009-06-30,731,運賃,運賃　佐川急便,0,58429,-3293784
4163,0001-20090630-1-662-1-1785,1,2009-06-30,191,仮払消費税等,運賃　佐川急便,0,2921,-3296705
4444,0001-20090630-137-697-1-1855,0,2009-06-30,791,雑費,有線,0,6000,-3302705
4445,0001-20090630-137-697-1-1855,1,2009-06-30,191,仮払消費税等,有線,0,300,-3303005
4447,0001-20090630-137-697-1-1855,3,2009-06-30,791,雑費,警備料,0,42858,-3345863
4448,0001-20090630-137-697-1-1855,4,2009-06-30,191,仮払消費税等,警備料,0,2142,-3348005
4454,0001-20090630-137-697-1-1855,8,2009-06-30,791,雑費,清掃料,0,70000,-3418005
4455,0001-20090630-137-697-1-1855,9,2009-06-30,191,仮払消費税等,清掃料,0,3500,-3421505
4495,0001-20090630-145-705-1-1871,0,2009-06-30,731,運賃,運賃,0,135667,-3557172
4496,0001-20090630-145-705-1-1871,1,2009-06-30,191,仮払消費税等,運賃,0,6783,-3563955
4533,0001-20090630-36-663-1-1787,0,2009-06-30,731,運賃,運賃　ヤマト運輸,0,1637000,-5200955
4534,0001-20090630-36-663-1-1787,1,2009-06-30,191,仮払消費税等,運賃　ヤマト運輸,0,81850,-5282805
4536,0001-20090630-36-663-1-1787,3,2009-06-30,731,運賃,運賃　佐川急便,0,805743,-6088548
4537,0001-20090630-36-663-1-1787,4,2009-06-30,191,仮払消費税等,運賃　佐川急便,0,40287,-6128835
4539,0001-20090630-40-664-1-1789,0,2009-06-30,732,広告宣伝費,広告掲載,0,47620,-6176455
4540,0001-20090630-40-664-1-1789,1,2009-06-30,191,仮払消費税等,広告掲載,0,2380,-6178835
4557,0001-20090630-70-668-1-1797,0,2009-06-30,791,雑費,有線,0,6000,-6184835
4558,0001-20090630-70-668-1-1797,1,2009-06-30,191,仮払消費税等,有線,0,300,-6185135
4560,0001-20090630-70-668-1-1797,3,2009-06-30,791,雑費,警備料,0,52381,-6237516
4561,0001-20090630-70-668-1-1797,4,2009-06-30,191,仮払消費税等,警備料,0,2619,-6240135
4567,0001-20090630-70-668-1-1797,8,2009-06-30,791,雑費,清掃料,0,70000,-6310135
4568,0001-20090630-70-668-1-1797,9,2009-06-30,191,仮払消費税等,清掃料,0,3500,-6313635
4571,0001-20090630-77-669-1-1799,0,2009-06-30,731,運賃,運賃,0,142158,-6455793
4572,0001-20090630-77-669-1-1799,1,2009-06-30,191,仮払消費税等,運賃,0,7107,-6462900
4663,0001-20090630-93-675-1-1811,1,2009-06-30,131,普通預金,5月分支払,7263732,0,800832
4673,0001-20090630-99-677-1-1815,0,2009-06-30,731,運賃,運賃,0,583267,217565
4674,0001-20090630-99-677-1-1815,1,2009-06-30,191,仮払消費税等,運賃,0,29163,188402
,,,2009-06,,※※月計※※,,7263732,7396290,
4721,0001-20090702-32-715-1-1891,0,2009-07-02,754,事務用消耗品費,事務用品費,0,2127,186275
4722,0001-20090702-32-715-1-1891,1,2009-07-02,191,仮払消費税等,事務用品費,0,106,186169
4748,0001-20090704-82-724-1-1909,0,2009-07-04,740,車両費,ガソリン代,0,18000,168169
4749,0001-20090704-82-724-1-1909,1,2009-07-04,191,仮払消費税等,ガソリン代,0,900,167269
4828,0001-20090708-147-743-1-1947,0,2009-07-08,740,車両費,ガソリン代,0,5412,161857
4829,0001-20090708-147-743-1-1947,1,2009-07-08,191,仮払消費税等,ガソリン代,0,270,161587
4831,0001-20090708-147-743-1-1947,3,2009-07-08,740,車両費,高速代,0,4858,156729
4832,0001-20090708-147-743-1-1947,4,2009-07-08,191,仮払消費税等,高速代,0,242,156487
4833,0001-20090708-147-743-1-1947,5,2009-07-08,740,車両費,駐車代,0,572,155915
4834,0001-20090708-147-743-1-1947,6,2009-07-08,191,仮払消費税等,駐車代,0,28,155887
4854,0001-20090708-76-741-1-1943,0,2009-07-08,724,福利厚生費,景品代,0,58143,97744
4855,0001-20090708-76-741-1-1943,1,2009-07-08,191,仮払消費税等,景品代,0,2907,94837
4899,0001-20090710-168-767-1-1995,0,2009-07-10,791,雑費,有線,0,6000,88837
4900,0001-20090710-168-767-1-1995,1,2009-07-10,191,仮払消費税等,有線,0,300,88537
4902,0001-20090710-168-767-1-1995,3,2009-07-10,791,雑費,警備料,0,42858,45679
4903,0001-20090710-168-767-1-1995,4,2009-07-10,191,仮払消費税等,警備料,0,2142,43537
4926,0001-20090710-67-751-1-1963,0,2009-07-10,791,雑費,有線,0,5000,38537
4927,0001-20090710-67-751-1-1963,1,2009-07-10,191,仮払消費税等,有線,0,250,38287
4929,0001-20090710-67-751-1-1963,3,2009-07-10,791,雑費,警備料,0,34286,4001
4930,0001-20090710-67-751-1-1963,4,2009-07-10,191,仮払消費税等,警備料,0,1714,2287
5146,0001-20090717-4-796-1-2053,0,2009-07-17,732,広告宣伝費,広告費,0,30000,-27713
5147,0001-20090717-4-796-1-2053,1,2009-07-17,191,仮払消費税等,広告費,0,1500,-29213
5154,0001-20090718-139-801-1-2063,0,2009-07-18,724,福利厚生費,社員夜食代,0,42877,-72090
5155,0001-20090718-139-801-1-2063,1,2009-07-18,191,仮払消費税等,社員夜食代,0,2143,-74233
5186,0001-20090720-101-817-1-2095,0,2009-07-20,732,広告宣伝費,広告料,0,50000,-124233
5187,0001-20090720-101-817-1-2095,1,2009-07-20,191,仮払消費税等,広告料,0,2500,-126733
5224,0001-20090720-118-824-1-2109,0,2009-07-20,754,事務用消耗品費,コピー代,0,6880,-133613
5225,0001-20090720-118-824-1-2109,1,2009-07-20,191,仮払消費税等,コピー代,0,343,-133956
5228,0001-20090720-119-825-1-2111,0,2009-07-20,754,事務用消耗品費,事務用品,0,1410,-135366
5229,0001-20090720-119-825-1-2111,1,2009-07-20,191,仮払消費税等,事務用品,0,70,-135436
5274,0001-20090720-31-807-1-2075,0,2009-07-20,754,事務用消耗品費,コピー代,0,2730,-138166
5275,0001-20090720-31-807-1-2075,1,2009-07-20,191,仮払消費税等,コピー代,0,136,-138302
5298,0001-20090720-69-811-1-2083,0,2009-07-20,791,雑費,有線,0,4762,-143064
5299,0001-20090720-69-811-1-2083,1,2009-07-20,191,仮払消費税等,有線,0,238,-143302
5302,0001-20090720-71-812-1-2085,0,2009-07-20,754,事務用消耗品費,事務用品,0,11407,-154709
5303,0001-20090720-71-812-1-2085,1,2009-07-20,191,仮払消費税等,事務用品,0,570,-155279
5305,0001-20090720-71-812-1-2085,3,2009-07-20,754,事務用消耗品費,カウンター料金,0,31320,-186599
5306,0001-20090720-71-812-1-2085,4,2009-07-20,191,仮払消費税等,カウンター料金,0,1565,-188164
5308,0001-20090720-72-813-1-2087,0,2009-07-20,754,事務用消耗品費,カウンター料金,0,6000,-194164
5309,0001-20090720-72-813-1-2087,1,2009-07-20,191,仮払消費税等,カウンター料金,0,300,-194464
5312,0001-20090720-77-814-1-2089,0,2009-07-20,737,消耗品費,ファイル等,0,19387,-213851
5313,0001-20090720-77-814-1-2089,1,2009-07-20,191,仮払消費税等,ファイル等,0,969,-214820
5315,0001-20090720-77-814-1-2089,3,2009-07-20,737,消耗品費,飲料水,0,239019,-453839
5316,0001-20090720-77-814-1-2089,4,2009-07-20,191,仮払消費税等,飲料水,0,11950,-465789
5317,0001-20090720-77-814-1-2089,5,2009-07-20,737,消耗品費,名刺代,0,10096,-475885
5318,0001-20090720-77-814-1-2089,6,2009-07-20,191,仮払消費税等,名刺代,0,504,-476389
5320,0001-20090720-97-815-1-2091,0,2009-07-20,754,事務用消耗品費,コピー代,0,34085,-510474
5321,0001-20090720-97-815-1-2091,1,2009-07-20,191,仮払消費税等,コピー代,0,1704,-512178
5324,0001-20090720-98-816-1-2093,0,2009-07-20,754,事務用消耗品費,事務用品,0,5610,-517788
5325,0001-20090720-98-816-1-2093,1,2009-07-20,191,仮払消費税等,事務用品,0,280,-518068
5336,0001-20090721-63-834-1-2129,0,2009-07-21,724,福利厚生費,お茶代,0,10524,-528592
5337,0001-20090721-63-834-1-2129,1,2009-07-21,191,仮払消費税等,お茶代,0,526,-529118
5398,0001-20090722-95-841-1-2143,0,2009-07-22,791,雑費,清掃料,0,68262,-597380
5399,0001-20090722-95-841-1-2143,1,2009-07-22,191,仮払消費税等,清掃料,0,3413,-600793
5410,0001-20090724-137-850-1-2161,0,2009-07-24,791,雑費,有線,0,6000,-606793
5411,0001-20090724-137-850-1-2161,1,2009-07-24,191,仮払消費税等,有線,0,300,-607093
5413,0001-20090724-137-850-1-2161,3,2009-07-24,791,雑費,警備料,0,42858,-649951
5414,0001-20090724-137-850-1-2161,4,2009-07-24,191,仮払消費税等,警備料,0,2142,-652093
5420,0001-20090724-137-850-1-2161,8,2009-07-24,791,雑費,清掃料,0,70000,-722093
5421,0001-20090724-137-850-1-2161,9,2009-07-24,191,仮払消費税等,清掃料,0,3500,-725593
5427,0001-20090724-154-851-1-2163,0,2009-07-24,733,交際接待費,飲食代　博多亭3名,0,13029,-738622
5428,0001-20090724-154-851-1-2163,1,2009-07-24,191,仮払消費税等,飲食代　博多亭3名,0,651,-739273
5430,0001-20090724-154-851-1-2163,3,2009-07-24,733,交際接待費,飲食代　スナックみわ,0,23477,-762750
5431,0001-20090724-154-851-1-2163,4,2009-07-24,191,仮払消費税等,飲食代　スナックみわ,0,1173,-763923
5433,0001-20090724-172-852-1-2165,0,2009-07-24,728,業務委託費,業務委託費支払い,0,125715,-889638
5434,0001-20090724-172-852-1-2165,1,2009-07-24,191,仮払消費税等,業務委託費支払い,0,6285,-895923
5437,0001-20090724-38-848-1-2157,0,2009-07-24,724,福利厚生費,宿泊費,0,45871,-941794
5438,0001-20090724-38-848-1-2157,1,2009-07-24,191,仮払消費税等,宿泊費,0,2293,-944087
5447,0001-20090725-109-863-1-2187,0,2009-07-25,740,車両費,ガソリン代,0,42381,-986468
5448,0001-20090725-109-863-1-2187,1,2009-07-25,191,仮払消費税等,ガソリン代,0,2119,-988587
5461,0001-20090725-111-865-1-2191,0,2009-07-25,726,旅費交通費,タクシー代,0,22477,-1011064
5462,0001-20090725-111-865-1-2191,1,2009-07-25,191,仮払消費税等,タクシー代,0,1123,-1012187
5509,0001-20090725-28-854-1-2169,0,2009-07-25,726,旅費交通費,タクシー代,0,5702,-1017889
5510,0001-20090725-28-854-1-2169,1,2009-07-25,191,仮払消費税等,タクシー代,0,285,-1018174
5519,0001-20090725-3-853-1-2167,0,2009-07-25,724,福利厚生費,宿泊代,0,28583,-1046757
5520,0001-20090725-3-853-1-2167,1,2009-07-25,191,仮払消費税等,宿泊代,0,1429,-1048186
5531,0001-20090725-78-858-1-2177,0,2009-07-25,728,業務委託費,業務委託費支払い,0,180000,-1228186
5532,0001-20090725-78-858-1-2177,1,2009-07-25,191,仮払消費税等,業務委託費支払い,0,9000,-1237186
5660,0001-20090725-92-862-1-2185,0,2009-07-25,753,修繕維持費,コピー機修繕,0,17143,-1254329
5661,0001-20090725-92-862-1-2185,1,2009-07-25,191,仮払消費税等,コピー機修繕,0,857,-1255186
5670,0001-20090726-120-877-1-2215,0,2009-07-26,728,業務委託費,業務委託費,0,320000,-1575186
5671,0001-20090726-120-877-1-2215,1,2009-07-26,191,仮払消費税等,業務委託費,0,16000,-1591186
5674,0001-20090726-146-878-1-2217,0,2009-07-26,728,業務委託費,業務委託費,0,140000,-1731186
5675,0001-20090726-146-878-1-2217,1,2009-07-26,191,仮払消費税等,業務委託費,0,7000,-1738186
5703,0001-20090727-37-881-1-2223,0,2009-07-27,728,業務委託費,業務委託費,0,477334,-2215520
5704,0001-20090727-37-881-1-2223,1,2009-07-27,191,仮払消費税等,業務委託費,0,23866,-2239386
5706,0001-20090727-37-881-1-2223,3,2009-07-27,728,業務委託費,業務委託費,0,266000,-2505386
5707,0001-20090727-37-881-1-2223,4,2009-07-27,191,仮払消費税等,業務委託費,0,13300,-2518686
5708,0001-20090727-37-881-1-2223,5,2009-07-27,728,業務委託費,業務委託費,0,816374,-3335060
5709,0001-20090727-37-881-1-2223,6,2009-07-27,191,仮払消費税等,業務委託費,0,40818,-3375878
5751,0001-20090728-81-887-1-2235,0,2009-07-28,724,福利厚生費,お茶代,0,20953,-3396831
5752,0001-20090728-81-887-1-2235,1,2009-07-28,191,仮払消費税等,お茶代,0,1047,-3397878
5759,0001-20090728-93-888-1-2237,0,2009-07-28,753,修繕維持費,修繕費,0,17000,-3414878
5760,0001-20090728-93-888-1-2237,1,2009-07-28,191,仮払消費税等,修繕費,0,850,-3415728
5811,0001-20090730-70-897-1-2255,0,2009-07-30,791,雑費,有線,0,6000,-3421728
5812,0001-20090730-70-897-1-2255,1,2009-07-30,191,仮払消費税等,有線,0,300,-3422028
5814,0001-20090730-70-897-1-2255,3,2009-07-30,791,雑費,警備料,0,52381,-3474409
5815,0001-20090730-70-897-1-2255,4,2009-07-30,191,仮払消費税等,警備料,0,2619,-3477028
5816,0001-20090730-70-897-1-2255,5,2009-07-30,791,雑費,清掃料,0,70000,-3547028
5817,0001-20090730-70-897-1-2255,6,2009-07-30,191,仮払消費税等,清掃料,0,3500,-3550528
5830,0001-20090731-1-902-1-2265,0,2009-07-31,731,運賃,運賃　佐川急便,0,155048,-3705576
5831,0001-20090731-1-902-1-2265,1,2009-07-31,191,仮払消費税等,運賃　佐川急便,0,7752,-3713328
6133,0001-20090731-145-940-1-2341,0,2009-07-31,731,運賃,運賃,0,157334,-3870662
6134,0001-20090731-145-940-1-2341,1,2009-07-31,191,仮払消費税等,運賃,0,7866,-3878528
6154,0001-20090731-36-903-1-2267,0,2009-07-31,731,運賃,運賃　ヤマト運輸,0,1835020,-5713548
6155,0001-20090731-36-903-1-2267,1,2009-07-31,191,仮払消費税等,運賃　ヤマト運輸,0,91750,-5805298
6157,0001-20090731-36-903-1-2267,3,2009-07-31,731,運賃,運賃　佐川急便,0,964048,-6769346
6158,0001-20090731-36-903-1-2267,4,2009-07-31,191,仮払消費税等,運賃　佐川急便,0,48202,-6817548
6160,0001-20090731-40-904-1-2269,0,2009-07-31,732,広告宣伝費,広告掲載,0,47620,-6865168
6161,0001-20090731-40-904-1-2269,1,2009-07-31,191,仮払消費税等,広告掲載,0,2380,-6867548
6194,0001-20090731-77-909-1-2279,0,2009-07-31,731,運賃,運賃,0,119581,-6987129
6195,0001-20090731-77-909-1-2279,1,2009-07-31,191,仮払消費税等,運賃,0,5979,-6993108
6206,0001-20090731-86-911-1-2283,1,2009-07-31,131,普通預金,6月分支払,7396290,0,403182
6210,0001-20090731-99-912-1-2285,0,2009-07-31,731,運賃,運賃,0,719239,-316057
6211,0001-20090731-99-912-1-2285,1,2009-07-31,191,仮払消費税等,運賃,0,35961,-352018
,,,2009-07,,※※月計※※,,7396290,7936710,
6230,0001-20090802-147-948-1-2357,0,2009-08-02,740,車両費,ガソリン代,0,6332,-358350
6231,0001-20090802-147-948-1-2357,1,2009-08-02,191,仮払消費税等,ガソリン代,0,316,-358666
6234,0001-20090803-134-951-1-2363,0,2009-08-03,754,事務用消耗品費,用紙,0,15029,-373695
6235,0001-20090803-134-951-1-2363,1,2009-08-03,191,仮払消費税等,用紙,0,751,-374446
6237,0001-20090803-134-951-1-2363,3,2009-08-03,754,事務用消耗品費,用紙,0,16000,-390446
6238,0001-20090803-134-951-1-2363,4,2009-08-03,191,仮払消費税等,用紙,0,800,-391246
6241,0001-20090803-139-952-1-2365,0,2009-08-03,724,福利厚生費,社員夜食代,0,24191,-415437
6242,0001-20090803-139-952-1-2365,1,2009-08-03,191,仮払消費税等,社員夜食代,0,1209,-416646
6261,0001-20090803-82-950-1-2361,0,2009-08-03,740,車両費,ガソリン代,0,17163,-433809
6262,0001-20090803-82-950-1-2361,1,2009-08-03,191,仮払消費税等,ガソリン代,0,858,-434667
6374,0001-20090809-76-975-1-2411,0,2009-08-09,724,福利厚生費,社員夜食代,0,33762,-468429
6375,0001-20090809-76-975-1-2411,1,2009-08-09,191,仮払消費税等,社員夜食代,0,1688,-470117
6416,0001-20090810-168-998-1-2457,0,2009-08-10,791,雑費,有線,0,6000,-476117
6417,0001-20090810-168-998-1-2457,1,2009-08-10,191,仮払消費税等,有線,0,300,-476417
6419,0001-20090810-168-998-1-2457,3,2009-08-10,791,雑費,警備料,0,42858,-519275
6420,0001-20090810-168-998-1-2457,4,2009-08-10,191,仮払消費税等,警備料,0,2142,-521417
6422,0001-20090810-32-978-1-2417,0,2009-08-10,754,事務用消耗品費,事務用品費,0,3722,-525139
6423,0001-20090810-32-978-1-2417,1,2009-08-10,191,仮払消費税等,事務用品費,0,186,-525325
6447,0001-20090810-66-981-1-2423,0,2009-08-10,791,雑費,有線,0,5000,-530325
6448,0001-20090810-66-981-1-2423,1,2009-08-10,191,仮払消費税等,有線,0,250,-530575
6450,0001-20090810-66-981-1-2423,3,2009-08-10,791,雑費,警備料,0,34286,-564861
6451,0001-20090810-66-981-1-2423,4,2009-08-10,191,仮払消費税等,警備料,0,1714,-566575
6556,0001-20090815-4-1009-1-2479,0,2009-08-15,732,広告宣伝費,広告費,0,30000,-596575
6557,0001-20090815-4-1009-1-2479,1,2009-08-15,191,仮払消費税等,広告費,0,1500,-598075
6651,0001-20090817-154-1026-1-2513,1,2009-08-17,733,交際接待費,香典代,0,10000,-608075
6692,0001-20090820-101-1048-1-2557,0,2009-08-20,732,広告宣伝費,広告料,0,50000,-658075
6693,0001-20090820-101-1048-1-2557,1,2009-08-20,191,仮払消費税等,広告料,0,2500,-660575
6729,0001-20090820-118-1053-1-2567,0,2009-08-20,754,事務用消耗品費,コピー代,0,6691,-667266
6730,0001-20090820-118-1053-1-2567,1,2009-08-20,191,仮払消費税等,コピー代,0,334,-667600
6733,0001-20090820-119-1054-1-2569,0,2009-08-20,754,事務用消耗品費,事務用品,0,2553,-670153
6734,0001-20090820-119-1054-1-2569,1,2009-08-20,191,仮払消費税等,事務用品,0,127,-670280
6770,0001-20090820-31-1034-1-2529,0,2009-08-20,754,事務用消耗品費,コピー代,0,2283,-672563
6771,0001-20090820-31-1034-1-2529,1,2009-08-20,191,仮払消費税等,コピー代,0,114,-672677
6794,0001-20090820-67-1038-1-2537,0,2009-08-20,791,雑費,有線,0,4762,-677439
6795,0001-20090820-67-1038-1-2537,1,2009-08-20,191,仮払消費税等,有線,0,238,-677677
6798,0001-20090820-69-1039-1-2539,0,2009-08-20,754,事務用消耗品費,カウンター料金,0,6000,-683677
6799,0001-20090820-69-1039-1-2539,1,2009-08-20,191,仮払消費税等,カウンター料金,0,300,-683977
6802,0001-20090820-71-1040-1-2541,0,2009-08-20,754,事務用消耗品費,事務用品,0,7275,-691252
6803,0001-20090820-71-1040-1-2541,1,2009-08-20,191,仮払消費税等,事務用品,0,363,-691615
6805,0001-20090820-71-1040-1-2541,3,2009-08-20,754,事務用消耗品費,カウンター料金,0,32493,-724108
6806,0001-20090820-71-1040-1-2541,4,2009-08-20,191,仮払消費税等,カウンター料金,0,1624,-725732
6808,0001-20090820-74-1041-1-2543,0,2009-08-20,737,消耗品費,ファイル等,0,12620,-738352
6809,0001-20090820-74-1041-1-2543,1,2009-08-20,191,仮払消費税等,ファイル等,0,630,-738982
6811,0001-20090820-74-1041-1-2543,3,2009-08-20,737,消耗品費,飲料水,0,263155,-1002137
6812,0001-20090820-74-1041-1-2543,4,2009-08-20,191,仮払消費税等,飲料水,0,13157,-1015294
6813,0001-20090820-74-1041-1-2543,5,2009-08-20,737,消耗品費,名刺代,0,5334,-1020628
6814,0001-20090820-74-1041-1-2543,6,2009-08-20,191,仮払消費税等,名刺代,0,266,-1020894
6820,0001-20090820-80-1043-1-2547,0,2009-08-20,724,福利厚生費,会費支払い,0,397500,-1418394
6821,0001-20090820-80-1043-1-2547,1,2009-08-20,191,仮払消費税等,会費支払い,0,19875,-1438269
6834,0001-20090820-97-1045-1-2551,0,2009-08-20,754,事務用消耗品費,コピー代,0,32529,-1470798
6835,0001-20090820-97-1045-1-2551,1,2009-08-20,191,仮払消費税等,コピー代,0,1626,-1472424
6838,0001-20090820-98-1046-1-2553,0,2009-08-20,754,事務用消耗品費,事務用品,0,5743,-1478167
6839,0001-20090820-98-1046-1-2553,1,2009-08-20,191,仮払消費税等,事務用品,0,287,-1478454
6857,0001-20090821-38-1063-1-2587,0,2009-08-21,724,福利厚生費,宿泊費,0,45871,-1524325
6858,0001-20090821-38-1063-1-2587,1,2009-08-21,191,仮払消費税等,宿泊費,0,2293,-1526618
6878,0001-20090822-109-1074-1-2609,0,2009-08-22,740,車両費,ガソリン代,0,53943,-1580561
6879,0001-20090822-109-1074-1-2609,1,2009-08-22,191,仮払消費税等,ガソリン代,0,2697,-1583258
6907,0001-20090822-95-1072-1-2605,0,2009-08-22,791,雑費,清掃料,0,68262,-1651520
6908,0001-20090822-95-1072-1-2605,1,2009-08-22,191,仮払消費税等,清掃料,0,3413,-1654933
6915,0001-20090823-28-1077-1-2615,0,2009-08-23,726,旅費交通費,タクシー代,0,2305,-1657238
6916,0001-20090823-28-1077-1-2615,1,2009-08-23,191,仮払消費税等,タクシー代,0,115,-1657353
6931,0001-20090824-120-1084-1-2629,0,2009-08-24,728,業務委託費,業務委託費,0,300000,-1957353
6932,0001-20090824-120-1084-1-2629,1,2009-08-24,191,仮払消費税等,業務委託費,0,15000,-1972353
6935,0001-20090824-62-1081-1-2623,0,2009-08-24,724,福利厚生費,お茶代,0,13810,-1986163
6936,0001-20090824-62-1081-1-2623,1,2009-08-24,191,仮払消費税等,お茶代,0,690,-1986853
7087,0001-20090825-111-1096-1-2653,0,2009-08-25,726,旅費交通費,タクシー代,0,15524,-2002377
7088,0001-20090825-111-1096-1-2653,1,2009-08-25,191,仮払消費税等,タクシー代,0,776,-2003153
7111,0001-20090825-37-1087-1-2635,0,2009-08-25,728,業務委託費,業務委託費,0,1102858,-3106011
7112,0001-20090825-37-1087-1-2635,1,2009-08-25,191,仮払消費税等,業務委託費,0,55142,-3161153
7160,0001-20090826-146-1104-1-2669,0,2009-08-26,728,業務委託費,業務委託費,0,140000,-3301153
7161,0001-20090826-146-1104-1-2669,1,2009-08-26,191,仮払消費税等,業務委託費,0,7000,-3308153
7164,0001-20090826-172-1105-1-2671,0,2009-08-26,728,業務委託費,業務委託費支払い,0,99048,-3407201
7165,0001-20090826-172-1105-1-2671,1,2009-08-26,191,仮払消費税等,業務委託費支払い,0,4952,-3412153
7205,0001-20090827-78-1111-1-2683,0,2009-08-27,728,業務委託費,業務委託費支払い,0,180000,-3592153
7206,0001-20090827-78-1111-1-2683,1,2009-08-27,191,仮払消費税等,業務委託費支払い,0,9000,-3601153
7229,0001-20090828-3-1114-1-2689,0,2009-08-28,724,福利厚生費,宿泊代,0,29696,-3630849
7230,0001-20090828-3-1114-1-2689,1,2009-08-28,191,仮払消費税等,宿泊代,0,1484,-3632333
7243,0001-20090828-93-1117-1-2695,0,2009-08-28,753,修繕維持費,修繕費,0,17000,-3649333
7244,0001-20090828-93-1117-1-2695,1,2009-08-28,191,仮払消費税等,修繕費,0,850,-3650183
7267,0001-20090830-137-1130-1-2721,0,2009-08-30,791,雑費,有線,0,6000,-3656183
7268,0001-20090830-137-1130-1-2721,1,2009-08-30,191,仮払消費税等,有線,0,300,-3656483
7270,0001-20090830-137-1130-1-2721,3,2009-08-30,791,雑費,警備料,0,42858,-3699341
7271,0001-20090830-137-1130-1-2721,4,2009-08-30,191,仮払消費税等,警備料,0,2142,-3701483
7277,0001-20090830-137-1130-1-2721,8,2009-08-30,791,雑費,清掃料,0,70000,-3771483
7278,0001-20090830-137-1130-1-2721,9,2009-08-30,191,仮払消費税等,清掃料,0,3500,-3774983
7288,0001-20090830-70-1122-1-2705,0,2009-08-30,791,雑費,有線,0,6000,-3780983
7289,0001-20090830-70-1122-1-2705,1,2009-08-30,191,仮払消費税等,有線,0,300,-3781283
7291,0001-20090830-70-1122-1-2705,3,2009-08-30,791,雑費,警備料,0,52381,-3833664
7292,0001-20090830-70-1122-1-2705,4,2009-08-30,191,仮払消費税等,警備料,0,2619,-3836283
7296,0001-20090830-70-1122-1-2705,8,2009-08-30,791,雑費,清掃料,0,70000,-3906283
7297,0001-20090830-70-1122-1-2705,9,2009-08-30,191,仮払消費税等,清掃料,0,3500,-3909783
7308,0001-20090830-81-1124-1-2709,0,2009-08-30,724,福利厚生費,お茶代,0,18858,-3928641
7309,0001-20090830-81-1124-1-2709,1,2009-08-30,191,仮払消費税等,お茶代,0,942,-3929583
7318,0001-20090830-99-1126-1-2713,0,2009-08-30,731,運賃,運賃,0,651905,-4581488
7319,0001-20090830-99-1126-1-2713,1,2009-08-30,191,仮払消費税等,運賃,0,32595,-4614083
7322,0001-20090831-1-1131-1-2723,0,2009-08-31,731,運賃,運賃　佐川急便,0,84124,-4698207
7323,0001-20090831-1-1131-1-2723,1,2009-08-31,191,仮払消費税等,運賃　佐川急便,0,4206,-4702413
7609,0001-20090831-145-1173-1-2807,0,2009-08-31,731,運賃,運賃,0,119453,-4821866
7610,0001-20090831-145-1173-1-2807,1,2009-08-31,191,仮払消費税等,運賃,0,5972,-4827838
7613,0001-20090831-36-1132-1-2725,0,2009-08-31,731,運賃,運賃　ヤマト運輸,0,1618610,-6446448
7614,0001-20090831-36-1132-1-2725,1,2009-08-31,191,仮払消費税等,運賃　ヤマト運輸,0,80930,-6527378
7616,0001-20090831-36-1132-1-2725,3,2009-08-31,731,運賃,運賃　佐川急便,0,916715,-7444093
7617,0001-20090831-36-1132-1-2725,4,2009-08-31,191,仮払消費税等,運賃　佐川急便,0,45835,-7489928
7619,0001-20090831-40-1133-1-2727,0,2009-08-31,732,広告宣伝費,広告掲載,0,47620,-7537548
7620,0001-20090831-40-1133-1-2727,1,2009-08-31,191,仮払消費税等,広告掲載,0,2380,-7539928
7664,0001-20090831-77-1139-1-2739,0,2009-08-31,731,運賃,運賃,0,138734,-7678662
7665,0001-20090831-77-1139-1-2739,1,2009-08-31,191,仮払消費税等,運賃,0,6936,-7685598
7672,0001-20090831-83-1140-1-2741,4,2009-08-31,131,普通預金,7月分支払,7936710,0,251112
,,,2009-08,,※※月計※※,,7936710,7333580,
7718,0001-20090902-76-1179-1-2819,0,2009-09-02,724,福利厚生費,制服代,0,53334,197778
7719,0001-20090902-76-1179-1-2819,1,2009-09-02,191,仮払消費税等,制服代,0,2666,195112
7742,0001-20090904-147-1190-1-2841,0,2009-09-04,740,車両費,ガソリン代,0,65162,129950
7743,0001-20090904-147-1190-1-2841,1,2009-09-04,191,仮払消費税等,ガソリン代,0,3258,126692
7841,0001-20090910-168-1221-1-2903,0,2009-09-10,791,雑費,有線,0,6000,120692
7842,0001-20090910-168-1221-1-2903,1,2009-09-10,191,仮払消費税等,有線,0,300,120392
7844,0001-20090910-168-1221-1-2903,3,2009-09-10,791,雑費,警備料,0,42858,77534
7845,0001-20090910-168-1221-1-2903,4,2009-09-10,191,仮払消費税等,警備料,0,2142,75392
7861,0001-20090910-66-1207-1-2875,0,2009-09-10,791,雑費,有線,0,5000,70392
7862,0001-20090910-66-1207-1-2875,1,2009-09-10,191,仮払消費税等,有線,0,250,70142
7864,0001-20090910-66-1207-1-2875,3,2009-09-10,791,雑費,警備料,0,34286,35856
7865,0001-20090910-66-1207-1-2875,4,2009-09-10,191,仮払消費税等,警備料,0,1714,34142
8098,0001-20090915-82-1246-1-2953,0,2009-09-15,740,車両費,ガソリン代,0,24553,9589
8099,0001-20090915-82-1246-1-2953,1,2009-09-15,191,仮払消費税等,ガソリン代,0,1227,8362
8134,0001-20090917-4-1260-1-2981,0,2009-09-17,732,広告宣伝費,広告費,0,30000,-21638
8135,0001-20090917-4-1260-1-2981,1,2009-09-17,191,仮払消費税等,広告費,0,1500,-23138
8168,0001-20090920-101-1278-1-3017,0,2009-09-20,732,広告宣伝費,広告料,0,50000,-73138
8169,0001-20090920-101-1278-1-3017,1,2009-09-20,191,仮払消費税等,広告料,0,2500,-75638
8217,0001-20090920-118-1286-1-3033,0,2009-09-20,754,事務用消耗品費,コピー代,0,6856,-82494
8218,0001-20090920-118-1286-1-3033,1,2009-09-20,191,仮払消費税等,コピー代,0,342,-82836
8221,0001-20090920-135-1287-1-3035,0,2009-09-20,754,事務用消耗品費,事務用品,0,5458,-88294
8222,0001-20090920-135-1287-1-3035,1,2009-09-20,191,仮払消費税等,事務用品,0,272,-88566
8248,0001-20090920-31-1269-1-2999,0,2009-09-20,754,事務用消耗品費,コピー代,0,2680,-91246
8249,0001-20090920-31-1269-1-2999,1,2009-09-20,191,仮払消費税等,コピー代,0,133,-91379
8266,0001-20090920-69-1272-1-3005,0,2009-09-20,791,雑費,有線,0,4762,-96141
8267,0001-20090920-69-1272-1-3005,1,2009-09-20,191,仮払消費税等,有線,0,238,-96379
8270,0001-20090920-71-1273-1-3007,0,2009-09-20,754,事務用消耗品費,事務用品,0,5981,-102360
8271,0001-20090920-71-1273-1-3007,1,2009-09-20,191,仮払消費税等,事務用品,0,299,-102659
8273,0001-20090920-71-1273-1-3007,3,2009-09-20,754,事務用消耗品費,カウンター料金,0,29203,-131862
8274,0001-20090920-71-1273-1-3007,4,2009-09-20,191,仮払消費税等,カウンター料金,0,1460,-133322
8276,0001-20090920-72-1274-1-3009,0,2009-09-20,754,事務用消耗品費,カウンター料金,0,6000,-139322
8277,0001-20090920-72-1274-1-3009,1,2009-09-20,191,仮払消費税等,カウンター料金,0,300,-139622
8280,0001-20090920-78-1275-1-3011,0,2009-09-20,737,消耗品費,ファイル等,0,35038,-174660
8281,0001-20090920-78-1275-1-3011,1,2009-09-20,191,仮払消費税等,ファイル等,0,1751,-176411
8283,0001-20090920-78-1275-1-3011,3,2009-09-20,737,消耗品費,飲料水,0,265940,-442351
8284,0001-20090920-78-1275-1-3011,4,2009-09-20,191,仮払消費税等,飲料水,0,13296,-455647
8286,0001-20090920-97-1276-1-3013,0,2009-09-20,754,事務用消耗品費,コピー代,0,34713,-490360
8287,0001-20090920-97-1276-1-3013,1,2009-09-20,191,仮払消費税等,コピー代,0,1735,-492095
8290,0001-20090920-98-1277-1-3015,0,2009-09-20,754,事務用消耗品費,事務用品,0,4880,-496975
8291,0001-20090920-98-1277-1-3015,1,2009-09-20,191,仮払消費税等,事務用品,0,243,-497218
8302,0001-20090921-154-1295-1-3051,0,2009-09-21,733,交際接待費,飲食代　居酒屋花道4名,0,23610,-520828
8303,0001-20090921-154-1295-1-3051,1,2009-09-21,191,仮払消費税等,飲食代　居酒屋花道4名,0,1180,-522008
8305,0001-20090921-154-1295-1-3051,3,2009-09-21,733,交際接待費,飲食代　スナックみわ,0,33715,-555723
8306,0001-20090921-154-1295-1-3051,4,2009-09-21,191,仮払消費税等,飲食代　スナックみわ,0,1685,-557408
8358,0001-20090922-38-1298-1-3057,0,2009-09-22,724,福利厚生費,宿泊費,0,45871,-603279
8359,0001-20090922-38-1298-1-3057,1,2009-09-22,191,仮払消費税等,宿泊費,0,2293,-605572
8362,0001-20090922-61-1299-1-3059,0,2009-09-22,724,福利厚生費,お茶代,0,10381,-615953
8363,0001-20090922-61-1299-1-3059,1,2009-09-22,191,仮払消費税等,お茶代,0,519,-616472
8378,0001-20090922-95-1303-1-3067,0,2009-09-22,791,雑費,清掃料,0,68262,-684734
8379,0001-20090922-95-1303-1-3067,1,2009-09-22,191,仮払消費税等,清掃料,0,3413,-688147
8390,0001-20090923-28-1309-1-3079,0,2009-09-23,726,旅費交通費,タクシー代,0,2305,-690452
8391,0001-20090923-28-1309-1-3079,1,2009-09-23,191,仮払消費税等,タクシー代,0,115,-690567
8394,0001-20090923-3-1307-1-3075,0,2009-09-23,724,福利厚生費,宿泊代,0,27478,-718045
8395,0001-20090923-3-1307-1-3075,1,2009-09-23,191,仮払消費税等,宿泊代,0,1373,-719418
8402,0001-20090924-109-1314-1-3089,0,2009-09-24,740,車両費,ガソリン代,0,43239,-762657
8403,0001-20090924-109-1314-1-3089,1,2009-09-24,191,仮払消費税等,ガソリン代,0,2161,-764818
8406,0001-20090924-120-1315-1-3091,0,2009-09-24,728,業務委託費,業務委託費,0,480000,-1244818
8407,0001-20090924-120-1315-1-3091,1,2009-09-24,191,仮払消費税等,業務委託費,0,24000,-1268818
8416,0001-20090924-146-1317-1-3095,0,2009-09-24,728,業務委託費,業務委託費,0,140000,-1408818
8417,0001-20090924-146-1317-1-3095,1,2009-09-24,191,仮払消費税等,業務委託費,0,7000,-1415818
8430,0001-20090925-111-1322-1-3105,0,2009-09-25,726,旅費交通費,タクシー代,0,8562,-1424380
8431,0001-20090925-111-1322-1-3105,1,2009-09-25,191,仮払消費税等,タクシー代,0,428,-1424808
8470,0001-20090925-172-1329-1-3119,0,2009-09-25,728,業務委託費,業務委託費支払い,0,82858,-1507666
8471,0001-20090925-172-1329-1-3119,1,2009-09-25,191,仮払消費税等,業務委託費支払い,0,4142,-1511808
8484,0001-20090925-78-1320-1-3101,0,2009-09-25,728,業務委託費,業務委託費支払い,0,184152,-1695960
8485,0001-20090925-78-1320-1-3101,1,2009-09-25,191,仮払消費税等,業務委託費支払い,0,9207,-1705167
8664,0001-20090927-37-1339-1-3139,0,2009-09-27,728,業務委託費,業務委託費,0,939048,-2644215
8665,0001-20090927-37-1339-1-3139,1,2009-09-27,191,仮払消費税等,業務委託費,0,46952,-2691167
8684,0001-20090928-93-1347-1-3155,0,2009-09-28,753,修繕維持費,修繕費,0,17000,-2708167
8685,0001-20090928-93-1347-1-3155,1,2009-09-28,191,仮払消費税等,修繕費,0,850,-2709017
8692,0001-20090929-137-1351-1-3163,0,2009-09-29,791,雑費,有線,0,6000,-2715017
8693,0001-20090929-137-1351-1-3163,1,2009-09-29,191,仮払消費税等,有線,0,300,-2715317
8695,0001-20090929-137-1351-1-3163,3,2009-09-29,791,雑費,警備料,0,42858,-2758175
8696,0001-20090929-137-1351-1-3163,4,2009-09-29,191,仮払消費税等,警備料,0,2142,-2760317
8702,0001-20090929-137-1351-1-3163,8,2009-09-29,791,雑費,清掃料,0,70000,-2830317
8703,0001-20090929-137-1351-1-3163,9,2009-09-29,191,仮払消費税等,清掃料,0,3500,-2833817
8722,0001-20090929-81-1348-1-3157,0,2009-09-29,724,福利厚生費,お茶代,0,18000,-2851817
8723,0001-20090929-81-1348-1-3157,1,2009-09-29,191,仮払消費税等,お茶代,0,900,-2852717
8730,0001-20090930-1-1353-1-3167,0,2009-09-30,731,運賃,運賃　佐川急便,0,125296,-2978013
8731,0001-20090930-1-1353-1-3167,1,2009-09-30,191,仮払消費税等,運賃　佐川急便,0,6264,-2984277
9003,0001-20090930-145-1399-1-3259,0,2009-09-30,731,運賃,運賃,0,132515,-3116792
9004,0001-20090930-145-1399-1-3259,1,2009-09-30,191,仮払消費税等,運賃,0,6625,-3123417
9040,0001-20090930-36-1356-1-3173,0,2009-09-30,731,運賃,運賃　ヤマト運輸,0,1650467,-4773884
9041,0001-20090930-36-1356-1-3173,1,2009-09-30,191,仮払消費税等,運賃　ヤマト運輸,0,82523,-4856407
9043,0001-20090930-36-1356-1-3173,3,2009-09-30,731,運賃,運賃　佐川急便,0,810324,-5666731
9044,0001-20090930-36-1356-1-3173,4,2009-09-30,191,仮払消費税等,運賃　佐川急便,0,40516,-5707247
9046,0001-20090930-40-1357-1-3175,0,2009-09-30,732,広告宣伝費,広告掲載,0,47620,-5754867
9047,0001-20090930-40-1357-1-3175,1,2009-09-30,191,仮払消費税等,広告掲載,0,2380,-5757247
9070,0001-20090930-70-1361-1-3183,0,2009-09-30,791,雑費,有線,0,6000,-5763247
9071,0001-20090930-70-1361-1-3183,1,2009-09-30,191,仮払消費税等,有線,0,300,-5763547
9073,0001-20090930-70-1361-1-3183,3,2009-09-30,791,雑費,警備料,0,52381,-5815928
9074,0001-20090930-70-1361-1-3183,4,2009-09-30,191,仮払消費税等,警備料,0,2619,-5818547
9078,0001-20090930-70-1361-1-3183,8,2009-09-30,791,雑費,清掃料,0,70000,-5888547
9079,0001-20090930-70-1361-1-3183,9,2009-09-30,191,仮払消費税等,清掃料,0,3500,-5892047
9105,0001-20090930-77-1364-1-3189,2,2009-09-30,731,運賃,運賃,0,157543,-6049590
9106,0001-20090930-77-1364-1-3189,3,2009-09-30,191,仮払消費税等,運賃,0,7877,-6057467
9121,0001-20090930-90-1367-1-3195,1,2009-09-30,131,普通預金,8月分支払,7333580,0,1276113
9131,0001-20090930-99-1369-1-3199,0,2009-09-30,731,運賃,運賃,0,601943,674170
9132,0001-20090930-99-1369-1-3199,1,2009-09-30,191,仮払消費税等,運賃,0,30097,644073
,,,2009-09,,※※月計※※,,7333580,6940619,
9169,0001-20091002-32-1410-1-3281,0,2009-10-02,754,事務用消耗品費,事務用品費,0,6499,637574
9170,0001-20091002-32-1410-1-3281,1,2009-10-02,191,仮払消費税等,事務用品費,0,324,637250
9201,0001-20091005-147-1424-1-3309,0,2009-10-05,740,車両費,ガソリン代,0,3774,633476
9202,0001-20091005-147-1424-1-3309,1,2009-10-05,191,仮払消費税等,ガソリン代,0,188,633288
9217,0001-20091005-76-1420-1-3301,0,2009-10-05,724,福利厚生費,制服代,0,53334,579954
9218,0001-20091005-76-1420-1-3301,1,2009-10-05,191,仮払消費税等,制服代,0,2666,577288
9298,0001-20091008-82-1439-1-3339,0,2009-10-08,740,車両費,ガソリン代,0,27372,549916
9299,0001-20091008-82-1439-1-3339,1,2009-10-08,191,仮払消費税等,ガソリン代,0,1368,548548
9350,0001-20091010-168-1464-1-3389,0,2009-10-10,791,雑費,有線,0,6000,542548
9351,0001-20091010-168-1464-1-3389,1,2009-10-10,191,仮払消費税等,有線,0,300,542248
9353,0001-20091010-168-1464-1-3389,3,2009-10-10,791,雑費,警備料,0,42858,499390
9354,0001-20091010-168-1464-1-3389,4,2009-10-10,191,仮払消費税等,警備料,0,2142,497248
9387,0001-20091010-65-1447-1-3355,0,2009-10-10,791,雑費,有線,0,5000,492248
9388,0001-20091010-65-1447-1-3355,1,2009-10-10,191,仮払消費税等,有線,0,250,491998
9390,0001-20091010-65-1447-1-3355,3,2009-10-10,791,雑費,警備料,0,34286,457712
9391,0001-20091010-65-1447-1-3355,4,2009-10-10,191,仮払消費税等,警備料,0,1714,455998
9458,0001-20091012-154-1468-1-3397,0,2009-10-12,733,交際接待費,コーヒー代2名,0,1200,454798
9459,0001-20091012-154-1468-1-3397,1,2009-10-12,191,仮払消費税等,コーヒー代2名,0,60,454738
9510,0001-20091015-4-1476-1-3413,0,2009-10-15,732,広告宣伝費,広告費,0,30000,424738
9511,0001-20091015-4-1476-1-3413,1,2009-10-15,191,仮払消費税等,広告費,0,1500,423238
9645,0001-20091020-101-1509-1-3479,0,2009-10-20,732,広告宣伝費,広告料,0,50000,373238
9646,0001-20091020-101-1509-1-3479,1,2009-10-20,191,仮払消費税等,広告料,0,2500,370738
9671,0001-20091020-118-1513-1-3487,0,2009-10-20,754,事務用消耗品費,コピー代,0,6656,364082
9672,0001-20091020-118-1513-1-3487,1,2009-10-20,191,仮払消費税等,コピー代,0,332,363750
9675,0001-20091020-119-1514-1-3489,0,2009-10-20,754,事務用消耗品費,事務用品,0,6334,357416
9676,0001-20091020-119-1514-1-3489,1,2009-10-20,191,仮払消費税等,事務用品,0,316,357100
9679,0001-20091020-139-1515-1-3491,0,2009-10-20,724,福利厚生費,社員夜食代,0,21434,335666
9680,0001-20091020-139-1515-1-3491,1,2009-10-20,191,仮払消費税等,社員夜食代,0,1071,334595
9691,0001-20091020-31-1499-1-3459,0,2009-10-20,754,事務用消耗品費,コピー代,0,2572,332023
9692,0001-20091020-31-1499-1-3459,1,2009-10-20,191,仮払消費税等,コピー代,0,128,331895
9699,0001-20091020-68-1501-1-3463,0,2009-10-20,754,事務用消耗品費,カウンター料金,0,6000,325895
9700,0001-20091020-68-1501-1-3463,1,2009-10-20,191,仮払消費税等,カウンター料金,0,300,325595
9703,0001-20091020-71-1502-1-3465,0,2009-10-20,754,事務用消耗品費,事務用品,0,4013,321582
9704,0001-20091020-71-1502-1-3465,1,2009-10-20,191,仮払消費税等,事務用品,0,200,321382
9706,0001-20091020-71-1502-1-3465,3,2009-10-20,754,事務用消耗品費,カウンター料金,0,31435,289947
9707,0001-20091020-71-1502-1-3465,4,2009-10-20,191,仮払消費税等,カウンター料金,0,1571,288376
9709,0001-20091020-72-1503-1-3467,0,2009-10-20,737,消耗品費,ファイル等,0,13567,274809
9710,0001-20091020-72-1503-1-3467,1,2009-10-20,191,仮払消費税等,ファイル等,0,678,274131
9712,0001-20091020-72-1503-1-3467,3,2009-10-20,737,消耗品費,飲料水,0,219895,54236
9713,0001-20091020-72-1503-1-3467,4,2009-10-20,191,仮払消費税等,飲料水,0,10994,43242
9714,0001-20091020-72-1503-1-3467,5,2009-10-20,737,消耗品費,名刺代,0,12000,31242
9715,0001-20091020-72-1503-1-3467,6,2009-10-20,191,仮払消費税等,名刺代,0,600,30642
9717,0001-20091020-80-1504-1-3469,0,2009-10-20,724,福利厚生費,会費支払い,0,397500,-366858
9718,0001-20091020-80-1504-1-3469,1,2009-10-20,191,仮払消費税等,会費支払い,0,19875,-386733
9721,0001-20091020-97-1505-1-3471,0,2009-10-20,754,事務用消耗品費,コピー代,0,35419,-422152
9722,0001-20091020-97-1505-1-3471,1,2009-10-20,191,仮払消費税等,コピー代,0,1770,-423922
9725,0001-20091020-98-1506-1-3473,0,2009-10-20,754,事務用消耗品費,事務用品,0,2348,-426270
9726,0001-20091020-98-1506-1-3473,1,2009-10-20,191,仮払消費税等,事務用品,0,117,-426387
9791,0001-20091021-62-1523-1-3507,0,2009-10-21,724,福利厚生費,お茶代,0,9715,-436102
9792,0001-20091021-62-1523-1-3507,1,2009-10-21,191,仮払消費税等,お茶代,0,485,-436587
9827,0001-20091022-137-1537-1-3535,0,2009-10-22,791,雑費,有線,0,6000,-442587
9828,0001-20091022-137-1537-1-3535,1,2009-10-22,191,仮払消費税等,有線,0,300,-442887
9830,0001-20091022-137-1537-1-3535,3,2009-10-22,791,雑費,警備料,0,42858,-485745
9831,0001-20091022-137-1537-1-3535,4,2009-10-22,191,仮払消費税等,警備料,0,2142,-487887
9837,0001-20091022-137-1537-1-3535,8,2009-10-22,791,雑費,清掃料,0,70000,-557887
9838,0001-20091022-137-1537-1-3535,9,2009-10-22,191,仮払消費税等,清掃料,0,3500,-561387
9852,0001-20091022-3-1530-1-3521,0,2009-10-22,724,福利厚生費,宿泊代,0,28477,-589864
9853,0001-20091022-3-1530-1-3521,1,2009-10-22,191,仮払消費税等,宿泊代,0,1423,-591287
9871,0001-20091022-95-1535-1-3531,0,2009-10-22,791,雑費,清掃料,0,68262,-659549
9872,0001-20091022-95-1535-1-3531,1,2009-10-22,191,仮払消費税等,清掃料,0,3413,-662962
9883,0001-20091023-28-1542-1-3545,0,2009-10-23,726,旅費交通費,タクシー代,0,2305,-665267
9884,0001-20091023-28-1542-1-3545,1,2009-10-23,191,仮払消費税等,タクシー代,0,115,-665382
9895,0001-20091024-146-1547-1-3555,0,2009-10-24,728,業務委託費,業務委託費,0,140000,-805382
9896,0001-20091024-146-1547-1-3555,1,2009-10-24,191,仮払消費税等,業務委託費,0,7000,-812382
9930,0001-20091025-111-1558-1-3577,0,2009-10-25,726,旅費交通費,タクシー代,0,12858,-825240
9931,0001-20091025-111-1558-1-3577,1,2009-10-25,191,仮払消費税等,タクシー代,0,642,-825882
9957,0001-20091025-37-1550-1-3561,0,2009-10-25,728,業務委託費,業務委託費,0,1088572,-1914454
9958,0001-20091025-37-1550-1-3561,1,2009-10-25,191,仮払消費税等,業務委託費,0,54428,-1968882
10082,0001-20091025-92-1553-1-3567,0,2009-10-25,753,修繕維持費,コピー機修繕,0,17143,-1986025
10083,0001-20091025-92-1553-1-3567,1,2009-10-25,191,仮払消費税等,コピー機修繕,0,857,-1986882
10086,0001-20091026-120-1566-1-3593,0,2009-10-26,728,業務委託費,業務委託費,0,600000,-2586882
10087,0001-20091026-120-1566-1-3593,1,2009-10-26,191,仮払消費税等,業務委託費,0,30000,-2616882
10095,0001-20091026-172-1568-1-3597,0,2009-10-26,728,業務委託費,業務委託費支払い,0,112381,-2729263
10096,0001-20091026-172-1568-1-3597,1,2009-10-26,191,仮払消費税等,業務委託費支払い,0,5619,-2734882
10107,0001-20091026-38-1563-1-3587,0,2009-10-26,724,福利厚生費,宿泊費,0,40610,-2775492
10108,0001-20091026-38-1563-1-3587,1,2009-10-26,191,仮払消費税等,宿泊費,0,2030,-2777522
10117,0001-20091026-78-1565-1-3591,0,2009-10-26,728,業務委託費,業務委託費支払い,0,180000,-2957522
10118,0001-20091026-78-1565-1-3591,1,2009-10-26,191,仮払消費税等,業務委託費支払い,0,9000,-2966522
10168,0001-20091028-93-1578-1-3617,0,2009-10-28,753,修繕維持費,修繕費,0,17000,-2983522
10169,0001-20091028-93-1578-1-3617,1,2009-10-28,191,仮払消費税等,修繕費,0,850,-2984372
10172,0001-20091029-109-1581-1-3623,0,2009-10-29,740,車両費,ガソリン代,0,58757,-3043129
10173,0001-20091029-109-1581-1-3623,1,2009-10-29,191,仮払消費税等,ガソリン代,0,2937,-3046066
10219,0001-20091030-70-1584-1-3629,0,2009-10-30,791,雑費,有線,0,6000,-3052066
10220,0001-20091030-70-1584-1-3629,1,2009-10-30,191,仮払消費税等,有線,0,300,-3052366
10222,0001-20091030-70-1584-1-3629,3,2009-10-30,791,雑費,警備料,0,52381,-3104747
10223,0001-20091030-70-1584-1-3629,4,2009-10-30,191,仮払消費税等,警備料,0,2619,-3107366
10229,0001-20091030-70-1584-1-3629,8,2009-10-30,791,雑費,清掃料,0,70000,-3177366
10230,0001-20091030-70-1584-1-3629,9,2009-10-30,191,仮払消費税等,清掃料,0,3500,-3180866
10243,0001-20091031-1-1590-1-3641,0,2009-10-31,731,運賃,運賃　佐川急便,0,204753,-3385619
10244,0001-20091031-1-1590-1-3641,1,2009-10-31,191,仮払消費税等,運賃　佐川急便,0,10237,-3395856
10548,0001-20091031-145-1635-1-3731,0,2009-10-31,731,運賃,運賃,0,145429,-3541285
10549,0001-20091031-145-1635-1-3731,1,2009-10-31,191,仮払消費税等,運賃,0,7271,-3548556
10552,0001-20091031-36-1591-1-3643,0,2009-10-31,731,運賃,運賃　ヤマト運輸,0,1633000,-5181556
10553,0001-20091031-36-1591-1-3643,1,2009-10-31,191,仮払消費税等,運賃　ヤマト運輸,0,81650,-5263206
10555,0001-20091031-36-1591-1-3643,3,2009-10-31,731,運賃,運賃　佐川急便,0,922305,-6185511
10556,0001-20091031-36-1591-1-3643,4,2009-10-31,191,仮払消費税等,運賃　佐川急便,0,46115,-6231626
10558,0001-20091031-40-1592-1-3645,0,2009-10-31,732,広告宣伝費,広告掲載,0,47620,-6279246
10559,0001-20091031-40-1592-1-3645,1,2009-10-31,191,仮払消費税等,広告掲載,0,2380,-6281626
10590,0001-20091031-77-1599-1-3659,0,2009-10-31,731,運賃,運賃,0,164620,-6446246
10591,0001-20091031-77-1599-1-3659,1,2009-10-31,191,仮払消費税等,運賃,0,8230,-6454476
10601,0001-20091031-81-1601-1-3663,0,2009-10-31,724,福利厚生費,お茶代,0,19524,-6474000
10602,0001-20091031-81-1601-1-3663,1,2009-10-31,191,仮払消費税等,お茶代,0,976,-6474976
10606,0001-20091031-82-1602-1-3665,1,2009-10-31,131,普通預金,9月分支払,6940619,0,465643
10610,0001-20091031-99-1603-1-3667,0,2009-10-31,731,運賃,運賃,0,680115,-214472
10611,0001-20091031-99-1603-1-3667,1,2009-10-31,191,仮払消費税等,運賃,0,34005,-248477
,,,2009-10,,※※月計※※,,6940619,7833169,
10732,0001-20091108-32-1662-1-3785,0,2009-11-08,754,事務用消耗品費,事務用品費,0,1505,-249982
10733,0001-20091108-32-1662-1-3785,1,2009-11-08,191,仮払消費税等,事務用品費,0,75,-250057
10748,0001-20091109-139-1668-1-3797,0,2009-11-09,724,福利厚生費,社員夜食代,0,29572,-279629
10749,0001-20091109-139-1668-1-3797,1,2009-11-09,191,仮払消費税等,社員夜食代,0,1478,-281107
10790,0001-20091110-147-1686-1-3833,0,2009-11-10,740,車両費,ガソリン代,0,6780,-287887
10791,0001-20091110-147-1686-1-3833,1,2009-11-10,191,仮払消費税等,ガソリン代,0,338,-288225
10813,0001-20091110-168-1690-1-3841,0,2009-11-10,791,雑費,有線,0,6000,-294225
10814,0001-20091110-168-1690-1-3841,1,2009-11-10,191,仮払消費税等,有線,0,300,-294525
10816,0001-20091110-168-1690-1-3841,3,2009-11-10,791,雑費,警備料,0,42858,-337383
10817,0001-20091110-168-1690-1-3841,4,2009-11-10,191,仮払消費税等,警備料,0,2142,-339525
10851,0001-20091110-66-1675-1-3811,0,2009-11-10,791,雑費,有線,0,5000,-344525
10852,0001-20091110-66-1675-1-3811,1,2009-11-10,191,仮払消費税等,有線,0,250,-344775
10854,0001-20091110-66-1675-1-3811,3,2009-11-10,791,雑費,警備料,0,34286,-379061
10855,0001-20091110-66-1675-1-3811,4,2009-11-10,191,仮払消費税等,警備料,0,1714,-380775
10991,0001-20091115-76-1708-1-3877,0,2009-11-15,724,福利厚生費,社員夜食代,0,33607,-414382
10992,0001-20091115-76-1708-1-3877,1,2009-11-15,191,仮払消費税等,社員夜食代,0,1680,-416062
11074,0001-20091116-82-1720-1-3901,0,2009-11-16,740,車両費,ガソリン代,0,20800,-436862
11075,0001-20091116-82-1720-1-3901,1,2009-11-16,191,仮払消費税等,ガソリン代,0,1040,-437902
11077,0001-20091116-82-1720-1-3901,3,2009-11-16,740,車両費,ウォッシャー液,0,352,-438254
11078,0001-20091116-82-1720-1-3901,4,2009-11-16,191,仮払消費税等,ウォッシャー液,0,17,-438271
11080,0001-20091117-4-1724-1-3909,0,2009-11-17,732,広告宣伝費,広告費,0,30000,-468271
11081,0001-20091117-4-1724-1-3909,1,2009-11-17,191,仮払消費税等,広告費,0,1500,-469771
11120,0001-20091120-101-1745-1-3951,0,2009-11-20,732,広告宣伝費,広告料,0,50000,-519771
11121,0001-20091120-101-1745-1-3951,1,2009-11-20,191,仮払消費税等,広告料,0,2500,-522271
11157,0001-20091120-118-1751-1-3963,0,2009-11-20,754,事務用消耗品費,コピー代,0,7016,-529287
11158,0001-20091120-118-1751-1-3963,1,2009-11-20,191,仮払消費税等,コピー代,0,350,-529637
11161,0001-20091120-119-1752-1-3965,0,2009-11-20,754,事務用消耗品費,事務用品,0,3706,-533343
11162,0001-20091120-119-1752-1-3965,1,2009-11-20,191,仮払消費税等,事務用品,0,185,-533528
11202,0001-20091120-31-1734-1-3929,0,2009-11-20,754,事務用消耗品費,コピー代,0,2733,-536261
11203,0001-20091120-31-1734-1-3929,1,2009-11-20,191,仮払消費税等,コピー代,0,136,-536397
11234,0001-20091120-66-1738-1-3937,0,2009-11-20,791,雑費,有線,0,4762,-541159
11235,0001-20091120-66-1738-1-3937,1,2009-11-20,191,仮払消費税等,有線,0,238,-541397
11238,0001-20091120-67-1739-1-3939,0,2009-11-20,754,事務用消耗品費,カウンター料金,0,6000,-547397
11239,0001-20091120-67-1739-1-3939,1,2009-11-20,191,仮払消費税等,カウンター料金,0,300,-547697
11242,0001-20091120-71-1740-1-3941,0,2009-11-20,754,事務用消耗品費,事務用品,0,3670,-551367
11243,0001-20091120-71-1740-1-3941,1,2009-11-20,191,仮払消費税等,事務用品,0,183,-551550
11245,0001-20091120-71-1740-1-3941,3,2009-11-20,754,事務用消耗品費,カウンター料金,0,31448,-582998
11246,0001-20091120-71-1740-1-3941,4,2009-11-20,191,仮払消費税等,カウンター料金,0,1572,-584570
11248,0001-20091120-73-1741-1-3943,0,2009-11-20,737,消耗品費,ファイル等,0,11544,-596114
11249,0001-20091120-73-1741-1-3943,1,2009-11-20,191,仮払消費税等,ファイル等,0,577,-596691
11251,0001-20091120-73-1741-1-3943,3,2009-11-20,737,消耗品費,飲料水,0,209980,-806671
11252,0001-20091120-73-1741-1-3943,4,2009-11-20,191,仮払消費税等,飲料水,0,10498,-817169
11253,0001-20091120-73-1741-1-3943,5,2009-11-20,737,消耗品費,名刺代,0,12458,-829627
11254,0001-20091120-73-1741-1-3943,6,2009-11-20,191,仮払消費税等,名刺代,0,622,-830249
11266,0001-20091120-97-1743-1-3947,0,2009-11-20,754,事務用消耗品費,コピー代,0,37144,-867393
11267,0001-20091120-97-1743-1-3947,1,2009-11-20,191,仮払消費税等,コピー代,0,1857,-869250
11270,0001-20091120-98-1744-1-3949,0,2009-11-20,754,事務用消耗品費,事務用品,0,3378,-872628
11271,0001-20091120-98-1744-1-3949,1,2009-11-20,191,仮払消費税等,事務用品,0,168,-872796
11312,0001-20091122-62-1763-1-3987,0,2009-11-22,724,福利厚生費,お茶代,0,10524,-883320
11313,0001-20091122-62-1763-1-3987,1,2009-11-22,191,仮払消費税等,お茶代,0,526,-883846
11324,0001-20091122-95-1766-1-3993,0,2009-11-22,791,雑費,清掃料,0,68262,-952108
11325,0001-20091122-95-1766-1-3993,1,2009-11-22,191,仮払消費税等,清掃料,0,3413,-955521
11340,0001-20091123-28-1774-1-4009,0,2009-11-23,726,旅費交通費,タクシー代,0,2305,-957826
11341,0001-20091123-28-1774-1-4009,1,2009-11-23,191,仮払消費税等,タクシー代,0,115,-957941
11344,0001-20091123-3-1771-1-4003,0,2009-11-23,724,福利厚生費,宿泊代,0,29544,-987485
11345,0001-20091123-3-1771-1-4003,1,2009-11-23,191,仮払消費税等,宿泊代,0,1477,-988962
11467,0001-20091124-120-1781-1-4023,0,2009-11-24,728,業務委託費,業務委託費,0,460000,-1448962
11468,0001-20091124-120-1781-1-4023,1,2009-11-24,191,仮払消費税等,業務委託費,0,23000,-1471962
11477,0001-20091124-37-1778-1-4017,0,2009-11-24,728,業務委託費,業務委託費,0,833524,-2305486
11478,0001-20091124-37-1778-1-4017,1,2009-11-24,191,仮払消費税等,業務委託費,0,41676,-2347162
11502,0001-20091125-109-1790-1-4041,0,2009-11-25,740,車両費,高速代,0,9853,-2357015
11503,0001-20091125-109-1790-1-4041,1,2009-11-25,191,仮払消費税等,高速代,0,492,-2357507
11505,0001-20091125-109-1790-1-4041,3,2009-11-25,740,車両費,ガソリン代,0,53430,-2410937
11506,0001-20091125-109-1790-1-4041,4,2009-11-25,191,仮払消費税等,ガソリン代,0,2671,-2413608
11523,0001-20091125-111-1792-1-4045,0,2009-11-25,726,旅費交通費,タクシー代,0,14096,-2427704
11524,0001-20091125-111-1792-1-4045,1,2009-11-25,191,仮払消費税等,タクシー代,0,704,-2428408
11532,0001-20091125-146-1794-1-4049,0,2009-11-25,728,業務委託費,業務委託費,0,160000,-2588408
11533,0001-20091125-146-1794-1-4049,1,2009-11-25,191,仮払消費税等,業務委託費,0,8000,-2596408
11540,0001-20091125-172-1796-1-4053,0,2009-11-25,728,業務委託費,業務委託費支払い,0,120000,-2716408
11541,0001-20091125-172-1796-1-4053,1,2009-11-25,191,仮払消費税等,業務委託費支払い,0,6000,-2722408
11556,0001-20091125-78-1786-1-4033,0,2009-11-25,728,業務委託費,業務委託費支払い,0,180000,-2902408
11557,0001-20091125-78-1786-1-4033,1,2009-11-25,191,仮払消費税等,業務委託費支払い,0,9000,-2911408
11632,0001-20091128-154-1813-1-4087,0,2009-11-28,733,交際接待費,食事代　ホテル大分2名,0,3372,-2914780
11633,0001-20091128-154-1813-1-4087,1,2009-11-28,191,仮払消費税等,食事代　ホテル大分2名,0,168,-2914948
11635,0001-20091128-154-1813-1-4087,3,2009-11-28,733,交際接待費,飲食代　ホテル大分2名,0,14724,-2929672
11636,0001-20091128-154-1813-1-4087,4,2009-11-28,191,仮払消費税等,飲食代　ホテル大分2名,0,736,-2930408
11650,0001-20091128-38-1811-1-4083,0,2009-11-28,724,福利厚生費,宿泊費,0,45871,-2976279
11651,0001-20091128-38-1811-1-4083,1,2009-11-28,191,仮払消費税等,宿泊費,0,2293,-2978572
11654,0001-20091128-93-1812-1-4085,0,2009-11-28,753,修繕維持費,修繕費,0,17000,-2995572
11655,0001-20091128-93-1812-1-4085,1,2009-11-28,191,仮払消費税等,修繕費,0,850,-2996422
11658,0001-20091129-137-1817-1-4095,0,2009-11-29,791,雑費,有線,0,6000,-3002422
11659,0001-20091129-137-1817-1-4095,1,2009-11-29,191,仮払消費税等,有線,0,300,-3002722
11661,0001-20091129-137-1817-1-4095,3,2009-11-29,791,雑費,警備料,0,42858,-3045580
11662,0001-20091129-137-1817-1-4095,4,2009-11-29,191,仮払消費税等,警備料,0,2142,-3047722
11668,0001-20091129-137-1817-1-4095,8,2009-11-29,791,雑費,清掃料,0,70000,-3117722
11669,0001-20091129-137-1817-1-4095,9,2009-11-29,191,仮払消費税等,清掃料,0,3500,-3121222
11699,0001-20091129-81-1816-1-4093,0,2009-11-29,724,福利厚生費,お茶代,0,18667,-3139889
11700,0001-20091129-81-1816-1-4093,1,2009-11-29,191,仮払消費税等,お茶代,0,933,-3140822
11703,0001-20091130-1-1820-1-4101,0,2009-11-30,731,運賃,運賃　佐川急便,0,363686,-3504508
11704,0001-20091130-1-1820-1-4101,1,2009-11-30,191,仮払消費税等,運賃　佐川急便,0,18184,-3522692
12007,0001-20091130-145-1868-1-4197,0,2009-11-30,731,運賃,運賃,0,133715,-3656407
12008,0001-20091130-145-1868-1-4197,1,2009-11-30,191,仮払消費税等,運賃,0,6685,-3663092
12023,0001-20091130-155-1871-1-4203,0,2009-11-30,740,車両費,点検整備,0,24210,-3687302
12024,0001-20091130-155-1871-1-4203,1,2009-11-30,191,仮払消費税等,点検整備,0,1210,-3688512
12027,0001-20091130-36-1822-1-4105,0,2009-11-30,731,運賃,運賃　ヤマト運輸,0,1723867,-5412379
12028,0001-20091130-36-1822-1-4105,1,2009-11-30,191,仮払消費税等,運賃　ヤマト運輸,0,86193,-5498572
12030,0001-20091130-36-1822-1-4105,3,2009-11-30,731,運賃,運賃　佐川急便,0,1281581,-6780153
12031,0001-20091130-36-1822-1-4105,4,2009-11-30,191,仮払消費税等,運賃　佐川急便,0,64079,-6844232
12033,0001-20091130-40-1823-1-4107,0,2009-11-30,732,広告宣伝費,広告掲載,0,47620,-6891852
12034,0001-20091130-40-1823-1-4107,1,2009-11-30,191,仮払消費税等,広告掲載,0,2380,-6894232
12068,0001-20091130-70-1829-1-4119,0,2009-11-30,791,雑費,有線,0,6000,-6900232
12069,0001-20091130-70-1829-1-4119,1,2009-11-30,191,仮払消費税等,有線,0,300,-6900532
12071,0001-20091130-70-1829-1-4119,3,2009-11-30,791,雑費,警備料,0,52381,-6952913
12072,0001-20091130-70-1829-1-4119,4,2009-11-30,191,仮払消費税等,警備料,0,2619,-6955532
12078,0001-20091130-70-1829-1-4119,8,2009-11-30,791,雑費,清掃料,0,70000,-7025532
12079,0001-20091130-70-1829-1-4119,9,2009-11-30,191,仮払消費税等,清掃料,0,3500,-7029032
12099,0001-20091130-77-1833-1-4127,0,2009-11-30,731,運賃,運賃,0,187229,-7216261
12100,0001-20091130-77-1833-1-4127,1,2009-11-30,191,仮払消費税等,運賃,0,9361,-7225622
12104,0001-20091130-83-1834-1-4129,1,2009-11-30,131,普通預金,10月分支払,7833169,0,607547
12114,0001-20091130-99-1836-1-4133,0,2009-11-30,731,運賃,運賃,0,805810,-198263
12115,0001-20091130-99-1836-1-4133,1,2009-11-30,191,仮払消費税等,運賃,0,40290,-238553
,,,2009-11,,※※月計※※,,7833169,7823245,
12148,0001-20091203-147-1879-1-4219,0,2009-12-03,740,車両費,ガソリン代,0,5943,-244496
12149,0001-20091203-147-1879-1-4219,1,2009-12-03,191,仮払消費税等,ガソリン代,0,297,-244793
12262,0001-20091208-76-1898-1-4257,0,2009-12-08,724,福利厚生費,社員夜食代,0,72192,-316985
12263,0001-20091208-76-1898-1-4257,1,2009-12-08,191,仮払消費税等,社員夜食代,0,3609,-320594
12340,0001-20091210-168-1924-1-4309,0,2009-12-10,791,雑費,有線,0,6000,-326594
12341,0001-20091210-168-1924-1-4309,1,2009-12-10,191,仮払消費税等,有線,0,300,-326894
12343,0001-20091210-168-1924-1-4309,3,2009-12-10,791,雑費,警備料,0,42858,-369752
12344,0001-20091210-168-1924-1-4309,4,2009-12-10,191,仮払消費税等,警備料,0,2142,-371894
12378,0001-20091210-69-1909-1-4279,0,2009-12-10,791,雑費,有線,0,5000,-376894
12379,0001-20091210-69-1909-1-4279,1,2009-12-10,191,仮払消費税等,有線,0,250,-377144
12381,0001-20091210-69-1909-1-4279,3,2009-12-10,791,雑費,警備料,0,34286,-411430
12382,0001-20091210-69-1909-1-4279,4,2009-12-10,191,仮払消費税等,警備料,0,1714,-413144
12384,0001-20091210-82-1910-1-4281,0,2009-12-10,740,車両費,ガソリン代,0,16252,-429396
12385,0001-20091210-82-1910-1-4281,1,2009-12-10,191,仮払消費税等,ガソリン代,0,812,-430208
12535,0001-20091215-4-1936-1-4333,0,2009-12-15,732,広告宣伝費,広告費,0,30000,-460208
12536,0001-20091215-4-1936-1-4333,1,2009-12-15,191,仮払消費税等,広告費,0,1500,-461708
12608,0001-20091217-32-1957-1-4375,0,2009-12-17,754,事務用消耗品費,事務用品費,0,1359,-463067
12609,0001-20091217-32-1957-1-4375,1,2009-12-17,191,仮払消費税等,事務用品費,0,67,-463134
12667,0001-20091220-101-1981-1-4423,0,2009-12-20,732,広告宣伝費,広告料,0,50000,-513134
12668,0001-20091220-101-1981-1-4423,1,2009-12-20,191,仮払消費税等,広告料,0,2500,-515634
12711,0001-20091220-118-1989-1-4439,0,2009-12-20,754,事務用消耗品費,コピー代,0,7839,-523473
12712,0001-20091220-118-1989-1-4439,1,2009-12-20,191,仮払消費税等,コピー代,0,391,-523864
12715,0001-20091220-135-1990-1-4441,0,2009-12-20,754,事務用消耗品費,事務用品,0,4507,-528371
12716,0001-20091220-135-1990-1-4441,1,2009-12-20,191,仮払消費税等,事務用品,0,225,-528596
12737,0001-20091220-31-1971-1-4403,0,2009-12-20,754,事務用消耗品費,コピー代,0,3132,-531728
12738,0001-20091220-31-1971-1-4403,1,2009-12-20,191,仮払消費税等,コピー代,0,156,-531884
12745,0001-20091220-71-1973-1-4407,0,2009-12-20,754,事務用消耗品費,カウンター料金,0,34992,-566876
12746,0001-20091220-71-1973-1-4407,1,2009-12-20,191,仮払消費税等,カウンター料金,0,1749,-568625
12749,0001-20091220-73-1974-1-4409,0,2009-12-20,791,雑費,有線,0,4762,-573387
12750,0001-20091220-73-1974-1-4409,1,2009-12-20,191,仮払消費税等,有線,0,238,-573625
12761,0001-20091220-76-1976-1-4413,0,2009-12-20,754,事務用消耗品費,カウンター料金,0,6000,-579625
12762,0001-20091220-76-1976-1-4413,1,2009-12-20,191,仮払消費税等,カウンター料金,0,300,-579925
12765,0001-20091220-80-1977-1-4415,0,2009-12-20,724,福利厚生費,会費支払い,0,397500,-977425
12766,0001-20091220-80-1977-1-4415,1,2009-12-20,191,仮払消費税等,会費支払い,0,19875,-997300
12768,0001-20091220-80-1977-1-4415,3,2009-12-20,737,消耗品費,ファイル等,0,9320,-1006620
12769,0001-20091220-80-1977-1-4415,4,2009-12-20,191,仮払消費税等,ファイル等,0,465,-1007085
12771,0001-20091220-80-1977-1-4415,6,2009-12-20,737,消耗品費,飲料水,0,210161,-1217246
12772,0001-20091220-80-1977-1-4415,7,2009-12-20,191,仮払消費税等,飲料水,0,10508,-1227754
12773,0001-20091220-80-1977-1-4415,8,2009-12-20,737,消耗品費,名刺代,0,9420,-1237174
12774,0001-20091220-80-1977-1-4415,9,2009-12-20,191,仮払消費税等,名刺代,0,470,-1237644
12776,0001-20091220-97-1978-1-4417,0,2009-12-20,754,事務用消耗品費,コピー代,0,37359,-1275003
12777,0001-20091220-97-1978-1-4417,1,2009-12-20,191,仮払消費税等,コピー代,0,1867,-1276870
12780,0001-20091220-98-1979-1-4419,0,2009-12-20,754,事務用消耗品費,事務用品,0,9580,-1286450
12781,0001-20091220-98-1979-1-4419,1,2009-12-20,191,仮払消費税等,事務用品,0,478,-1286928
12813,0001-20091221-3-1994-1-4449,0,2009-12-21,724,福利厚生費,宿泊代,0,28691,-1315619
12814,0001-20091221-3-1994-1-4449,1,2009-12-21,191,仮払消費税等,宿泊代,0,1434,-1317053
12909,0001-20091222-95-2012-1-4485,0,2009-12-22,791,雑費,清掃料,0,68262,-1385315
12910,0001-20091222-95-2012-1-4485,1,2009-12-22,191,仮払消費税等,清掃料,0,3413,-1388728
12921,0001-20091223-28-2019-1-4499,0,2009-12-23,726,旅費交通費,タクシー代,0,2305,-1391033
12922,0001-20091223-28-2019-1-4499,1,2009-12-23,191,仮払消費税等,タクシー代,0,115,-1391148
12925,0001-20091223-64-2020-1-4501,0,2009-12-23,724,福利厚生費,お茶代,0,17810,-1408958
12926,0001-20091223-64-2020-1-4501,1,2009-12-23,191,仮払消費税等,お茶代,0,890,-1409848
12933,0001-20091224-120-2027-1-4515,0,2009-12-24,728,業務委託費,業務委託費,0,700000,-2109848
12934,0001-20091224-120-2027-1-4515,1,2009-12-24,191,仮払消費税等,業務委託費,0,35000,-2144848
12937,0001-20091224-146-2028-1-4517,0,2009-12-24,728,業務委託費,業務委託費,0,160000,-2304848
12938,0001-20091224-146-2028-1-4517,1,2009-12-24,191,仮払消費税等,業務委託費,0,8000,-2312848
12941,0001-20091224-154-2029-1-4519,0,2009-12-24,733,交際接待費,忘年会会費2名,0,11429,-2324277
12942,0001-20091224-154-2029-1-4519,1,2009-12-24,191,仮払消費税等,忘年会会費2名,0,571,-2324848
12944,0001-20091224-154-2029-1-4519,3,2009-12-24,733,交際接待費,飲食代　スナックみわ,0,30410,-2355258
12945,0001-20091224-154-2029-1-4519,4,2009-12-24,191,仮払消費税等,飲食代　スナックみわ,0,1520,-2356778
12947,0001-20091224-38-2023-1-4507,0,2009-12-24,724,福利厚生費,宿泊費,0,56166,-2412944
12948,0001-20091224-38-2023-1-4507,1,2009-12-24,191,仮払消費税等,宿泊費,0,2808,-2415752
12957,0001-20091224-78-2025-1-4511,0,2009-12-24,728,業務委託費,業務委託費支払い,0,180000,-2595752
12958,0001-20091224-78-2025-1-4511,1,2009-12-24,191,仮払消費税等,業務委託費支払い,0,9000,-2604752
12967,0001-20091225-111-2036-1-4533,0,2009-12-25,726,旅費交通費,タクシー代,0,14286,-2619038
12968,0001-20091225-111-2036-1-4533,1,2009-12-25,191,仮払消費税等,タクシー代,0,714,-2619752
13002,0001-20091225-139-2042-1-4545,0,2009-12-25,724,福利厚生費,社員夜食代,0,64805,-2684557
13003,0001-20091225-139-2042-1-4545,1,2009-12-25,191,仮払消費税等,社員夜食代,0,3240,-2687797
13010,0001-20091225-172-2044-1-4549,0,2009-12-25,728,業務委託費,業務委託費支払い,0,204762,-2892559
13011,0001-20091225-172-2044-1-4549,1,2009-12-25,191,仮払消費税等,業務委託費支払い,0,10238,-2902797
13020,0001-20091225-37-2031-1-4523,0,2009-12-25,728,業務委託費,業務委託費,0,1760953,-4663750
13021,0001-20091225-37-2031-1-4523,1,2009-12-25,191,仮払消費税等,業務委託費,0,88047,-4751797
13244,0001-20091226-81-2048-1-4557,0,2009-12-26,724,福利厚生費,お茶代,0,25277,-4777074
13245,0001-20091226-81-2048-1-4557,1,2009-12-26,191,仮払消費税等,お茶代,0,1263,-4778337
13277,0001-20091228-1-2057-1-4575,0,2009-12-28,731,運賃,運賃　佐川急便,0,554572,-5332909
13278,0001-20091228-1-2057-1-4575,1,2009-12-28,191,仮払消費税等,運賃　佐川急便,0,27728,-5360637
13285,0001-20091228-145-2068-1-4597,0,2009-12-28,731,運賃,運賃,0,309715,-5670352
13286,0001-20091228-145-2068-1-4597,1,2009-12-28,191,仮払消費税等,運賃,0,15485,-5685837
13297,0001-20091228-36-2060-1-4581,0,2009-12-28,731,運賃,運賃　ヤマト運輸,0,2737239,-8423076
13298,0001-20091228-36-2060-1-4581,1,2009-12-28,191,仮払消費税等,運賃　ヤマト運輸,0,136861,-8559937
13300,0001-20091228-36-2060-1-4581,3,2009-12-28,731,運賃,運賃　佐川急便,0,1669467,-10229404
13301,0001-20091228-36-2060-1-4581,4,2009-12-28,191,仮払消費税等,運賃　佐川急便,0,83473,-10312877
13303,0001-20091228-40-2061-1-4583,0,2009-12-28,732,広告宣伝費,広告掲載,0,47620,-10360497
13304,0001-20091228-40-2061-1-4583,1,2009-12-28,191,仮払消費税等,広告掲載,0,2380,-10362877
13320,0001-20091228-77-2064-1-4589,0,2009-12-28,731,運賃,運賃,0,334620,-10697497
13321,0001-20091228-77-2064-1-4589,1,2009-12-28,191,仮払消費税等,運賃,0,16730,-10714227
13330,0001-20091228-99-2066-1-4593,0,2009-12-28,731,運賃,運賃,0,1567343,-12281570
13331,0001-20091228-99-2066-1-4593,1,2009-12-28,191,仮払消費税等,運賃,0,78367,-12359937
13354,0001-20091230-109-2073-1-4607,0,2009-12-30,740,車両費,ガソリン代,0,58757,-12418694
13355,0001-20091230-109-2073-1-4607,1,2009-12-30,191,仮払消費税等,ガソリン代,0,2937,-12421631
13366,0001-20091230-137-2076-1-4613,0,2009-12-30,791,雑費,有線,0,6000,-12427631
13367,0001-20091230-137-2076-1-4613,1,2009-12-30,191,仮払消費税等,有線,0,300,-12427931
13369,0001-20091230-137-2076-1-4613,3,2009-12-30,791,雑費,警備料,0,42858,-12470789
13370,0001-20091230-137-2076-1-4613,4,2009-12-30,191,仮払消費税等,警備料,0,2142,-12472931
13376,0001-20091230-137-2076-1-4613,8,2009-12-30,791,雑費,清掃料,0,70000,-12542931
13377,0001-20091230-137-2076-1-4613,9,2009-12-30,191,仮払消費税等,清掃料,0,3500,-12546431
13400,0001-20091230-70-2070-1-4601,0,2009-12-30,791,雑費,有線,0,6000,-12552431
13401,0001-20091230-70-2070-1-4601,1,2009-12-30,191,仮払消費税等,有線,0,300,-12552731
13403,0001-20091230-70-2070-1-4601,3,2009-12-30,791,雑費,警備料,0,52381,-12605112
13404,0001-20091230-70-2070-1-4601,4,2009-12-30,191,仮払消費税等,警備料,0,2619,-12607731
13410,0001-20091230-70-2070-1-4601,8,2009-12-30,791,雑費,清掃料,0,70000,-12677731
13411,0001-20091230-70-2070-1-4601,9,2009-12-30,191,仮払消費税等,清掃料,0,3500,-12681231
13740,0001-20091231-94-2084-1-4629,1,2009-12-31,131,普通預金,11月分支払,7823245,0,-4857986
,,,2009-12,,※※月計※※,,7823245,12442678,
13752,0001-20100103-134-2116-1-4693,0,2010-01-03,754,事務用消耗品費,用紙,0,8000,-4865986
13753,0001-20100103-134-2116-1-4693,1,2010-01-03,191,仮払消費税等,用紙,0,400,-4866386
13905,0001-20100110-168-2160-1-4781,0,2010-01-10,791,雑費,有線,0,6000,-4872386
13906,0001-20100110-168-2160-1-4781,1,2010-01-10,191,仮払消費税等,有線,0,300,-4872686
13908,0001-20100110-168-2160-1-4781,3,2010-01-10,791,雑費,警備料,0,42858,-4915544
13909,0001-20100110-168-2160-1-4781,4,2010-01-10,191,仮払消費税等,警備料,0,2142,-4917686
13938,0001-20100110-67-2146-1-4753,0,2010-01-10,791,雑費,有線,0,5000,-4922686
13939,0001-20100110-67-2146-1-4753,1,2010-01-10,191,仮払消費税等,有線,0,250,-4922936
13941,0001-20100110-67-2146-1-4753,3,2010-01-10,791,雑費,警備料,0,34286,-4957222
13942,0001-20100110-67-2146-1-4753,4,2010-01-10,191,仮払消費税等,警備料,0,1714,-4958936
13984,0001-20100111-147-2168-1-4797,0,2010-01-11,740,車両費,ガソリン代,0,6265,-4965201
13985,0001-20100111-147-2168-1-4797,1,2010-01-11,191,仮払消費税等,ガソリン代,0,313,-4965514
14026,0001-20100111-76-2165-1-4791,0,2010-01-11,724,福利厚生費,社員食事代,0,27534,-4993048
14027,0001-20100111-76-2165-1-4791,1,2010-01-11,191,仮払消費税等,社員食事代,0,1376,-4994424
14119,0001-20100115-109-2193-1-4847,0,2010-01-15,740,車両費,ガソリン代,0,48000,-5042424
14120,0001-20100115-109-2193-1-4847,1,2010-01-15,191,仮払消費税等,ガソリン代,0,2400,-5044824
14136,0001-20100115-4-2181-1-4823,0,2010-01-15,732,広告宣伝費,広告費,0,30000,-5074824
14137,0001-20100115-4-2181-1-4823,1,2010-01-15,191,仮払消費税等,広告費,0,1500,-5076324
14257,0001-20100120-101-2226-1-4913,0,2010-01-20,732,広告宣伝費,広告料,0,50000,-5126324
14258,0001-20100120-101-2226-1-4913,1,2010-01-20,191,仮払消費税等,広告料,0,2500,-5128824
14293,0001-20100120-118-2233-1-4927,0,2010-01-20,754,事務用消耗品費,コピー代,0,7600,-5136424
14294,0001-20100120-118-2233-1-4927,1,2010-01-20,191,仮払消費税等,コピー代,0,380,-5136804
14297,0001-20100120-119-2234-1-4929,0,2010-01-20,754,事務用消耗品費,事務用品,0,3599,-5140403
14298,0001-20100120-119-2234-1-4929,1,2010-01-20,191,仮払消費税等,事務用品,0,179,-5140582
14341,0001-20100120-31-2213-1-4887,0,2010-01-20,754,事務用消耗品費,コピー代,0,3002,-5143584
14342,0001-20100120-31-2213-1-4887,1,2010-01-20,191,仮払消費税等,コピー代,0,150,-5143734
14369,0001-20100120-63-2217-1-4895,0,2010-01-20,724,福利厚生費,お茶代,0,9620,-5153354
14370,0001-20100120-63-2217-1-4895,1,2010-01-20,191,仮払消費税等,お茶代,0,480,-5153834
14381,0001-20100120-70-2219-1-4899,0,2010-01-20,791,雑費,有線,0,4762,-5158596
14382,0001-20100120-70-2219-1-4899,1,2010-01-20,191,仮払消費税等,有線,0,238,-5158834
14385,0001-20100120-71-2220-1-4901,0,2010-01-20,754,事務用消耗品費,事務用品,0,3509,-5162343
14386,0001-20100120-71-2220-1-4901,1,2010-01-20,191,仮払消費税等,事務用品,0,175,-5162518
14388,0001-20100120-71-2220-1-4901,3,2010-01-20,754,事務用消耗品費,カウンター料金,0,35137,-5197655
14389,0001-20100120-71-2220-1-4901,4,2010-01-20,191,仮払消費税等,カウンター料金,0,1756,-5199411
14391,0001-20100120-72-2221-1-4903,0,2010-01-20,754,事務用消耗品費,カウンター料金,0,6000,-5205411
14392,0001-20100120-72-2221-1-4903,1,2010-01-20,191,仮払消費税等,カウンター料金,0,300,-5205711
14395,0001-20100120-76-2222-1-4905,0,2010-01-20,737,消耗品費,ファイル等,0,10147,-5215858
14396,0001-20100120-76-2222-1-4905,1,2010-01-20,191,仮払消費税等,ファイル等,0,507,-5216365
14398,0001-20100120-76-2222-1-4905,3,2010-01-20,737,消耗品費,飲料水,0,222011,-5438376
14399,0001-20100120-76-2222-1-4905,4,2010-01-20,191,仮払消費税等,飲料水,0,11100,-5449476
14400,0001-20100120-76-2222-1-4905,5,2010-01-20,737,消耗品費,名刺代,0,43810,-5493286
14401,0001-20100120-76-2222-1-4905,6,2010-01-20,191,仮払消費税等,名刺代,0,2190,-5495476
14413,0001-20100120-97-2224-1-4909,0,2010-01-20,754,事務用消耗品費,コピー代,0,37988,-5533464
14414,0001-20100120-97-2224-1-4909,1,2010-01-20,191,仮払消費税等,コピー代,0,1899,-5535363
14417,0001-20100120-98-2225-1-4911,0,2010-01-20,754,事務用消耗品費,事務用品,0,6727,-5542090
14418,0001-20100120-98-2225-1-4911,1,2010-01-20,191,仮払消費税等,事務用品,0,336,-5542426
14443,0001-20100121-82-2242-1-4945,0,2010-01-21,740,車両費,ガソリン代,0,20309,-5562735
14444,0001-20100121-82-2242-1-4945,1,2010-01-21,191,仮払消費税等,ガソリン代,0,1015,-5563750
14469,0001-20100122-3-2246-1-4953,0,2010-01-22,724,福利厚生費,宿泊代,0,24239,-5587989
14470,0001-20100122-3-2246-1-4953,1,2010-01-22,191,仮払消費税等,宿泊代,0,1211,-5589200
14477,0001-20100122-95-2248-1-4957,0,2010-01-22,791,雑費,清掃料,0,68262,-5657462
14478,0001-20100122-95-2248-1-4957,1,2010-01-22,191,仮払消費税等,清掃料,0,3413,-5660875
14493,0001-20100123-28-2253-1-4967,0,2010-01-23,726,旅費交通費,タクシー代,0,2305,-5663180
14494,0001-20100123-28-2253-1-4967,1,2010-01-23,191,仮払消費税等,タクシー代,0,115,-5663295
14513,0001-20100124-120-2259-1-4979,0,2010-01-24,728,業務委託費,業務委託費,0,620000,-6283295
14514,0001-20100124-120-2259-1-4979,1,2010-01-24,191,仮払消費税等,業務委託費,0,31000,-6314295
14517,0001-20100124-137-2260-1-4981,0,2010-01-24,791,雑費,有線,0,6000,-6320295
14518,0001-20100124-137-2260-1-4981,1,2010-01-24,191,仮払消費税等,有線,0,300,-6320595
14520,0001-20100124-137-2260-1-4981,3,2010-01-24,791,雑費,警備料,0,42858,-6363453
14521,0001-20100124-137-2260-1-4981,4,2010-01-24,191,仮払消費税等,警備料,0,2142,-6365595
14527,0001-20100124-137-2260-1-4981,8,2010-01-24,791,雑費,清掃料,0,62420,-6428015
14528,0001-20100124-137-2260-1-4981,9,2010-01-24,191,仮払消費税等,清掃料,0,3120,-6431135
14534,0001-20100124-146-2261-1-4983,0,2010-01-24,728,業務委託費,業務委託費,0,160000,-6591135
14535,0001-20100124-146-2261-1-4983,1,2010-01-24,191,仮払消費税等,業務委託費,0,8000,-6599135
14561,0001-20100125-111-2270-1-5001,0,2010-01-25,726,旅費交通費,タクシー代,0,12924,-6612059
14562,0001-20100125-111-2270-1-5001,1,2010-01-25,191,仮払消費税等,タクシー代,0,646,-6612705
14583,0001-20100125-172-2273-1-5007,0,2010-01-25,728,業務委託費,業務委託費支払い,0,137143,-6749848
14584,0001-20100125-172-2273-1-5007,1,2010-01-25,191,仮払消費税等,業務委託費支払い,0,6857,-6756705
14735,0001-20100126-37-2275-1-5011,0,2010-01-26,728,業務委託費,業務委託費,0,1293239,-8049944
14736,0001-20100126-37-2275-1-5011,1,2010-01-26,191,仮払消費税等,業務委託費,0,64661,-8114605
14743,0001-20100126-78-2277-1-5015,0,2010-01-26,728,業務委託費,業務委託費支払い,0,180000,-8294605
14744,0001-20100126-78-2277-1-5015,1,2010-01-26,191,仮払消費税等,業務委託費支払い,0,9000,-8303605
14770,0001-20100127-38-2283-1-5027,0,2010-01-27,724,福利厚生費,宿泊費,0,45871,-8349476
14771,0001-20100127-38-2283-1-5027,1,2010-01-27,191,仮払消費税等,宿泊費,0,2293,-8351769
14794,0001-20100128-81-2290-1-5041,0,2010-01-28,724,福利厚生費,お茶代,0,19239,-8371008
14795,0001-20100128-81-2290-1-5041,1,2010-01-28,191,仮払消費税等,お茶代,0,961,-8371969
14802,0001-20100129-32-2292-1-5045,0,2010-01-29,754,事務用消耗品費,事務用品費,0,2448,-8374417
14803,0001-20100129-32-2292-1-5045,1,2010-01-29,191,仮払消費税等,事務用品費,0,122,-8374539
14837,0001-20100130-154-2303-1-5067,0,2010-01-30,733,交際接待費,お花代,0,10000,-8384539
14838,0001-20100130-154-2303-1-5067,1,2010-01-30,191,仮払消費税等,お花代,0,500,-8385039
14840,0001-20100130-154-2303-1-5067,3,2010-01-30,733,交際接待費,香典代,0,10000,-8395039
14842,0001-20100130-49-2293-1-5047,0,2010-01-30,740,車両費,ガソリン代,0,155686,-8550725
14843,0001-20100130-49-2293-1-5047,1,2010-01-30,191,仮払消費税等,ガソリン代,0,7784,-8558509
14859,0001-20100130-70-2295-1-5051,0,2010-01-30,791,雑費,有線,0,6000,-8564509
14860,0001-20100130-70-2295-1-5051,1,2010-01-30,191,仮払消費税等,有線,0,300,-8564809
14862,0001-20100130-70-2295-1-5051,3,2010-01-30,791,雑費,警備料,0,52381,-8617190
14863,0001-20100130-70-2295-1-5051,4,2010-01-30,191,仮払消費税等,警備料,0,2619,-8619809
14869,0001-20100130-70-2295-1-5051,8,2010-01-30,791,雑費,清掃料,0,70000,-8689809
14870,0001-20100130-70-2295-1-5051,9,2010-01-30,191,仮払消費税等,清掃料,0,3500,-8693309
14887,0001-20100131-1-2304-1-5069,0,2010-01-31,731,運賃,運賃　佐川急便,0,507191,-9200500
14888,0001-20100131-1-2304-1-5069,1,2010-01-31,191,仮払消費税等,運賃　佐川急便,0,25359,-9225859
15155,0001-20100131-137-2342-1-5145,1,2010-01-31,131,普通預金,12月分支払,12442678,0,3216819
15193,0001-20100131-145-2347-1-5155,3,2010-01-31,731,運賃,運賃,0,161505,3055314
15194,0001-20100131-145-2347-1-5155,4,2010-01-31,191,仮払消費税等,運賃,0,8075,3047239
15214,0001-20100131-36-2306-1-5073,0,2010-01-31,731,運賃,運賃　ヤマト運輸,0,2709067,338172
15215,0001-20100131-36-2306-1-5073,1,2010-01-31,191,仮払消費税等,運賃　ヤマト運輸,0,135453,202719
15217,0001-20100131-36-2306-1-5073,3,2010-01-31,731,運賃,運賃　佐川急便,0,1203372,-1000653
15218,0001-20100131-36-2306-1-5073,4,2010-01-31,191,仮払消費税等,運賃　佐川急便,0,60168,-1060821
15220,0001-20100131-40-2307-1-5075,0,2010-01-31,732,広告宣伝費,広告掲載,0,47620,-1108441
15221,0001-20100131-40-2307-1-5075,1,2010-01-31,191,仮払消費税等,広告掲載,0,2380,-1110821
15261,0001-20100131-77-2314-1-5089,0,2010-01-31,731,運賃,運賃,0,209210,-1320031
15262,0001-20100131-77-2314-1-5089,1,2010-01-31,191,仮払消費税等,運賃,0,10460,-1330491
15265,0001-20100131-99-2315-1-5091,0,2010-01-31,731,運賃,運賃,0,1358486,-2688977
15266,0001-20100131-99-2315-1-5091,1,2010-01-31,191,仮払消費税等,運賃,0,67924,-2756901
,,,2010-01,,※※月計※※,,12442678,10341593,
15291,0001-20100203-134-2357-1-5175,0,2010-02-03,754,事務用消耗品費,用紙,0,10000,-2766901
15292,0001-20100203-134-2357-1-5175,1,2010-02-03,191,仮払消費税等,用紙,0,500,-2767401
15298,0001-20100204-147-2359-1-5179,0,2010-02-04,740,車両費,ガソリン代,0,6375,-2773776
15299,0001-20100204-147-2359-1-5179,1,2010-02-04,191,仮払消費税等,ガソリン代,0,318,-2774094
15328,0001-20100205-76-2361-1-5183,0,2010-02-05,724,福利厚生費,社員食事代,0,14865,-2788959
15329,0001-20100205-76-2361-1-5183,1,2010-02-05,191,仮払消費税等,社員食事代,0,743,-2789702
15414,0001-20100210-168-2393-1-5247,0,2010-02-10,791,雑費,有線,0,6000,-2795702
15415,0001-20100210-168-2393-1-5247,1,2010-02-10,191,仮払消費税等,有線,0,300,-2796002
15417,0001-20100210-168-2393-1-5247,3,2010-02-10,791,雑費,警備料,0,42858,-2838860
15418,0001-20100210-168-2393-1-5247,4,2010-02-10,191,仮払消費税等,警備料,0,2142,-2841002
15435,0001-20100210-65-2382-1-5225,0,2010-02-10,791,雑費,有線,0,5000,-2846002
15436,0001-20100210-65-2382-1-5225,1,2010-02-10,191,仮払消費税等,有線,0,250,-2846252
15438,0001-20100210-65-2382-1-5225,3,2010-02-10,791,雑費,警備料,0,34286,-2880538
15439,0001-20100210-65-2382-1-5225,4,2010-02-10,191,仮払消費税等,警備料,0,1714,-2882252
15575,0001-20100213-82-2411-1-5283,0,2010-02-13,740,車両費,ガソリン代,0,30028,-2912280
15576,0001-20100213-82-2411-1-5283,1,2010-02-13,191,仮払消費税等,ガソリン代,0,1501,-2913781
15626,0001-20100215-4-2415-1-5291,0,2010-02-15,732,広告宣伝費,広告費,0,30000,-2943781
15627,0001-20100215-4-2415-1-5291,1,2010-02-15,191,仮払消費税等,広告費,0,1500,-2945281
15697,0001-20100216-154-2435-1-5331,0,2010-02-16,733,交際接待費,手土産代　大塚物産,0,6229,-2951510
15698,0001-20100216-154-2435-1-5331,1,2010-02-16,191,仮払消費税等,手土産代　大塚物産,0,311,-2951821
15700,0001-20100216-154-2435-1-5331,3,2010-02-16,733,交際接待費,飲食代　スナック帰り道4名,0,18839,-2970660
15701,0001-20100216-154-2435-1-5331,4,2010-02-16,191,仮払消費税等,飲食代　スナック帰り道4名,0,941,-2971601
15767,0001-20100220-101-2458-1-5377,0,2010-02-20,732,広告宣伝費,広告料,0,50000,-3021601
15768,0001-20100220-101-2458-1-5377,1,2010-02-20,191,仮払消費税等,広告料,0,2500,-3024101
15802,0001-20100220-118-2464-1-5389,0,2010-02-20,754,事務用消耗品費,コピー代,0,7631,-3031732
15803,0001-20100220-118-2464-1-5389,1,2010-02-20,191,仮払消費税等,コピー代,0,381,-3032113
15814,0001-20100220-135-2466-1-5393,0,2010-02-20,754,事務用消耗品費,事務用品,0,2276,-3034389
15815,0001-20100220-135-2466-1-5393,1,2010-02-20,191,仮払消費税等,事務用品,0,113,-3034502
15839,0001-20100220-31-2445-1-5351,0,2010-02-20,754,事務用消耗品費,コピー代,0,2970,-3037472
15840,0001-20100220-31-2445-1-5351,1,2010-02-20,191,仮払消費税等,コピー代,0,148,-3037620
15851,0001-20100220-38-2447-1-5355,0,2010-02-20,724,福利厚生費,宿泊費,0,45871,-3083491
15852,0001-20100220-38-2447-1-5355,1,2010-02-20,191,仮払消費税等,宿泊費,0,2293,-3085784
15875,0001-20100220-66-2451-1-5363,0,2010-02-20,791,雑費,有線,0,4762,-3090546
15876,0001-20100220-66-2451-1-5363,1,2010-02-20,191,仮払消費税等,有線,0,238,-3090784
15879,0001-20100220-68-2452-1-5365,0,2010-02-20,754,事務用消耗品費,カウンター料金,0,6000,-3096784
15880,0001-20100220-68-2452-1-5365,1,2010-02-20,191,仮払消費税等,カウンター料金,0,300,-3097084
15883,0001-20100220-71-2453-1-5367,0,2010-02-20,754,事務用消耗品費,事務用品,0,1505,-3098589
15884,0001-20100220-71-2453-1-5367,1,2010-02-20,191,仮払消費税等,事務用品,0,75,-3098664
15886,0001-20100220-71-2453-1-5367,3,2010-02-20,754,事務用消耗品費,カウンター料金,0,34099,-3132763
15887,0001-20100220-71-2453-1-5367,4,2010-02-20,191,仮払消費税等,カウンター料金,0,1704,-3134467
15889,0001-20100220-74-2454-1-5369,0,2010-02-20,737,消耗品費,ファイル等,0,19396,-3153863
15890,0001-20100220-74-2454-1-5369,1,2010-02-20,191,仮払消費税等,ファイル等,0,969,-3154832
15892,0001-20100220-74-2454-1-5369,3,2010-02-20,737,消耗品費,飲料水,0,232915,-3387747
15893,0001-20100220-74-2454-1-5369,4,2010-02-20,191,仮払消費税等,飲料水,0,11645,-3399392
15894,0001-20100220-74-2454-1-5369,5,2010-02-20,737,消耗品費,名刺代,0,52096,-3451488
15895,0001-20100220-74-2454-1-5369,6,2010-02-20,191,仮払消費税等,名刺代,0,2604,-3454092
15907,0001-20100220-97-2456-1-5373,0,2010-02-20,754,事務用消耗品費,コピー代,0,38118,-3492210
15908,0001-20100220-97-2456-1-5373,1,2010-02-20,191,仮払消費税等,コピー代,0,1905,-3494115
15911,0001-20100220-98-2457-1-5375,0,2010-02-20,754,事務用消耗品費,事務用品,0,3006,-3497121
15912,0001-20100220-98-2457-1-5375,1,2010-02-20,191,仮払消費税等,事務用品,0,150,-3497271
15915,0001-20100221-137-2476-1-5413,0,2010-02-21,791,雑費,有線,0,6000,-3503271
15916,0001-20100221-137-2476-1-5413,1,2010-02-21,191,仮払消費税等,有線,0,300,-3503571
15918,0001-20100221-137-2476-1-5413,3,2010-02-21,791,雑費,警備料,0,42858,-3546429
15919,0001-20100221-137-2476-1-5413,4,2010-02-21,191,仮払消費税等,警備料,0,2142,-3548571
15925,0001-20100221-137-2476-1-5413,8,2010-02-21,791,雑費,清掃料,0,53735,-3602306
15926,0001-20100221-137-2476-1-5413,9,2010-02-21,191,仮払消費税等,清掃料,0,2686,-3604992
15949,0001-20100221-80-2475-1-5411,0,2010-02-21,724,福利厚生費,会費支払い,0,397500,-4002492
15950,0001-20100221-80-2475-1-5411,1,2010-02-21,191,仮払消費税等,会費支払い,0,19875,-4022367
15971,0001-20100222-95-2479-1-5419,0,2010-02-22,791,雑費,清掃料,0,68262,-4090629
15972,0001-20100222-95-2479-1-5419,1,2010-02-22,191,仮払消費税等,清掃料,0,3413,-4094042
15987,0001-20100223-28-2485-1-5431,0,2010-02-23,726,旅費交通費,タクシー代,0,2305,-4096347
15988,0001-20100223-28-2485-1-5431,1,2010-02-23,191,仮払消費税等,タクシー代,0,115,-4096462
15991,0001-20100223-3-2482-1-5425,0,2010-02-23,724,福利厚生費,宿泊代,0,27443,-4123905
15992,0001-20100223-3-2482-1-5425,1,2010-02-23,191,仮払消費税等,宿泊代,0,1372,-4125277
16001,0001-20100223-61-2487-1-5435,0,2010-02-23,724,福利厚生費,お茶代,0,10553,-4135830
16002,0001-20100223-61-2487-1-5435,1,2010-02-23,191,仮払消費税等,お茶代,0,527,-4136357
16129,0001-20100224-120-2496-1-5453,0,2010-02-24,728,業務委託費,業務委託費,0,300000,-4436357
16130,0001-20100224-120-2496-1-5453,1,2010-02-24,191,仮払消費税等,業務委託費,0,15000,-4451357
16139,0001-20100224-172-2498-1-5457,0,2010-02-24,728,業務委託費,業務委託費支払い,0,116191,-4567548
16140,0001-20100224-172-2498-1-5457,1,2010-02-24,191,仮払消費税等,業務委託費支払い,0,5809,-4573357
16147,0001-20100224-78-2492-1-5445,0,2010-02-24,728,業務委託費,業務委託費支払い,0,180000,-4753357
16148,0001-20100224-78-2492-1-5445,1,2010-02-24,191,仮払消費税等,業務委託費支払い,0,9000,-4762357
16188,0001-20100225-111-2507-1-5475,0,2010-02-25,726,旅費交通費,タクシー代,0,14048,-4776405
16189,0001-20100225-111-2507-1-5475,1,2010-02-25,191,仮払消費税等,タクシー代,0,702,-4777107
16204,0001-20100225-37-2501-1-5463,0,2010-02-25,728,業務委託費,業務委託費,0,718191,-5495298
16205,0001-20100225-37-2501-1-5463,1,2010-02-25,191,仮払消費税等,業務委託費,0,35909,-5531207
16212,0001-20100226-109-2514-1-5489,0,2010-02-26,740,車両費,ガソリン代,0,44274,-5575481
16213,0001-20100226-109-2514-1-5489,1,2010-02-26,191,仮払消費税等,ガソリン代,0,2213,-5577694
16233,0001-20100226-146-2518-1-5497,0,2010-02-26,728,業務委託費,業務委託費,0,160000,-5737694
16234,0001-20100226-146-2518-1-5497,1,2010-02-26,191,仮払消費税等,業務委託費,0,8000,-5745694
16294,0001-20100228-1-2531-1-5523,0,2010-02-28,731,運賃,運賃　佐川急便,0,123648,-5869342
16295,0001-20100228-1-2531-1-5523,1,2010-02-28,191,仮払消費税等,運賃　佐川急便,0,6182,-5875524
16577,0001-20100228-136-2573-1-5607,1,2010-02-28,131,普通預金,1月分支払,10341593,0,4466069
16628,0001-20100228-145-2578-1-5617,0,2010-02-28,731,運賃,運賃,0,160143,4305926
16629,0001-20100228-145-2578-1-5617,1,2010-02-28,191,仮払消費税等,運賃,0,8007,4297919
16644,0001-20100228-36-2533-1-5527,0,2010-02-28,731,運賃,運賃　ヤマト運輸,0,1568981,2728938
16645,0001-20100228-36-2533-1-5527,1,2010-02-28,191,仮払消費税等,運賃　ヤマト運輸,0,78449,2650489
16647,0001-20100228-36-2533-1-5527,3,2010-02-28,731,運賃,運賃　佐川急便,0,733172,1917317
16648,0001-20100228-36-2533-1-5527,4,2010-02-28,191,仮払消費税等,運賃　佐川急便,0,36658,1880659
16650,0001-20100228-40-2534-1-5529,0,2010-02-28,732,広告宣伝費,広告掲載,0,47620,1833039
16651,0001-20100228-40-2534-1-5529,1,2010-02-28,191,仮払消費税等,広告掲載,0,2380,1830659
16654,0001-20100228-49-2535-1-5531,0,2010-02-28,740,車両費,ガソリン代,0,155686,1674973
16655,0001-20100228-49-2535-1-5531,1,2010-02-28,191,仮払消費税等,ガソリン代,0,7784,1667189
16691,0001-20100228-70-2538-1-5537,0,2010-02-28,791,雑費,有線,0,6000,1661189
16692,0001-20100228-70-2538-1-5537,1,2010-02-28,191,仮払消費税等,有線,0,300,1660889
16694,0001-20100228-70-2538-1-5537,3,2010-02-28,791,雑費,警備料,0,52381,1608508
16695,0001-20100228-70-2538-1-5537,4,2010-02-28,191,仮払消費税等,警備料,0,2619,1605889
16701,0001-20100228-70-2538-1-5537,8,2010-02-28,791,雑費,清掃料,0,70000,1535889
16702,0001-20100228-70-2538-1-5537,9,2010-02-28,191,仮払消費税等,清掃料,0,3500,1532389
16715,0001-20100228-77-2541-1-5543,0,2010-02-28,731,運賃,運賃,0,134877,1397512
16716,0001-20100228-77-2541-1-5543,1,2010-02-28,191,仮払消費税等,運賃,0,6743,1390769
16726,0001-20100228-81-2527-1-5515,0,2010-02-28,724,福利厚生費,お茶代,0,18953,1371816
16727,0001-20100228-81-2527-1-5515,1,2010-02-28,191,仮払消費税等,お茶代,0,947,1370869
16730,0001-20100228-93-2543-1-5547,0,2010-02-28,753,修繕維持費,修繕費,0,17000,1353869
16731,0001-20100228-93-2543-1-5547,1,2010-02-28,191,仮払消費税等,修繕費,0,850,1353019
16740,0001-20100228-99-2545-1-5551,0,2010-02-28,731,運賃,運賃,0,760600,592419
16741,0001-20100228-99-2545-1-5551,1,2010-02-28,191,仮払消費税等,運賃,0,38030,554389
,,,2010-02,,※※月計※※,,10341593,7030303,
16752,0001-20100303-134-2585-1-5631,0,2010-03-03,754,事務用消耗品費,用紙,0,30000,524389
16753,0001-20100303-134-2585-1-5631,1,2010-03-03,191,仮払消費税等,用紙,0,1500,522889
16827,0001-20100306-147-2597-1-5655,0,2010-03-06,740,車両費,ガソリン代,0,6033,516856
16828,0001-20100306-147-2597-1-5655,1,2010-03-06,191,仮払消費税等,ガソリン代,0,301,516555
16917,0001-20100310-168-2629-1-5719,0,2010-03-10,791,雑費,有線,0,6000,510555
16918,0001-20100310-168-2629-1-5719,1,2010-03-10,191,仮払消費税等,有線,0,300,510255
16920,0001-20100310-168-2629-1-5719,3,2010-03-10,791,雑費,警備料,0,42858,467397
16921,0001-20100310-168-2629-1-5719,4,2010-03-10,191,仮払消費税等,警備料,0,2142,465255
16960,0001-20100310-65-2614-1-5689,0,2010-03-10,791,雑費,有線,0,5000,460255
16961,0001-20100310-65-2614-1-5689,1,2010-03-10,191,仮払消費税等,有線,0,250,460005
16963,0001-20100310-65-2614-1-5689,3,2010-03-10,791,雑費,警備料,0,34286,425719
16964,0001-20100310-65-2614-1-5689,4,2010-03-10,191,仮払消費税等,警備料,0,1714,424005
16966,0001-20100310-76-2615-1-5691,0,2010-03-10,724,福利厚生費,社員夜食代,0,71867,352138
16967,0001-20100310-76-2615-1-5691,1,2010-03-10,191,仮払消費税等,社員夜食代,0,3593,348545
17080,0001-20100314-82-2642-1-5745,0,2010-03-14,740,車両費,ガソリン代,0,29910,318635
17081,0001-20100314-82-2642-1-5745,1,2010-03-14,191,仮払消費税等,ガソリン代,0,1495,317140
17089,0001-20100315-4-2643-1-5747,0,2010-03-15,732,広告宣伝費,広告費,0,30000,287140
17090,0001-20100315-4-2643-1-5747,1,2010-03-15,191,仮払消費税等,広告費,0,1500,285640
17233,0001-20100320-101-2682-1-5825,0,2010-03-20,732,広告宣伝費,広告料,0,50000,235640
17234,0001-20100320-101-2682-1-5825,1,2010-03-20,191,仮払消費税等,広告料,0,2500,233140
17267,0001-20100320-109-2687-1-5835,0,2010-03-20,740,車両費,ガソリン代,0,75226,157914
17268,0001-20100320-109-2687-1-5835,1,2010-03-20,191,仮払消費税等,ガソリン代,0,3761,154153
17271,0001-20100320-118-2688-1-5837,0,2010-03-20,754,事務用消耗品費,コピー代,0,8095,146058
17272,0001-20100320-118-2688-1-5837,1,2010-03-20,191,仮払消費税等,コピー代,0,404,145654
17275,0001-20100320-135-2689-1-5839,0,2010-03-20,754,事務用消耗品費,事務用品,0,2584,143070
17276,0001-20100320-135-2689-1-5839,1,2010-03-20,191,仮払消費税等,事務用品,0,129,142941
17312,0001-20100320-31-2670-1-5801,0,2010-03-20,754,事務用消耗品費,コピー代,0,3338,139603
17313,0001-20100320-31-2670-1-5801,1,2010-03-20,191,仮払消費税等,コピー代,0,166,139437
17332,0001-20100320-67-2674-1-5809,0,2010-03-20,791,雑費,有線,0,4762,134675
17333,0001-20100320-67-2674-1-5809,1,2010-03-20,191,仮払消費税等,有線,0,238,134437
17336,0001-20100320-69-2675-1-5811,0,2010-03-20,754,事務用消耗品費,カウンター料金,0,6000,128437
17337,0001-20100320-69-2675-1-5811,1,2010-03-20,191,仮払消費税等,カウンター料金,0,300,128137
17340,0001-20100320-71-2676-1-5813,0,2010-03-20,754,事務用消耗品費,事務用品,0,3453,124684
17341,0001-20100320-71-2676-1-5813,1,2010-03-20,191,仮払消費税等,事務用品,0,172,124512
17343,0001-20100320-71-2676-1-5813,3,2010-03-20,754,事務用消耗品費,カウンター料金,0,38103,86409
17344,0001-20100320-71-2676-1-5813,4,2010-03-20,191,仮払消費税等,カウンター料金,0,1905,84504
17346,0001-20100320-73-2677-1-5815,0,2010-03-20,737,消耗品費,ファイル等,0,39271,45233
17347,0001-20100320-73-2677-1-5815,1,2010-03-20,191,仮払消費税等,ファイル等,0,1963,43270
17349,0001-20100320-73-2677-1-5815,3,2010-03-20,737,消耗品費,飲料水,0,243810,-200540
17350,0001-20100320-73-2677-1-5815,4,2010-03-20,191,仮払消費税等,飲料水,0,12190,-212730
17351,0001-20100320-73-2677-1-5815,5,2010-03-20,737,消耗品費,名刺代,0,64762,-277492
17352,0001-20100320-73-2677-1-5815,6,2010-03-20,191,仮払消費税等,名刺代,0,3238,-280730
17358,0001-20100320-97-2679-1-5819,0,2010-03-20,754,事務用消耗品費,コピー代,0,39165,-319895
17359,0001-20100320-97-2679-1-5819,1,2010-03-20,191,仮払消費税等,コピー代,0,1958,-321853
17362,0001-20100320-98-2680-1-5821,0,2010-03-20,754,事務用消耗品費,事務用品,0,6167,-328020
17363,0001-20100320-98-2680-1-5821,1,2010-03-20,191,仮払消費税等,事務用品,0,308,-328328
17437,0001-20100322-3-2705-1-5871,0,2010-03-22,724,福利厚生費,宿泊代,0,30653,-358981
17438,0001-20100322-3-2705-1-5871,1,2010-03-22,191,仮払消費税等,宿泊代,0,1532,-360513
17451,0001-20100322-95-2709-1-5879,0,2010-03-22,791,雑費,清掃料,0,68262,-428775
17452,0001-20100322-95-2709-1-5879,1,2010-03-22,191,仮払消費税等,清掃料,0,3413,-432188
17465,0001-20100323-28-2714-1-5889,0,2010-03-23,726,旅費交通費,タクシー代,0,2305,-434493
17466,0001-20100323-28-2714-1-5889,1,2010-03-23,191,仮払消費税等,タクシー代,0,115,-434608
17598,0001-20100324-146-2724-1-5909,0,2010-03-24,728,業務委託費,業務委託費,0,160000,-594608
17599,0001-20100324-146-2724-1-5909,1,2010-03-24,191,仮払消費税等,業務委託費,0,8000,-602608
17602,0001-20100324-154-2725-1-5911,0,2010-03-24,733,交際接待費,お花代　結婚式,0,12000,-614608
17603,0001-20100324-154-2725-1-5911,1,2010-03-24,191,仮払消費税等,お花代　結婚式,0,600,-615208
17605,0001-20100324-154-2725-1-5911,3,2010-03-24,733,交際接待費,結婚式会費,0,10000,-625208
17607,0001-20100324-172-2726-1-5913,0,2010-03-24,728,業務委託費,業務委託費支払い,0,180000,-805208
17608,0001-20100324-172-2726-1-5913,1,2010-03-24,191,仮払消費税等,業務委託費支払い,0,9000,-814208
17621,0001-20100324-60-2721-1-5903,0,2010-03-24,724,福利厚生費,お茶代,0,19524,-833732
17622,0001-20100324-60-2721-1-5903,1,2010-03-24,191,仮払消費税等,お茶代,0,976,-834708
17625,0001-20100324-81-2722-1-5905,0,2010-03-24,724,福利厚生費,お茶代,0,43620,-878328
17626,0001-20100324-81-2722-1-5905,1,2010-03-24,191,仮払消費税等,お茶代,0,2180,-880508
17656,0001-20100325-111-2732-1-5925,0,2010-03-25,726,旅費交通費,タクシー代,0,16086,-896594
17657,0001-20100325-111-2732-1-5925,1,2010-03-25,191,仮払消費税等,タクシー代,0,804,-897398
17660,0001-20100325-120-2733-1-5927,0,2010-03-25,728,業務委託費,業務委託費,0,900000,-1797398
17661,0001-20100325-120-2733-1-5927,1,2010-03-25,191,仮払消費税等,業務委託費,0,45000,-1842398
17692,0001-20100325-78-2727-1-5915,0,2010-03-25,728,業務委託費,業務委託費支払い,0,180000,-2022398
17693,0001-20100325-78-2727-1-5915,1,2010-03-25,191,仮払消費税等,業務委託費支払い,0,9000,-2031398
17708,0001-20100326-139-2747-1-5955,0,2010-03-26,724,福利厚生費,社員夜食代,0,61951,-2093349
17709,0001-20100326-139-2747-1-5955,1,2010-03-26,191,仮払消費税等,社員夜食代,0,3097,-2096446
17722,0001-20100326-37-2739-1-5939,0,2010-03-26,728,業務委託費,業務委託費,0,1459048,-3555494
17723,0001-20100326-37-2739-1-5939,1,2010-03-26,191,仮払消費税等,業務委託費,0,72952,-3628446
17726,0001-20100326-38-2740-1-5941,0,2010-03-26,724,福利厚生費,宿泊費,0,45871,-3674317
17727,0001-20100326-38-2740-1-5941,1,2010-03-26,191,仮払消費税等,宿泊費,0,2293,-3676610
17765,0001-20100327-32-2751-1-5963,0,2010-03-27,754,事務用消耗品費,事務用品費,0,2951,-3679561
17766,0001-20100327-32-2751-1-5963,1,2010-03-27,191,仮払消費税等,事務用品費,0,147,-3679708
17787,0001-20100328-137-2759-1-5979,0,2010-03-28,791,雑費,有線,0,6000,-3685708
17788,0001-20100328-137-2759-1-5979,1,2010-03-28,191,仮払消費税等,有線,0,300,-3686008
17790,0001-20100328-137-2759-1-5979,3,2010-03-28,791,雑費,警備料,0,42858,-3728866
17791,0001-20100328-137-2759-1-5979,4,2010-03-28,191,仮払消費税等,警備料,0,2142,-3731008
17797,0001-20100328-137-2759-1-5979,8,2010-03-28,791,雑費,清掃料,0,55334,-3786342
17798,0001-20100328-137-2759-1-5979,9,2010-03-28,191,仮払消費税等,清掃料,0,2766,-3789108
17849,0001-20100331-1-2766-1-5993,0,2010-03-31,731,運賃,運賃　佐川急便,0,232581,-4021689
17850,0001-20100331-1-2766-1-5993,1,2010-03-31,191,仮払消費税等,運賃　佐川急便,0,11629,-4033318
18122,0001-20100331-135-2811-1-6083,1,2010-03-31,131,普通預金,2月分支払,7030303,0,2996985
18164,0001-20100331-145-2816-1-6093,0,2010-03-31,731,運賃,運賃,0,605334,2391651
18165,0001-20100331-145-2816-1-6093,1,2010-03-31,191,仮払消費税等,運賃,0,30266,2361385
18218,0001-20100331-36-2770-1-6001,0,2010-03-31,731,運賃,運賃　ヤマト運輸,0,1376962,984423
18219,0001-20100331-36-2770-1-6001,1,2010-03-31,191,仮払消費税等,運賃　ヤマト運輸,0,68848,915575
18221,0001-20100331-36-2770-1-6001,3,2010-03-31,731,運賃,運賃　佐川急便,0,792839,122736
18222,0001-20100331-36-2770-1-6001,4,2010-03-31,191,仮払消費税等,運賃　佐川急便,0,39641,83095
18224,0001-20100331-40-2771-1-6003,0,2010-03-31,732,広告宣伝費,広告掲載,0,47620,35475
18225,0001-20100331-40-2771-1-6003,1,2010-03-31,191,仮払消費税等,広告掲載,0,2380,33095
18228,0001-20100331-49-2772-1-6005,0,2010-03-31,740,車両費,ガソリン代,0,155686,-122591
18229,0001-20100331-49-2772-1-6005,1,2010-03-31,191,仮払消費税等,ガソリン代,0,7784,-130375
18274,0001-20100331-70-2778-1-6017,0,2010-03-31,791,雑費,有線,0,6000,-136375
18275,0001-20100331-70-2778-1-6017,1,2010-03-31,191,仮払消費税等,有線,0,300,-136675
18277,0001-20100331-70-2778-1-6017,3,2010-03-31,791,雑費,警備料,0,52381,-189056
18278,0001-20100331-70-2778-1-6017,4,2010-03-31,191,仮払消費税等,警備料,0,2619,-191675
18284,0001-20100331-70-2778-1-6017,8,2010-03-31,791,雑費,清掃料,0,70000,-261675
18285,0001-20100331-70-2778-1-6017,9,2010-03-31,191,仮払消費税等,清掃料,0,3500,-265175
18297,0001-20100331-77-2780-1-6021,0,2010-03-31,731,運賃,運賃,0,192953,-458128
18298,0001-20100331-77-2780-1-6021,1,2010-03-31,191,仮払消費税等,運賃,0,9647,-467775
18308,0001-20100331-93-2782-1-6025,0,2010-03-31,753,修繕維持費,修繕費,0,17000,-484775
18309,0001-20100331-93-2782-1-6025,1,2010-03-31,191,仮払消費税等,修繕費,0,850,-485625
18331,0001-20100331-99-2784-1-6029,0,2010-03-31,731,運賃,運賃,0,930867,-1416492
18332,0001-20100331-99-2784-1-6029,1,2010-03-31,191,仮払消費税等,運賃,0,46543,-1463035
,,,2010-03,,※※月計※※,,7030303,9047727,-1463035
