num,GL02,GL02-GL55,date,contra_account,contra_account_name,note,debit_amount,credit_amount,balance
,,,,740,車両費,,7285803,0,7285803
14,0001-20090402-142-6-1-473,0,2009-04-02,111,現金,高速代,2458,0,2458
17,0001-20090402-142-6-1-473,3,2009-04-02,111,現金,駐車代,591,0,3049
19,0001-20090402-142-6-1-473,5,2009-04-02,111,現金,ガソリン代,4620,0,7669
21,0001-20090402-142-6-1-473,7,2009-04-02,111,現金,洗車券代,5715,0,13384
39,0001-20090404-310-9-1-479,0,2009-04-04,111,現金,ガソリン代,6486,0,19870
42,0001-20090404-310-9-1-479,3,2009-04-04,111,現金,高速代,9715,0,29585
44,0001-20090404-310-9-1-479,5,2009-04-04,111,現金,駐車代,1200,0,30785
85,0001-20090406-10-16-1-493,0,2009-04-06,111,現金,ガソリン代,4023,0,34808
106,0001-20090406-147-23-1-507,0,2009-04-06,322,未払金,ガソリン代,4882,0,39690
171,0001-20090408-143-37-1-535,0,2009-04-08,111,現金,ガソリン代,6796,0,46486
175,0001-20090408-50-36-1-533,0,2009-04-08,111,現金,高速代,1143,0,47629
325,0001-20090412-155-62-1-585,0,2009-04-12,111,現金,ガソリン代,4500,0,52129
328,0001-20090412-155-62-1-585,3,2009-04-12,111,現金,駐車代,572,0,52701
337,0001-20090412-311-64-1-589,0,2009-04-12,111,現金,タイヤ交換,70477,0,123178
341,0001-20090413-11-65-1-591,0,2009-04-13,111,現金,ガソリン代,3058,0,126236
345,0001-20090413-144-67-1-595,0,2009-04-13,111,現金,ウォッシャー液代,572,0,126808
348,0001-20090413-144-67-1-595,3,2009-04-13,111,現金,高速代,2286,0,129094
350,0001-20090413-144-67-1-595,5,2009-04-13,111,現金,ガソリン代,5833,0,134927
361,0001-20090413-17-66-1-593,0,2009-04-13,111,現金,ウォッシャー液,351,0,135278
364,0001-20090413-17-66-1-593,3,2009-04-13,111,現金,駐車代,762,0,136040
375,0001-20090414-46-71-1-603,0,2009-04-14,111,現金,ガソリン代,2341,0,138381
378,0001-20090414-46-71-1-603,3,2009-04-14,111,現金,駐車代,1762,0,140143
380,0001-20090414-46-71-1-603,5,2009-04-14,111,現金,高速代,3048,0,143191
383,0001-20090414-51-72-1-605,0,2009-04-14,111,現金,高速代,1505,0,144696
386,0001-20090414-51-72-1-605,3,2009-04-14,111,現金,駐車代,620,0,145316
388,0001-20090414-51-72-1-605,5,2009-04-14,111,現金,駐車代,810,0,146126
390,0001-20090414-51-72-1-605,7,2009-04-14,111,現金,高速代,1096,0,147222
407,0001-20090415-243-78-1-617,0,2009-04-15,111,現金,ガソリン代,5942,0,153164
484,0001-20090417-12-89-1-639,0,2009-04-17,111,現金,ガソリン代,4456,0,157620
487,0001-20090417-12-89-1-639,3,2009-04-17,111,現金,高速代,572,0,158192
489,0001-20090417-12-89-1-639,5,2009-04-17,111,現金,駐車代,1143,0,159335
492,0001-20090417-47-90-1-641,0,2009-04-17,111,現金,ガソリン代,2420,0,161755
496,0001-20090417-52-91-1-643,0,2009-04-17,111,現金,ガソリン代,2191,0,163946
499,0001-20090417-52-91-1-643,3,2009-04-17,111,現金,高速代,1096,0,165042
501,0001-20090417-52-91-1-643,5,2009-04-17,111,現金,駐車代,1143,0,166185
508,0001-20090419-244-93-1-647,0,2009-04-19,111,現金,ガソリン代,6727,0,172912
630,0001-20090420-48-101-1-663,0,2009-04-20,111,現金,ガソリン代,4099,0,177011
634,0001-20090420-53-102-1-665,0,2009-04-20,111,現金,高速代,381,0,177392
637,0001-20090420-53-102-1-665,3,2009-04-20,111,現金,駐車代,2000,0,179392
639,0001-20090420-53-102-1-665,5,2009-04-20,111,現金,ガソリン代,6102,0,185494
732,0001-20090422-245-140-1-741,0,2009-04-22,111,現金,駐車代,572,0,186066
735,0001-20090422-245-140-1-741,3,2009-04-22,111,現金,高速代,762,0,186828
737,0001-20090422-245-140-1-741,5,2009-04-22,111,現金,ガソリン代,5238,0,192066
780,0001-20090423-54-144-1-749,0,2009-04-23,111,現金,高速代,1810,0,193876
783,0001-20090423-54-144-1-749,3,2009-04-23,111,現金,駐車代,810,0,194686
1005,0001-20090426-109-173-1-807,0,2009-04-26,322,未払金,ガソリン代,6770,0,201456
1013,0001-20090426-148-175-1-811,0,2009-04-26,111,現金,ガソリン代,5500,0,206956
1016,0001-20090426-148-175-1-811,3,2009-04-26,111,現金,高速代,1143,0,208099
1053,0001-20090427-13-179-1-819,0,2009-04-27,322,未払金,ガソリン代,11990,0,220089
1057,0001-20090427-14-180-1-821,0,2009-04-27,111,現金,ガソリン代,2858,0,222947
1061,0001-20090427-15-181-1-823,0,2009-04-27,111,現金,車両管理費,23810,0,246757
1131,0001-20090430-137-209-1-879,5,2009-04-30,131,普通預金,高速料,50777,0,297534
1140,0001-20090430-138-210-1-881,0,2009-04-30,111,現金,ガソリン代,3410,0,300944
1143,0001-20090430-138-210-1-881,3,2009-04-30,111,現金,高速代,2524,0,303468
1500,0001-20090430-49-192-1-845,0,2009-04-30,322,未払金,ガソリン代,155686,0,459154
1503,0001-20090430-49-192-1-845,3,2009-04-30,111,現金,高速代,3381,0,462535
1506,0001-20090430-49-192-1-845,6,2009-04-30,111,現金,駐車代,762,0,463297
1515,0001-20090430-55-193-1-847,0,2009-04-30,111,現金,車両管理費,23810,0,487107
1518,0001-20090430-55-193-1-847,3,2009-04-30,111,現金,車両管理費,26667,0,513774
1521,0001-20090430-55-193-1-847,6,2009-04-30,111,現金,高速代,7667,0,521441
1560,0001-20090430-82-201-1-863,0,2009-04-30,322,未払金,ガソリン代,21016,0,542457
1564,0001-20090430-83-202-1-865,0,2009-04-30,111,現金,車両管理費,47620,0,590077
,,,2009-04,,※※月計※※,,590077,0,
1597,0001-20090503-10-251-1-963,0,2009-05-03,111,現金,ガソリン代,3469,0,593546
1688,0001-20090508-142-274-1-1009,0,2009-05-08,111,現金,駐車代,762,0,594308
1691,0001-20090508-142-274-1-1009,3,2009-05-08,111,現金,ガソリン代,6810,0,601118
1694,0001-20090508-147-275-1-1011,0,2009-05-08,322,未払金,ガソリン代,6326,0,607444
1703,0001-20090508-17-271-1-1003,0,2009-05-08,111,現金,夏用ワイパー代,7560,0,615004
1706,0001-20090508-17-271-1-1003,3,2009-05-08,111,現金,ウォッシャー液,340,0,615344
1749,0001-20090510-46-279-1-1019,0,2009-05-10,111,現金,ガソリン代,2858,0,618202
1752,0001-20090510-46-279-1-1019,3,2009-05-10,111,現金,駐車代,1429,0,619631
1754,0001-20090510-46-279-1-1019,5,2009-05-10,111,現金,高速代,6448,0,626079
1881,0001-20090512-143-307-1-1075,0,2009-05-12,111,現金,点検作業料,23258,0,649337
1903,0001-20090513-144-311-1-1083,0,2009-05-13,111,現金,ガソリン代,6400,0,655737
1941,0001-20090515-11-314-1-1089,0,2009-05-15,111,現金,ガソリン代,3058,0,658795
1961,0001-20090515-52-315-1-1091,0,2009-05-15,111,現金,駐車代,762,0,659557
1964,0001-20090515-52-315-1-1091,3,2009-05-15,111,現金,高速代,2191,0,661748
1966,0001-20090515-52-315-1-1091,5,2009-05-15,111,現金,ガソリン代,6126,0,667874
2033,0001-20090518-109-335-1-1131,0,2009-05-18,322,未払金,ガソリン代,6258,0,674132
2041,0001-20090518-47-333-1-1127,0,2009-05-18,111,現金,高速代,2420,0,676552
2044,0001-20090518-47-333-1-1127,3,2009-05-18,111,現金,ガソリン代,4762,0,681314
2097,0001-20090520-13-338-1-1137,0,2009-05-20,111,現金,ガソリン代,7648,0,688962
2122,0001-20090520-53-341-1-1143,0,2009-05-20,111,現金,高速代,1286,0,690248
2147,0001-20090520-82-345-1-1151,0,2009-05-20,322,未払金,ガソリン代,18861,0,709109
2150,0001-20090520-82-345-1-1151,3,2009-05-20,322,未払金,ウォッシャー液,369,0,709478
2230,0001-20090522-138-377-1-1215,0,2009-05-22,111,現金,ガソリン代,5650,0,715128
2233,0001-20090522-138-377-1-1215,3,2009-05-22,111,現金,高速代,4896,0,720024
2296,0001-20090523-78-383-1-1227,0,2009-05-23,111,現金,ガソリン代,6115,0,726139
2500,0001-20090526-14-403-1-1267,0,2009-05-26,111,現金,ガソリン代,4000,0,730139
2542,0001-20090526-83-408-1-1277,0,2009-05-26,111,現金,車両管理費,42858,0,772997
2558,0001-20090527-15-414-1-1289,0,2009-05-27,111,現金,タイヤ交換,71429,0,844426
2571,0001-20090527-49-417-1-1295,0,2009-05-27,111,現金,ガソリン代,142858,0,987284
2574,0001-20090527-49-417-1-1295,3,2009-05-27,131,普通預金,車両管理費,32572,0,1019856
2586,0001-20090527-79-419-1-1299,0,2009-05-27,111,現金,ガソリン代,3538,0,1023394
2622,0001-20090529-155-428-1-1317,0,2009-05-29,111,現金,車両管理費,6486,0,1029880
2625,0001-20090529-155-428-1-1317,3,2009-05-29,111,現金,高速代,9715,0,1039595
2627,0001-20090529-155-428-1-1317,5,2009-05-29,111,現金,駐車代,1200,0,1040795
2652,0001-20090530-137-433-1-1327,5,2009-05-30,131,普通預金,高速料,50777,0,1091572
2661,0001-20090530-148-434-1-1329,0,2009-05-30,111,現金,ウォッシャー液他,600,0,1092172
2674,0001-20090530-70-429-1-1319,5,2009-05-30,111,現金,高速料,69824,0,1161996
3081,0001-20090531-55-439-1-1339,0,2009-05-31,111,現金,高速代,9239,0,1171235
,,,2009-05,,※※月計※※,,581158,0,
3143,0001-20090601-147-488-1-1437,0,2009-06-01,322,未払金,ガソリン代,5416,0,1176651
3146,0001-20090601-147-488-1-1437,3,2009-06-01,322,未払金,高速代,572,0,1177223
3153,0001-20090602-10-489-1-1439,0,2009-06-02,111,現金,ガソリン代,4023,0,1181246
3216,0001-20090606-142-504-1-1469,0,2009-06-06,111,現金,ガソリン代,6267,0,1187513
3219,0001-20090606-142-504-1-1469,3,2009-06-06,111,現金,高速代,1572,0,1189085
3221,0001-20090606-142-504-1-1469,5,2009-06-06,111,現金,駐車代,620,0,1189705
3223,0001-20090606-142-504-1-1469,7,2009-06-06,111,現金,洗車代,1000,0,1190705
3260,0001-20090608-50-510-1-1481,0,2009-06-08,111,現金,高速代,1143,0,1191848
3440,0001-20090613-143-545-1-1551,0,2009-06-13,111,現金,ガソリン代,6903,0,1198751
3465,0001-20090614-51-549-1-1559,0,2009-06-14,111,現金,ガソリン代,10929,0,1209680
3468,0001-20090614-51-549-1-1559,3,2009-06-14,111,現金,駐車代,762,0,1210442
3470,0001-20090614-51-549-1-1559,5,2009-06-14,111,現金,高速代,3143,0,1213585
3523,0001-20090615-11-550-1-1561,0,2009-06-15,111,現金,高速代,3058,0,1216643
3539,0001-20090615-52-551-1-1563,0,2009-06-15,111,現金,高速代,715,0,1217358
3559,0001-20090616-83-564-1-1589,0,2009-06-16,322,未払金,ガソリン代,4721,0,1222079
3563,0001-20090617-144-568-1-1597,0,2009-06-17,111,現金,ガソリン代,5528,0,1227607
3566,0001-20090617-144-568-1-1597,3,2009-06-17,111,現金,高速代,762,0,1228369
3568,0001-20090617-144-568-1-1597,5,2009-06-17,111,現金,駐車代,1429,0,1229798
3583,0001-20090618-82-569-1-1599,0,2009-06-18,322,未払金,ガソリン代,29607,0,1259405
3587,0001-20090619-46-571-1-1603,0,2009-06-19,111,現金,ガソリン代,11988,0,1271393
3696,0001-20090620-53-577-1-1615,0,2009-06-20,111,現金,高速代,2381,0,1273774
3771,0001-20090621-12-605-1-1671,0,2009-06-21,111,現金,ガソリン代,4456,0,1278230
3774,0001-20090621-12-605-1-1671,3,2009-06-21,111,現金,ガソリン添加剤代,2313,0,1280543
3776,0001-20090621-12-605-1-1671,5,2009-06-21,111,現金,高速代,1048,0,1281591
3791,0001-20090622-109-612-1-1685,0,2009-06-22,322,未払金,ガソリン代,6631,0,1288222
3799,0001-20090622-155-614-1-1689,0,2009-06-22,111,現金,ガソリン代,5713,0,1293935
3802,0001-20090622-155-614-1-1689,3,2009-06-22,111,現金,高速代,762,0,1294697
3804,0001-20090622-155-614-1-1689,5,2009-06-22,111,現金,駐車代,381,0,1295078
3924,0001-20090625-54-628-1-1717,0,2009-06-25,111,現金,駐車代,1905,0,1296983
4073,0001-20090626-13-640-1-1741,0,2009-06-26,111,現金,ガソリン代,3298,0,1300281
4077,0001-20090626-138-649-1-1759,0,2009-06-26,111,現金,高速代,6756,0,1307037
4081,0001-20090626-14-641-1-1743,0,2009-06-26,111,現金,洗車代,2858,0,1309895
4158,0001-20090629-83-661-1-1783,0,2009-06-29,111,現金,車両管理費,49048,0,1358943
4449,0001-20090630-137-697-1-1855,5,2009-06-30,131,普通預金,高速料,50777,0,1409720
4543,0001-20090630-49-665-1-1791,0,2009-06-30,131,普通預金,ガソリン代,114286,0,1524006
4562,0001-20090630-70-668-1-1797,5,2009-06-30,131,普通預金,高速料,60334,0,1584340
4592,0001-20090630-84-673-1-1807,0,2009-06-30,111,現金,ガソリン代,3249,0,1587589
,,,2009-06,,※※月計※※,,416354,0,
4701,0001-20090702-142-716-1-1893,0,2009-07-02,111,現金,洗車代,2458,0,1590047
4704,0001-20090702-142-716-1-1893,3,2009-07-02,111,現金,ガソリン代,6229,0,1596276
4706,0001-20090702-142-716-1-1893,5,2009-07-02,111,現金,高速代,3086,0,1599362
4708,0001-20090702-142-716-1-1893,7,2009-07-02,111,現金,高速代,477,0,1599839
4710,0001-20090702-142-716-1-1893,9,2009-07-02,111,現金,高速代,8097,0,1607936
4712,0001-20090702-142-716-1-1893,11,2009-07-02,111,現金,ガソリン代,3858,0,1611794
4737,0001-20090704-10-721-1-1903,0,2009-07-04,111,現金,ガソリン代,6972,0,1618766
4748,0001-20090704-82-724-1-1909,0,2009-07-04,322,未払金,ガソリン代,18000,0,1636766
4820,0001-20090707-50-738-1-1937,0,2009-07-07,111,現金,ガソリン代,11429,0,1648195
4828,0001-20090708-147-743-1-1947,0,2009-07-08,322,未払金,ガソリン代,5412,0,1653607
4831,0001-20090708-147-743-1-1947,3,2009-07-08,322,未払金,高速代,4858,0,1658465
4833,0001-20090708-147-743-1-1947,5,2009-07-08,322,未払金,駐車代,572,0,1659037
4858,0001-20090709-143-747-1-1955,0,2009-07-09,111,現金,点検作業料,38096,0,1697133
4862,0001-20090709-79-746-1-1953,0,2009-07-09,111,現金,ガソリン代,3352,0,1700485
5022,0001-20090714-51-775-1-2011,0,2009-07-14,111,現金,高速代,7172,0,1707657
5025,0001-20090714-51-775-1-2011,3,2009-07-14,111,現金,駐車代,3286,0,1710943
5062,0001-20090715-46-778-1-2017,0,2009-07-15,111,現金,ガソリン代,13334,0,1724277
5113,0001-20090716-11-790-1-2041,0,2009-07-16,111,現金,ガソリン代,3058,0,1727335
5125,0001-20090716-52-791-1-2043,0,2009-07-16,111,現金,高速代,3381,0,1730716
5128,0001-20090716-52-791-1-2043,3,2009-07-16,111,現金,ガソリン代,71429,0,1802145
5137,0001-20090717-12-797-1-2055,0,2009-07-17,111,現金,駐車代,762,0,1802907
5140,0001-20090717-12-797-1-2055,3,2009-07-17,111,現金,ガソリン代,4456,0,1807363
5143,0001-20090717-12-797-1-2055,6,2009-07-17,111,現金,ガソリン代,4015,0,1811378
5158,0001-20090718-148-802-1-2065,0,2009-07-18,111,現金,ガソリン代,4486,0,1815864
5161,0001-20090718-148-802-1-2065,3,2009-07-18,111,現金,ウォッシャー液他,1600,0,1817464
5176,0001-20090719-47-804-1-2069,0,2009-07-19,111,現金,ガソリン代,8134,0,1825598
5255,0001-20090720-144-829-1-2119,0,2009-07-20,111,現金,ガソリン代,4324,0,1829922
5258,0001-20090720-144-829-1-2119,3,2009-07-20,111,現金,高速代,3408,0,1833330
5260,0001-20090720-144-829-1-2119,5,2009-07-20,111,現金,ガソリン代,7048,0,1840378
5282,0001-20090720-48-809-1-2079,0,2009-07-20,111,現金,ガソリン代,4099,0,1844477
5286,0001-20090720-53-810-1-2081,0,2009-07-20,111,現金,ガソリン代,6381,0,1850858
5289,0001-20090720-53-810-1-2081,3,2009-07-20,111,現金,駐車代,1429,0,1852287
5291,0001-20090720-53-810-1-2081,5,2009-07-20,111,現金,高速代,715,0,1853002
5415,0001-20090724-137-850-1-2161,5,2009-07-24,131,普通預金,高速料,28324,0,1881326
5423,0001-20090724-137-850-1-2161,11,2009-07-24,111,現金,駐車代,3340,0,1884666
5441,0001-20090724-54-849-1-2159,0,2009-07-24,111,現金,高速代,2858,0,1887524
5444,0001-20090724-54-849-1-2159,3,2009-07-24,111,現金,ガソリン代,4412,0,1891936
5447,0001-20090725-109-863-1-2187,0,2009-07-25,322,未払金,ガソリン代,42381,0,1934317
5495,0001-20090725-155-870-1-2201,0,2009-07-25,111,現金,ガソリン代,6901,0,1941218
5694,0001-20090727-15-879-1-2219,0,2009-07-27,111,現金,高速代,2858,0,1944076
5721,0001-20090727-83-884-1-2229,0,2009-07-27,111,現金,車両管理費,42858,0,1986934
5729,0001-20090728-138-890-1-2241,0,2009-07-28,111,現金,高速代,4290,0,1991224
5732,0001-20090728-138-890-1-2241,3,2009-07-28,111,現金,駐車代,3049,0,1994273
5734,0001-20090728-138-890-1-2241,5,2009-07-28,111,現金,高速代,6229,0,2000502
5736,0001-20090728-138-890-1-2241,7,2009-07-28,111,現金,高速代,477,0,2000979
5738,0001-20090728-138-890-1-2241,9,2009-07-28,111,現金,高速代,2353,0,2003332
5740,0001-20090728-138-890-1-2241,11,2009-07-28,111,現金,ガソリン代,6198,0,2009530
5767,0001-20090729-14-891-1-2243,0,2009-07-29,111,現金,ガソリン代,2858,0,2012388
5780,0001-20090730-49-893-1-2247,0,2009-07-30,111,現金,ガソリン代,161905,0,2174293
5783,0001-20090730-49-893-1-2247,3,2009-07-30,111,現金,車両管理費,20000,0,2194293
,,,2009-07,,※※月計※※,,606704,0,
6226,0001-20090801-50-946-1-2353,0,2009-08-01,111,現金,高速代,572,0,2194865
6230,0001-20090802-147-948-1-2357,0,2009-08-02,322,未払金,ガソリン代,6332,0,2201197
6245,0001-20090803-142-953-1-2367,0,2009-08-03,111,現金,高速代,2458,0,2203655
6248,0001-20090803-142-953-1-2367,3,2009-08-03,111,現金,ガソリン代,3052,0,2206707
6250,0001-20090803-142-953-1-2367,5,2009-08-03,111,現金,高速代,1191,0,2207898
6252,0001-20090803-142-953-1-2367,7,2009-08-03,111,現金,高速代,8543,0,2216441
6254,0001-20090803-142-953-1-2367,9,2009-08-03,111,現金,高速代,4290,0,2220731
6261,0001-20090803-82-950-1-2361,0,2009-08-03,322,未払金,ガソリン代,17163,0,2237894
6326,0001-20090807-10-966-1-2393,0,2009-08-07,111,現金,ガソリン代,4023,0,2241917
6356,0001-20090809-143-977-1-2415,0,2009-08-09,111,現金,点検作業料,30002,0,2271919
6368,0001-20090809-46-974-1-2409,0,2009-08-09,111,現金,レーダー代,3298,0,2275217
6371,0001-20090809-46-974-1-2409,3,2009-08-09,111,現金,ガソリン代,4207,0,2279424
6389,0001-20090810-148-993-1-2447,0,2009-08-10,111,現金,ガソリン代,3755,0,2283179
6502,0001-20090811-144-1003-1-2467,0,2009-08-11,111,現金,ガソリン代,3294,0,2286473
6505,0001-20090811-144-1003-1-2467,3,2009-08-11,111,現金,ガソリン代,6195,0,2292668
6507,0001-20090811-144-1003-1-2467,5,2009-08-11,111,現金,洗車代,1905,0,2294573
6537,0001-20090813-11-1006-1-2473,0,2009-08-13,111,現金,ガソリン代,3058,0,2297631
6623,0001-20090816-12-1020-1-2501,0,2009-08-16,111,現金,ガソリン代,4456,0,2302087
6626,0001-20090816-12-1020-1-2501,3,2009-08-16,111,現金,高速代,2313,0,2304400
6628,0001-20090816-12-1020-1-2501,5,2009-08-16,111,現金,ウォッシャー液,300,0,2304700
6635,0001-20090816-51-1021-1-2503,0,2009-08-16,111,現金,高速代,3362,0,2308062
6638,0001-20090816-51-1021-1-2503,3,2009-08-16,111,現金,ガソリン代,4412,0,2312474
6640,0001-20090816-51-1021-1-2503,5,2009-08-16,111,現金,駐車代,1762,0,2314236
6657,0001-20090817-52-1024-1-2509,0,2009-08-17,111,現金,ガソリン代,3620,0,2317856
6677,0001-20090819-47-1030-1-2521,0,2009-08-19,111,現金,駐車代,810,0,2318666
6782,0001-20090820-53-1036-1-2533,0,2009-08-20,111,現金,ガソリン代,9879,0,2328545
6845,0001-20090821-155-1066-1-2593,0,2009-08-21,111,現金,ガソリン代,6720,0,2335265
6878,0001-20090822-109-1074-1-2609,0,2009-08-22,322,未払金,ガソリン代,53943,0,2389208
6893,0001-20090822-48-1069-1-2599,0,2009-08-22,111,現金,ガソリン代,4874,0,2394082
7097,0001-20090825-15-1085-1-2631,0,2009-08-25,111,現金,洗車代,2858,0,2396940
7150,0001-20090826-138-1103-1-2667,0,2009-08-26,111,現金,高速代,5381,0,2402321
7153,0001-20090826-138-1103-1-2667,3,2009-08-26,111,現金,高速代,3858,0,2406179
7155,0001-20090826-138-1103-1-2667,5,2009-08-26,111,現金,ガソリン代,6381,0,2412560
7157,0001-20090826-138-1103-1-2667,7,2009-08-26,111,現金,駐車代,3400,0,2415960
7180,0001-20090827-13-1106-1-2673,0,2009-08-27,111,現金,ガソリン代,7284,0,2423244
7184,0001-20090827-14-1107-1-2675,0,2009-08-27,111,現金,ガソリン代,2858,0,2426102
7233,0001-20090828-54-1115-1-2691,0,2009-08-28,111,現金,高速代,1715,0,2427817
7236,0001-20090828-54-1115-1-2691,3,2009-08-28,111,現金,駐車代,858,0,2428675
7272,0001-20090830-137-1130-1-2721,5,2009-08-30,131,普通預金,高速料,42924,0,2471599
7281,0001-20090830-49-1121-1-2703,0,2009-08-30,111,現金,ガソリン代,162269,0,2633868
7284,0001-20090830-49-1121-1-2703,3,2009-08-30,111,現金,車両管理費,23364,0,2657232
7293,0001-20090830-70-1122-1-2705,5,2009-08-30,111,現金,高速代,53810,0,2711042
7300,0001-20090830-76-1123-1-2707,0,2009-08-30,111,現金,ガソリン代,5623,0,2716665
7303,0001-20090830-76-1123-1-2707,3,2009-08-30,111,現金,タイヤ代　175/60-14　4本,42286,0,2758951
7305,0001-20090830-76-1123-1-2707,5,2009-08-30,111,現金,タイヤ交換代,1200,0,2760151
7668,0001-20090831-83-1140-1-2741,0,2009-08-31,111,現金,車両管理費,40477,0,2800628
,,,2009-08,,※※月計※※,,606335,0,
7734,0001-20090903-50-1186-1-2833,0,2009-09-03,111,現金,駐車代,572,0,2801200
7742,0001-20090904-147-1190-1-2841,0,2009-09-04,322,未払金,ガソリン代,65162,0,2866362
7746,0001-20090904-16-1189-1-2839,0,2009-09-04,111,現金,駐車代,530,0,2866892
7749,0001-20090904-16-1189-1-2839,3,2009-09-04,111,現金,ガソリン代,5951,0,2872843
7752,0001-20090905-142-1194-1-2849,0,2009-09-05,111,現金,ガソリン代,7290,0,2880133
7755,0001-20090905-142-1194-1-2849,3,2009-09-05,111,現金,洗車代,1905,0,2882038
7757,0001-20090905-142-1194-1-2849,5,2009-09-05,111,現金,駐車代,3048,0,2885086
7781,0001-20090906-10-1195-1-2851,0,2009-09-06,111,現金,ガソリン代,4023,0,2889109
7815,0001-20090909-148-1204-1-2869,0,2009-09-09,111,現金,ガソリン代,6865,0,2895974
7818,0001-20090909-148-1204-1-2869,3,2009-09-09,111,現金,高速代,2286,0,2898260
7833,0001-20090910-143-1219-1-2899,0,2009-09-10,111,現金,点検作業料,20953,0,2919213
7871,0001-20090910-81-1209-1-2879,0,2009-09-10,111,現金,ガソリン代,4931,0,2924144
7874,0001-20090910-81-1209-1-2879,3,2009-09-10,111,現金,駐車代,572,0,2924716
7990,0001-20090912-11-1233-1-2927,0,2009-09-12,111,現金,ガソリン代,3058,0,2927774
8021,0001-20090913-17-1238-1-2937,0,2009-09-13,111,現金,駐車代,351,0,2928125
8033,0001-20090914-51-1243-1-2947,0,2009-09-14,111,現金,高速代,3124,0,2931249
8036,0001-20090914-51-1243-1-2947,3,2009-09-14,111,現金,駐車代,2620,0,2933869
8098,0001-20090915-82-1246-1-2953,0,2009-09-15,322,未払金,ガソリン代,24553,0,2958422
8128,0001-20090917-12-1261-1-2983,0,2009-09-17,111,現金,ガソリン代,7113,0,2965535
8131,0001-20090917-12-1261-1-2983,3,2009-09-17,111,現金,ガソリン代,4015,0,2969550
8138,0001-20090917-52-1262-1-2985,0,2009-09-17,111,現金,高速代,1096,0,2970646
8141,0001-20090917-52-1262-1-2985,3,2009-09-17,111,現金,駐車代,762,0,2971408
8143,0001-20090917-52-1262-1-2985,5,2009-09-17,111,現金,ガソリン代,5477,0,2976885
8158,0001-20090919-47-1266-1-2993,0,2009-09-19,111,現金,ガソリン代,3448,0,2980333
8162,0001-20090919-82-1267-1-2995,0,2009-09-19,111,現金,ガソリン代,4602,0,2984935
8165,0001-20090919-82-1267-1-2995,3,2009-09-19,111,現金,駐車代,381,0,2985316
8225,0001-20090920-138-1288-1-3037,0,2009-09-20,111,現金,高速代,3410,0,2988726
8228,0001-20090920-138-1288-1-3037,3,2009-09-20,111,現金,高速代,2524,0,2991250
8230,0001-20090920-138-1288-1-3037,5,2009-09-20,111,現金,高速代,3667,0,2994917
8232,0001-20090920-138-1288-1-3037,7,2009-09-20,111,現金,洗車代,1905,0,2996822
8234,0001-20090920-138-1288-1-3037,9,2009-09-20,111,現金,ガソリン代,8560,0,3005382
8236,0001-20090920-138-1288-1-3037,11,2009-09-20,111,現金,ウォッシャー液代,572,0,3005954
8238,0001-20090920-138-1288-1-3037,13,2009-09-20,111,現金,高速代,4291,0,3010245
8252,0001-20090920-48-1270-1-3001,0,2009-09-20,111,現金,ガソリン代,4099,0,3014344
8256,0001-20090920-53-1271-1-3003,0,2009-09-20,111,現金,ガソリン代,2381,0,3016725
8259,0001-20090920-53-1271-1-3003,3,2009-09-20,111,現金,高速代,1191,0,3017916
8398,0001-20090923-54-1310-1-3081,0,2009-09-23,111,現金,高速代,4381,0,3022297
8402,0001-20090924-109-1314-1-3089,0,2009-09-24,322,未払金,ガソリン代,43239,0,3065536
8410,0001-20090924-144-1316-1-3093,0,2009-09-24,111,現金,ガソリン代,6172,0,3071708
8413,0001-20090924-144-1316-1-3093,3,2009-09-24,111,現金,高速代,8477,0,3080185
8603,0001-20090926-155-1334-1-3129,0,2009-09-26,111,現金,ガソリン代,6901,0,3087086
8645,0001-20090927-13-1336-1-3133,0,2009-09-27,111,現金,修理代,89000,0,3176086
8649,0001-20090927-14-1337-1-3135,0,2009-09-27,111,現金,ガソリン代,3810,0,3179896
8676,0001-20090928-83-1345-1-3151,0,2009-09-28,111,現金,車両管理費,46191,0,3226087
8697,0001-20090929-137-1351-1-3163,5,2009-09-29,131,普通預金,高速料,64581,0,3290668
8726,0001-20090929-83-1349-1-3159,0,2009-09-29,111,現金,ガソリン代,4153,0,3294821
9050,0001-20090930-49-1358-1-3177,0,2009-09-30,111,現金,ガソリン代,127620,0,3422441
9053,0001-20090930-49-1358-1-3177,3,2009-09-30,111,現金,高速代,5729,0,3428170
9075,0001-20090930-70-1361-1-3183,5,2009-09-30,111,現金,高速代,69824,0,3497994
,,,2009-09,,※※月計※※,,697366,0,
9155,0001-20091002-142-1413-1-3287,0,2009-10-02,111,現金,ガソリン代,6229,0,3504223
9158,0001-20091002-142-1413-1-3287,3,2009-10-02,111,現金,高速代,4289,0,3508512
9160,0001-20091002-142-1413-1-3287,5,2009-10-02,111,現金,点検作業料,43433,0,3551945
9173,0001-20091002-50-1411-1-3283,0,2009-10-02,111,現金,駐車代,1143,0,3553088
9201,0001-20091005-147-1424-1-3309,0,2009-10-05,322,未払金,ガソリン代,3774,0,3556862
9283,0001-20091008-10-1437-1-3335,0,2009-10-08,111,現金,駐車代,477,0,3557339
9291,0001-20091008-16-1438-1-3337,0,2009-10-08,111,現金,洗車代,2858,0,3560197
9294,0001-20091008-16-1438-1-3337,3,2009-10-08,111,現金,ガソリン代,6000,0,3566197
9298,0001-20091008-82-1439-1-3339,0,2009-10-08,322,未払金,ガソリン代,27372,0,3593569
9306,0001-20091009-46-1442-1-3345,0,2009-10-09,111,現金,ガソリン代,6172,0,3599741
9309,0001-20091009-46-1442-1-3345,3,2009-10-09,111,現金,高速代,7143,0,3606884
9311,0001-20091009-46-1442-1-3345,5,2009-10-09,111,現金,駐車代,3334,0,3610218
9448,0001-20091011-73-1465-1-3391,0,2009-10-11,111,現金,ガソリン代,6325,0,3616543
9451,0001-20091011-73-1465-1-3391,3,2009-10-11,111,現金,高速代,1143,0,3617686
9454,0001-20091012-148-1467-1-3395,0,2009-10-12,111,現金,ガソリン代,6729,0,3624415
9466,0001-20091013-11-1469-1-3399,0,2009-10-13,111,現金,ガソリン代,3058,0,3627473
9470,0001-20091013-51-1470-1-3401,0,2009-10-13,111,現金,駐車代,3667,0,3631140
9473,0001-20091013-51-1470-1-3401,3,2009-10-13,111,現金,高速代,5524,0,3636664
9475,0001-20091013-51-1470-1-3401,5,2009-10-13,111,現金,ガソリン代,4381,0,3641045
9594,0001-20091017-47-1491-1-3443,0,2009-10-17,111,現金,ガソリン代,2420,0,3643465
9606,0001-20091018-12-1493-1-3447,0,2009-10-18,111,現金,ガソリン代,4456,0,3647921
9609,0001-20091018-12-1493-1-3447,3,2009-10-18,111,現金,高速代,2313,0,3650234
9613,0001-20091018-155-1497-1-3455,0,2009-10-18,111,現金,ガソリン代,3372,0,3653606
9617,0001-20091018-52-1494-1-3449,0,2009-10-18,111,現金,高速代,2191,0,3655797
9620,0001-20091018-52-1494-1-3449,3,2009-10-18,111,現金,駐車代,1715,0,3657512
9683,0001-20091020-144-1516-1-3493,0,2009-10-20,111,現金,ガソリン代,4290,0,3661802
9686,0001-20091020-144-1516-1-3493,3,2009-10-20,111,現金,ガソリン代,8096,0,3669898
9688,0001-20091020-144-1516-1-3493,5,2009-10-20,111,現金,駐車代,3372,0,3673270
9695,0001-20091020-48-1500-1-3461,0,2009-10-20,111,現金,ガソリン代,4099,0,3677369
9779,0001-20091021-53-1522-1-3505,0,2009-10-21,111,現金,高速代,2286,0,3679655
9782,0001-20091021-53-1522-1-3505,3,2009-10-21,111,現金,ガソリン代,1000,0,3680655
9784,0001-20091021-53-1522-1-3505,5,2009-10-21,111,現金,駐車代,762,0,3681417
9832,0001-20091022-137-1537-1-3535,5,2009-10-22,131,普通預金,高速料,42901,0,3724318
9887,0001-20091023-54-1543-1-3547,0,2009-10-23,111,現金,高速代,4381,0,3728699
9961,0001-20091025-74-1551-1-3563,0,2009-10-25,111,現金,ガソリン代,4351,0,3733050
9964,0001-20091025-74-1551-1-3563,3,2009-10-25,111,現金,駐車代,572,0,3733622
10127,0001-20091027-14-1569-1-3599,0,2009-10-27,111,現金,ガソリン代,2858,0,3736480
10140,0001-20091027-83-1572-1-3605,0,2009-10-27,111,現金,車両管理費,48762,0,3785242
10160,0001-20091028-15-1576-1-3613,0,2009-10-28,111,現金,駐車代,762,0,3786004
10172,0001-20091029-109-1581-1-3623,0,2009-10-29,322,未払金,ガソリン代,58757,0,3844761
10193,0001-20091030-13-1582-1-3625,0,2009-10-30,111,現金,ガソリン代,12381,0,3857142
10213,0001-20091030-55-1583-1-3627,0,2009-10-30,111,現金,車両管理費,23810,0,3880952
10216,0001-20091030-55-1583-1-3627,3,2009-10-30,111,現金,高速代,7667,0,3888619
10224,0001-20091030-70-1584-1-3629,5,2009-10-30,131,普通預金,高速代,71429,0,3960048
10562,0001-20091031-49-1593-1-3647,0,2009-10-31,111,現金,ガソリン代,155686,0,4115734
,,,2009-10,,※※月計※※,,617740,0,
10622,0001-20091101-75-1637-1-3735,0,2009-11-01,111,現金,ガソリン代,6151,0,4121885
10625,0001-20091101-75-1637-1-3735,3,2009-11-01,111,現金,ウォッシャー液代,475,0,4122360
10659,0001-20091105-143-1654-1-3769,0,2009-11-05,111,現金,点検作業料,29858,0,4152218
10671,0001-20091105-50-1646-1-3753,0,2009-11-05,111,現金,高速代,3620,0,4155838
10704,0001-20091106-10-1655-1-3771,0,2009-11-06,111,現金,ガソリン代,4023,0,4159861
10712,0001-20091106-16-1656-1-3773,0,2009-11-06,111,現金,スノーブレード代,7620,0,4167481
10752,0001-20091109-144-1669-1-3799,0,2009-11-09,111,現金,ガソリン代,6116,0,4173597
10755,0001-20091109-144-1669-1-3799,3,2009-11-09,111,現金,駐車代,2516,0,4176113
10757,0001-20091109-144-1669-1-3799,5,2009-11-09,111,現金,高速代,5833,0,4181946
10790,0001-20091110-147-1686-1-3833,0,2009-11-10,322,未払金,ガソリン代,6780,0,4188726
10907,0001-20091111-46-1691-1-3843,0,2009-11-11,111,現金,ガソリン代,8286,0,4197012
10910,0001-20091111-46-1691-1-3843,3,2009-11-11,111,現金,高速代,1239,0,4198251
10912,0001-20091111-46-1691-1-3843,5,2009-11-11,111,現金,駐車代,572,0,4198823
10933,0001-20091113-142-1700-1-3861,0,2009-11-13,111,現金,高速代,3446,0,4202269
10936,0001-20091113-142-1700-1-3861,3,2009-11-13,111,現金,高速代,2043,0,4204312
10938,0001-20091113-142-1700-1-3861,5,2009-11-13,111,現金,高速代,1195,0,4205507
10940,0001-20091113-142-1700-1-3861,7,2009-11-13,111,現金,駐車代,3000,0,4208507
10942,0001-20091113-142-1700-1-3861,9,2009-11-13,111,現金,ガソリン代,7220,0,4215727
10949,0001-20091113-17-1699-1-3859,0,2009-11-13,111,現金,ウォッシャー液,351,0,4216078
10965,0001-20091114-51-1703-1-3867,0,2009-11-14,111,現金,高速代,6477,0,4222555
10974,0001-20091115-11-1705-1-3871,0,2009-11-15,111,現金,ガソリン代,3058,0,4225613
11070,0001-20091116-47-1719-1-3899,0,2009-11-16,111,現金,ガソリン代,8286,0,4233899
11074,0001-20091116-82-1720-1-3901,0,2009-11-16,322,未払金,ガソリン代,20800,0,4254699
11077,0001-20091116-82-1720-1-3901,3,2009-11-16,322,未払金,ウォッシャー液,352,0,4255051
11092,0001-20091118-76-1726-1-3913,0,2009-11-18,111,現金,ガソリン代,3686,0,4258737
11095,0001-20091118-76-1726-1-3913,3,2009-11-18,111,現金,高速代,762,0,4259499
11098,0001-20091119-12-1729-1-3919,0,2009-11-19,111,現金,ガソリン代,4456,0,4263955
11101,0001-20091119-12-1729-1-3919,3,2009-11-19,111,現金,高速代,1572,0,4265527
11103,0001-20091119-12-1729-1-3919,5,2009-11-19,111,現金,駐車代,762,0,4266289
11110,0001-20091119-52-1731-1-3923,0,2009-11-19,111,現金,高速代,1096,0,4267385
11113,0001-20091119-52-1731-1-3923,3,2009-11-19,111,現金,駐車代,2191,0,4269576
11214,0001-20091120-53-1736-1-3933,0,2009-11-20,111,現金,高速代,381,0,4269957
11217,0001-20091120-53-1736-1-3933,3,2009-11-20,111,現金,高速代,1000,0,4270957
11219,0001-20091120-53-1736-1-3933,5,2009-11-20,111,現金,高速代,1000,0,4271957
11308,0001-20091122-48-1762-1-3985,0,2009-11-22,111,現金,ガソリン代,3298,0,4275255
11328,0001-20091123-13-1772-1-4005,0,2009-11-23,111,現金,ガソリン代,10477,0,4285732
11481,0001-20091124-77-1779-1-4019,0,2009-11-24,111,現金,ガソリン代,3053,0,4288785
11484,0001-20091124-77-1779-1-4019,3,2009-11-24,111,現金,駐車代,572,0,4289357
11487,0001-20091124-83-1780-1-4021,0,2009-11-24,111,現金,車両管理費,30000,0,4319357
11502,0001-20091125-109-1790-1-4041,0,2009-11-25,322,未払金,高速代,9853,0,4329210
11505,0001-20091125-109-1790-1-4041,3,2009-11-25,322,未払金,ガソリン代,53430,0,4382640
11580,0001-20091126-54-1797-1-4055,0,2009-11-26,111,現金,高速代,2381,0,4385021
11603,0001-20091127-14-1801-1-4063,0,2009-11-27,111,現金,ガソリン代,2858,0,4387879
11607,0001-20091127-15-1802-1-4065,0,2009-11-27,111,現金,車両管理費,85715,0,4473594
11663,0001-20091129-137-1817-1-4095,5,2009-11-29,131,普通預金,高速料,62289,0,4535883
11688,0001-20091129-148-1819-1-4099,0,2009-11-29,111,現金,ガソリン代,4762,0,4540645
12023,0001-20091130-155-1871-1-4203,0,2009-11-30,322,未払金,点検整備,24210,0,4564855
12037,0001-20091130-49-1824-1-4109,0,2009-11-30,111,現金,ガソリン代,138096,0,4702951
12047,0001-20091130-55-1825-1-4111,0,2009-11-30,111,現金,車両管理費,11905,0,4714856
12050,0001-20091130-55-1825-1-4111,3,2009-11-30,111,現金,駐車代,7667,0,4722523
12073,0001-20091130-70-1829-1-4119,5,2009-11-30,131,普通預金,高速料,69824,0,4792347
,,,2009-11,,※※月計※※,,676613,0,
12118,0001-20091201-10-1872-1-4205,0,2009-12-01,111,現金,洗車代,2858,0,4795205
12122,0001-20091201-143-1876-1-4213,0,2009-12-01,111,現金,点検作業料,28000,0,4823205
12148,0001-20091203-147-1879-1-4219,0,2009-12-03,322,未払金,ガソリン代,5943,0,4829148
12166,0001-20091205-50-1881-1-4223,0,2009-12-05,111,現金,高速代,3334,0,4832482
12217,0001-20091207-16-1891-1-4243,0,2009-12-07,111,現金,ガソリン代,2858,0,4835340
12220,0001-20091207-16-1891-1-4243,3,2009-12-07,111,現金,駐車代,378,0,4835718
12248,0001-20091208-142-1900-1-4261,0,2009-12-08,111,現金,高速代,3102,0,4838820
12251,0001-20091208-142-1900-1-4261,3,2009-12-08,111,現金,高速代,9373,0,4848193
12253,0001-20091208-142-1900-1-4261,5,2009-12-08,111,現金,高速代,3404,0,4851597
12255,0001-20091208-142-1900-1-4261,7,2009-12-08,111,現金,高速代,6229,0,4857826
12257,0001-20091208-142-1900-1-4261,9,2009-12-08,111,現金,高速代,4353,0,4862179
12259,0001-20091208-142-1900-1-4261,11,2009-12-08,111,現金,ガソリン代,5715,0,4867894
12384,0001-20091210-82-1910-1-4281,0,2009-12-10,322,未払金,ガソリン代,16252,0,4884146
12416,0001-20091211-82-1925-1-4311,0,2009-12-11,111,現金,ガソリン代,4014,0,4888160
12419,0001-20091211-82-1925-1-4311,3,2009-12-11,111,現金,高速代,572,0,4888732
12428,0001-20091213-11-1929-1-4319,0,2009-12-13,111,現金,高速代,2667,0,4891399
12431,0001-20091213-11-1929-1-4319,3,2009-12-13,111,現金,ガソリン代,4381,0,4895780
12457,0001-20091214-46-1933-1-4327,0,2009-12-14,111,現金,ガソリン代,7429,0,4903209
12460,0001-20091214-46-1933-1-4327,3,2009-12-14,111,現金,駐車代,1239,0,4904448
12462,0001-20091214-46-1933-1-4327,5,2009-12-14,111,現金,高速代,3334,0,4907782
12465,0001-20091214-51-1934-1-4329,0,2009-12-14,111,現金,高速代,5096,0,4912878
12468,0001-20091214-51-1934-1-4329,3,2009-12-14,111,現金,ガソリン代,6381,0,4919259
12470,0001-20091214-51-1934-1-4329,5,2009-12-14,111,現金,駐車代,2191,0,4921450
12539,0001-20091215-83-1937-1-4335,0,2009-12-15,111,現金,ガソリン代,6229,0,4927679
12542,0001-20091215-83-1937-1-4335,3,2009-12-15,111,現金,高速代,4020,0,4931699
12544,0001-20091215-83-1937-1-4335,5,2009-12-15,111,現金,駐車代,800,0,4932499
12560,0001-20091216-144-1952-1-4365,0,2009-12-16,111,現金,ウォッシャー液代,572,0,4933071
12563,0001-20091216-144-1952-1-4365,3,2009-12-16,111,現金,ガソリン代,6229,0,4939300
12565,0001-20091216-144-1952-1-4365,5,2009-12-16,111,現金,ガソリン代,8096,0,4947396
12594,0001-20091217-12-1956-1-4373,0,2009-12-17,111,現金,ガソリン代,7473,0,4954869
12597,0001-20091217-12-1956-1-4373,3,2009-12-17,111,現金,ガソリン代,2858,0,4957727
12599,0001-20091217-12-1956-1-4373,5,2009-12-17,111,現金,ガソリン代,6174,0,4963901
12601,0001-20091217-12-1956-1-4373,7,2009-12-17,111,現金,高速代,2000,0,4965901
12616,0001-20091217-52-1959-1-4379,0,2009-12-17,111,現金,高速代,1096,0,4966997
12619,0001-20091217-52-1959-1-4379,3,2009-12-17,111,現金,高速代,1096,0,4968093
12621,0001-20091217-52-1959-1-4379,5,2009-12-17,111,現金,高速代,1429,0,4969522
12640,0001-20091219-148-1969-1-4399,0,2009-12-19,111,現金,ガソリン代,5040,0,4974562
12644,0001-20091219-47-1966-1-4393,0,2009-12-19,111,現金,ガソリン代,2420,0,4976982
12741,0001-20091220-48-1972-1-4405,0,2009-12-20,111,現金,ガソリン代,4099,0,4981081
12753,0001-20091220-75-1975-1-4411,0,2009-12-20,111,現金,ガソリン代,2858,0,4983939
12756,0001-20091220-75-1975-1-4411,3,2009-12-20,111,現金,駐車代,286,0,4984225
12758,0001-20091220-75-1975-1-4411,5,2009-12-20,111,現金,駐車代,381,0,4984606
12876,0001-20091222-53-2006-1-4473,0,2009-12-22,111,現金,高速代,381,0,4984987
12879,0001-20091222-53-2006-1-4473,3,2009-12-22,111,現金,駐車代,1762,0,4986749
12897,0001-20091222-84-2009-1-4479,0,2009-12-22,111,現金,ガソリン代,6501,0,4993250
12951,0001-20091224-54-2024-1-4509,0,2009-12-24,111,現金,高速代,1810,0,4995060
12954,0001-20091224-54-2024-1-4509,3,2009-12-24,111,現金,ガソリン代,2572,0,4997632
13229,0001-20091226-49-2046-1-4553,0,2009-12-26,111,現金,ガソリン代,117143,0,5114775
13232,0001-20091226-49-2046-1-4553,3,2009-12-26,111,現金,駐車代,2620,0,5117395
13235,0001-20091226-49-2046-1-4553,6,2009-12-26,111,現金,高速代,1191,0,5118586
13248,0001-20091227-13-2051-1-4563,0,2009-12-27,111,現金,ガソリン代,12381,0,5130967
13252,0001-20091227-14-2052-1-4565,0,2009-12-27,111,現金,洗車代,2858,0,5133825
13256,0001-20091227-148-2054-1-4569,0,2009-12-27,111,現金,ガソリン代,5422,0,5139247
13259,0001-20091227-148-2054-1-4569,3,2009-12-27,111,現金,洗車代,1000,0,5140247
13313,0001-20091228-55-2062-1-4585,0,2009-12-28,111,現金,車両管理費,11429,0,5151676
13324,0001-20091228-83-2065-1-4591,0,2009-12-28,111,現金,車両管理費,48762,0,5200438
13327,0001-20091228-83-2065-1-4591,3,2009-12-28,111,現金,ガソリン代,18573,0,5219011
13354,0001-20091230-109-2073-1-4607,0,2009-12-30,322,未払金,ガソリン代,58757,0,5277768
13371,0001-20091230-137-2076-1-4613,5,2009-12-30,131,普通預金,高速料,50777,0,5328545
13380,0001-20091230-138-2077-1-4615,0,2009-12-30,111,現金,駐車場代,3410,0,5331955
13383,0001-20091230-138-2077-1-4615,3,2009-12-30,111,現金,高速代,2524,0,5334479
13385,0001-20091230-138-2077-1-4615,5,2009-12-30,111,現金,高速代,3667,0,5338146
13387,0001-20091230-138-2077-1-4615,7,2009-12-30,111,現金,高速代,1096,0,5339242
13389,0001-20091230-138-2077-1-4615,9,2009-12-30,111,現金,高速代,3000,0,5342242
13391,0001-20091230-138-2077-1-4615,11,2009-12-30,111,現金,高速代,1096,0,5343338
13393,0001-20091230-138-2077-1-4615,13,2009-12-30,111,現金,ガソリン代,3810,0,5347148
13396,0001-20091230-155-2078-1-4617,0,2009-12-30,111,現金,車両管理費,23810,0,5370958
13405,0001-20091230-70-2070-1-4601,5,2009-12-30,131,普通預金,高速料,51048,0,5422006
,,,2009-12,,※※月計※※,,629659,0,
13768,0001-20100105-143-2122-1-4705,0,2010-01-05,111,現金,点検作業料,29715,0,5451721
13842,0001-20100108-50-2134-1-4729,0,2010-01-08,111,現金,高速代,1143,0,5452864
13871,0001-20100110-142-2155-1-4771,0,2010-01-10,111,現金,高速代,3382,0,5456246
13874,0001-20100110-142-2155-1-4771,3,2010-01-10,111,現金,駐車代,5343,0,5461589
13876,0001-20100110-142-2155-1-4771,5,2010-01-10,111,現金,高速代,2223,0,5463812
13878,0001-20100110-142-2155-1-4771,7,2010-01-10,111,現金,高速代,4306,0,5468118
13880,0001-20100110-142-2155-1-4771,9,2010-01-10,111,現金,高速代,429,0,5468547
13895,0001-20100110-16-2140-1-4741,0,2010-01-10,111,現金,高速代,381,0,5468928
13898,0001-20100110-16-2140-1-4741,3,2010-01-10,111,現金,駐車代,762,0,5469690
13984,0001-20100111-147-2168-1-4797,0,2010-01-11,322,未払金,ガソリン代,6265,0,5475955
14054,0001-20100113-11-2175-1-4811,0,2010-01-13,111,現金,ガソリン代,3058,0,5479013
14058,0001-20100113-17-2176-1-4813,0,2010-01-13,111,現金,駐車代,286,0,5479299
14061,0001-20100113-17-2176-1-4813,3,2010-01-13,111,現金,駐車代,762,0,5480061
14072,0001-20100114-46-2178-1-4817,0,2010-01-14,111,現金,ガソリン代,2341,0,5482402
14075,0001-20100114-46-2178-1-4817,3,2010-01-14,111,現金,ガソリン代,4767,0,5487169
14077,0001-20100114-46-2178-1-4817,5,2010-01-14,111,現金,ガソリン代,4880,0,5492049
14080,0001-20100114-51-2179-1-4819,0,2010-01-14,111,現金,高速代,1505,0,5493554
14083,0001-20100114-51-2179-1-4819,3,2010-01-14,111,現金,高速代,620,0,5494174
14085,0001-20100114-51-2179-1-4819,5,2010-01-14,111,現金,高速代,810,0,5494984
14087,0001-20100114-51-2179-1-4819,7,2010-01-14,111,現金,高速代,1096,0,5496080
14089,0001-20100114-51-2179-1-4819,9,2010-01-14,111,現金,高速代,1096,0,5497176
14091,0001-20100114-51-2179-1-4819,11,2010-01-14,111,現金,高速代,1096,0,5498272
14093,0001-20100114-51-2179-1-4819,13,2010-01-14,111,現金,高速代,953,0,5499225
14119,0001-20100115-109-2193-1-4847,0,2010-01-15,322,未払金,ガソリン代,48000,0,5547225
14219,0001-20100117-47-2202-1-4865,0,2010-01-17,111,現金,ガソリン代,2420,0,5549645
14223,0001-20100117-52-2203-1-4867,0,2010-01-17,111,現金,高速代,1096,0,5550741
14226,0001-20100117-52-2203-1-4867,3,2010-01-17,111,現金,高速代,1096,0,5551837
14228,0001-20100117-52-2203-1-4867,5,2010-01-17,111,現金,高速代,1429,0,5553266
14231,0001-20100118-148-2207-1-4875,0,2010-01-18,111,現金,ガソリン代,6613,0,5559879
14234,0001-20100118-148-2207-1-4875,3,2010-01-18,111,現金,高速代,620,0,5560499
14301,0001-20100120-12-2211-1-4883,0,2010-01-20,111,現金,ガソリン代,4762,0,5565261
14304,0001-20100120-12-2211-1-4883,3,2010-01-20,111,現金,ガソリン代,4431,0,5569692
14321,0001-20100120-144-2237-1-4935,0,2010-01-20,111,現金,ガソリン代,4351,0,5574043
14324,0001-20100120-144-2237-1-4935,3,2010-01-20,111,現金,ガソリン代,7162,0,5581205
14326,0001-20100120-144-2237-1-4935,5,2010-01-20,111,現金,ガソリン代,305,0,5581510
14353,0001-20100120-48-2215-1-4891,0,2010-01-20,111,現金,ガソリン代,4099,0,5585609
14357,0001-20100120-53-2216-1-4893,0,2010-01-20,111,現金,高速代,381,0,5585990
14360,0001-20100120-53-2216-1-4893,3,2010-01-20,111,現金,高速代,1000,0,5586990
14362,0001-20100120-53-2216-1-4893,5,2010-01-20,111,現金,高速代,1000,0,5587990
14443,0001-20100121-82-2242-1-4945,0,2010-01-21,322,未払金,ガソリン代,20309,0,5608299
14447,0001-20100122-138-2249-1-4959,0,2010-01-22,111,現金,駐車代,4430,0,5612729
14450,0001-20100122-138-2249-1-4959,3,2010-01-22,111,現金,高速代,8115,0,5620844
14452,0001-20100122-138-2249-1-4959,5,2010-01-22,111,現金,高速代,1166,0,5622010
14454,0001-20100122-138-2249-1-4959,7,2010-01-22,111,現金,高速代,6230,0,5628240
14456,0001-20100122-138-2249-1-4959,9,2010-01-22,111,現金,高速代,2140,0,5630380
14458,0001-20100122-138-2249-1-4959,11,2010-01-22,111,現金,ガソリン代,9059,0,5639439
14497,0001-20100123-54-2254-1-4969,0,2010-01-23,111,現金,高速代,1810,0,5641249
14500,0001-20100123-54-2254-1-4969,3,2010-01-23,111,現金,高速代,2572,0,5643821
14522,0001-20100124-137-2260-1-4981,5,2010-01-24,131,普通預金,高速料,22426,0,5666247
14530,0001-20100124-137-2260-1-4981,11,2010-01-24,111,現金,ガソリン代,12582,0,5678829
14538,0001-20100124-155-2262-1-4985,0,2010-01-24,111,現金,ガソリン代,6761,0,5685590
14757,0001-20100127-14-2281-1-5023,0,2010-01-27,111,現金,ガソリン代,2858,0,5688448
14778,0001-20100128-13-2287-1-5035,0,2010-01-28,111,現金,タイヤ交換代,2400,0,5690848
14798,0001-20100128-83-2291-1-5043,0,2010-01-28,111,現金,車両管理費,42858,0,5733706
14842,0001-20100130-49-2293-1-5047,0,2010-01-30,322,未払金,ガソリン代,155686,0,5889392
14845,0001-20100130-49-2293-1-5047,3,2010-01-30,111,現金,ガソリン代,2626,0,5892018
14848,0001-20100130-49-2293-1-5047,6,2010-01-30,111,現金,ガソリン代,5729,0,5897747
14851,0001-20100130-55-2294-1-5049,0,2010-01-30,111,現金,車両管理費,23810,0,5921557
14854,0001-20100130-55-2294-1-5049,3,2010-01-30,111,現金,車両管理費,26667,0,5948224
14856,0001-20100130-55-2294-1-5049,5,2010-01-30,111,現金,高速代,7667,0,5955891
14864,0001-20100130-70-2295-1-5051,5,2010-01-30,131,普通預金,高速料,69824,0,6025715
14873,0001-20100130-80-2296-1-5053,0,2010-01-30,111,現金,ガソリン代,5834,0,6031549
,,,2010-01,,※※月計※※,,609543,0,
15298,0001-20100204-147-2359-1-5179,0,2010-02-04,322,未払金,ガソリン代,6375,0,6037924
15312,0001-20100205-142-2366-1-5193,0,2010-02-05,111,現金,高速代,4991,0,6042915
15315,0001-20100205-142-2366-1-5193,3,2010-02-05,111,現金,高速代,3004,0,6045919
15317,0001-20100205-142-2366-1-5193,5,2010-02-05,111,現金,高速代,4561,0,6050480
15369,0001-20100207-143-2374-1-5209,0,2010-02-07,111,現金,車両管理料,22096,0,6072576
15385,0001-20100208-50-2375-1-5211,0,2010-02-08,111,現金,高速代,1143,0,6073719
15389,0001-20100208-75-2376-1-5213,0,2010-02-08,111,現金,ガソリン代,6630,0,6080349
15392,0001-20100208-75-2376-1-5213,3,2010-02-08,111,現金,高速代,2286,0,6082635
15394,0001-20100208-75-2376-1-5213,5,2010-02-08,111,現金,駐車代,762,0,6083397
15401,0001-20100210-10-2379-1-5219,0,2010-02-10,111,現金,ガソリン代,2858,0,6086255
15441,0001-20100210-76-2383-1-5227,0,2010-02-10,111,現金,ガソリン代,5726,0,6091981
15563,0001-20100213-17-2409-1-5279,0,2010-02-13,111,現金,駐車代,381,0,6092362
15566,0001-20100213-17-2409-1-5279,3,2010-02-13,111,現金,高速代,2000,0,6094362
15575,0001-20100213-82-2411-1-5283,0,2010-02-13,322,未払金,ガソリン代,30028,0,6124390
15579,0001-20100214-46-2412-1-5285,0,2010-02-14,111,現金,ガソリン代,2341,0,6126731
15582,0001-20100214-46-2412-1-5285,3,2010-02-14,111,現金,ガソリン代,4767,0,6131498
15584,0001-20100214-46-2412-1-5285,5,2010-02-14,111,現金,ガソリン代,4880,0,6136378
15587,0001-20100214-51-2413-1-5287,0,2010-02-14,111,現金,高速代,1505,0,6137883
15590,0001-20100214-51-2413-1-5287,3,2010-02-14,111,現金,高速代,620,0,6138503
15592,0001-20100214-51-2413-1-5287,5,2010-02-14,111,現金,高速代,810,0,6139313
15594,0001-20100214-51-2413-1-5287,7,2010-02-14,111,現金,高速代,1096,0,6140409
15596,0001-20100214-51-2413-1-5287,9,2010-02-14,111,現金,高速代,1096,0,6141505
15598,0001-20100214-51-2413-1-5287,11,2010-02-14,111,現金,高速代,1096,0,6142601
15600,0001-20100214-51-2413-1-5287,13,2010-02-14,111,現金,高速代,953,0,6143554
15685,0001-20100216-11-2430-1-5321,0,2010-02-16,111,現金,ガソリン代,3058,0,6146612
15693,0001-20100216-148-2434-1-5329,0,2010-02-16,111,現金,ガソリン代,3400,0,6150012
15717,0001-20100217-47-2436-1-5333,0,2010-02-17,111,現金,ガソリン代,2420,0,6152432
15721,0001-20100217-52-2437-1-5335,0,2010-02-17,111,現金,高速代,1096,0,6153528
15724,0001-20100217-52-2437-1-5335,3,2010-02-17,111,現金,高速代,1096,0,6154624
15726,0001-20100217-52-2437-1-5335,5,2010-02-17,111,現金,高速代,1429,0,6156053
15741,0001-20100219-138-2443-1-5347,0,2010-02-19,111,現金,高速代,7187,0,6163240
15744,0001-20100219-138-2443-1-5347,3,2010-02-19,111,現金,駐車代,3086,0,6166326
15746,0001-20100219-138-2443-1-5347,5,2010-02-19,111,現金,高速代,305,0,6166631
15748,0001-20100219-138-2443-1-5347,7,2010-02-19,111,現金,高速代,8329,0,6174960
15750,0001-20100219-138-2443-1-5347,9,2010-02-19,111,現金,高速代,5181,0,6180141
15818,0001-20100220-144-2467-1-5395,0,2010-02-20,111,現金,ガソリン代,4286,0,6184427
15821,0001-20100220-144-2467-1-5395,3,2010-02-20,111,現金,ガソリン代,5919,0,6190346
15855,0001-20100220-48-2448-1-5357,0,2010-02-20,111,現金,ガソリン代,4099,0,6194445
15859,0001-20100220-53-2449-1-5359,0,2010-02-20,111,現金,高速代,381,0,6194826
15862,0001-20100220-53-2449-1-5359,3,2010-02-20,111,現金,高速代,1000,0,6195826
15864,0001-20100220-53-2449-1-5359,5,2010-02-20,111,現金,高速代,1000,0,6196826
15920,0001-20100221-137-2476-1-5413,5,2010-02-21,131,普通預金,高速料,12897,0,6209723
15953,0001-20100222-12-2477-1-5415,0,2010-02-22,111,現金,ガソリン代,3810,0,6213533
15956,0001-20100222-12-2477-1-5415,3,2010-02-22,111,現金,ガソリン代,5715,0,6219248
15959,0001-20100222-155-2480-1-5421,0,2010-02-22,111,現金,ガソリン代,5926,0,6225174
15995,0001-20100223-54-2486-1-5433,0,2010-02-23,111,現金,高速代,1810,0,6226984
15998,0001-20100223-54-2486-1-5433,3,2010-02-23,111,現金,高速代,2572,0,6229556
16151,0001-20100224-83-2493-1-5447,0,2010-02-24,111,現金,車両管理費,36858,0,6266414
16212,0001-20100226-109-2514-1-5489,0,2010-02-26,322,未払金,ガソリン代,44274,0,6310688
16269,0001-20100227-15-2520-1-5501,0,2010-02-27,111,現金,高速代,2000,0,6312688
16288,0001-20100227-77-2523-1-5507,0,2010-02-27,111,現金,ガソリン代,4893,0,6317581
16291,0001-20100227-77-2523-1-5507,3,2010-02-27,111,現金,洗車代,1143,0,6318724
16654,0001-20100228-49-2535-1-5531,0,2010-02-28,322,未払金,ガソリン代,155686,0,6474410
16657,0001-20100228-49-2535-1-5531,3,2010-02-28,111,現金,ガソリン代,2626,0,6477036
16660,0001-20100228-49-2535-1-5531,6,2010-02-28,111,現金,ガソリン代,5729,0,6482765
16669,0001-20100228-55-2536-1-5533,0,2010-02-28,111,現金,車両管理費,23810,0,6506575
16672,0001-20100228-55-2536-1-5533,3,2010-02-28,111,現金,車両管理費,26667,0,6533242
16674,0001-20100228-55-2536-1-5533,5,2010-02-28,111,現金,高速代,7667,0,6540909
16696,0001-20100228-70-2538-1-5537,5,2010-02-28,131,普通預金,高速料,69824,0,6610733
,,,2010-02,,※※月計※※,,579184,0,
16756,0001-20100303-142-2586-1-5633,0,2010-03-03,111,現金,高速代,220,0,6610953
16759,0001-20100303-142-2586-1-5633,3,2010-03-03,111,現金,ガソリン代,3338,0,6614291
16761,0001-20100303-142-2586-1-5633,5,2010-03-03,111,現金,高速代,5228,0,6619519
16763,0001-20100303-142-2586-1-5633,7,2010-03-03,111,現金,高速代,2461,0,6621980
16765,0001-20100303-142-2586-1-5633,9,2010-03-03,111,現金,高速代,3373,0,6625353
16767,0001-20100303-142-2586-1-5633,11,2010-03-03,111,現金,高速代,8105,0,6633458
16827,0001-20100306-147-2597-1-5655,0,2010-03-06,322,未払金,ガソリン代,6033,0,6639491
16839,0001-20100307-10-2598-1-5657,0,2010-03-07,111,現金,駐車代,286,0,6639777
16871,0001-20100308-50-2605-1-5671,0,2010-03-08,111,現金,高速代,1143,0,6640920
16879,0001-20100310-11-2608-1-5677,0,2010-03-10,111,現金,ガソリン代,4412,0,6645332
16894,0001-20100310-143-2625-1-5711,0,2010-03-10,111,現金,点検作業料,11905,0,6657237
16970,0001-20100310-78-2616-1-5693,0,2010-03-10,111,現金,ガソリン代,5623,0,6662860
16973,0001-20100310-78-2616-1-5693,3,2010-03-10,111,現金,高速代,1715,0,6664575
17030,0001-20100313-144-2636-1-5733,0,2010-03-13,111,現金,ガソリン代,2382,0,6666957
17033,0001-20100313-144-2636-1-5733,3,2010-03-13,111,現金,ガソリン代,7487,0,6674444
17035,0001-20100313-144-2636-1-5733,5,2010-03-13,111,現金,高速代,7662,0,6682106
17046,0001-20100314-17-2638-1-5737,0,2010-03-14,111,現金,ウォッシャー液,351,0,6682457
17050,0001-20100314-46-2639-1-5739,0,2010-03-14,111,現金,ガソリン代,2341,0,6684798
17053,0001-20100314-46-2639-1-5739,3,2010-03-14,111,現金,ガソリン代,4767,0,6689565
17055,0001-20100314-46-2639-1-5739,5,2010-03-14,111,現金,ガソリン代,4880,0,6694445
17058,0001-20100314-51-2640-1-5741,0,2010-03-14,111,現金,高速代,1505,0,6695950
17061,0001-20100314-51-2640-1-5741,3,2010-03-14,111,現金,高速代,620,0,6696570
17063,0001-20100314-51-2640-1-5741,5,2010-03-14,111,現金,高速代,810,0,6697380
17065,0001-20100314-51-2640-1-5741,7,2010-03-14,111,現金,高速代,1096,0,6698476
17067,0001-20100314-51-2640-1-5741,9,2010-03-14,111,現金,高速代,1096,0,6699572
17069,0001-20100314-51-2640-1-5741,11,2010-03-14,111,現金,高速代,1096,0,6700668
17071,0001-20100314-51-2640-1-5741,13,2010-03-14,111,現金,高速代,953,0,6701621
17080,0001-20100314-82-2642-1-5745,0,2010-03-14,322,未払金,ガソリン代,29910,0,6731531
17173,0001-20100316-148-2658-1-5777,0,2010-03-16,111,現金,ガソリン代,5319,0,6736850
17191,0001-20100317-47-2661-1-5783,0,2010-03-17,111,現金,ガソリン代,2420,0,6739270
17195,0001-20100317-52-2662-1-5785,0,2010-03-17,111,現金,高速代,1096,0,6740366
17198,0001-20100317-52-2662-1-5785,3,2010-03-17,111,現金,高速代,1096,0,6741462
17200,0001-20100317-52-2662-1-5785,5,2010-03-17,111,現金,高速代,1429,0,6742891
17267,0001-20100320-109-2687-1-5835,0,2010-03-20,322,未払金,ガソリン代,75226,0,6818117
17320,0001-20100320-48-2672-1-5805,0,2010-03-20,111,現金,ガソリン代,4099,0,6822216
17324,0001-20100320-53-2673-1-5807,0,2010-03-20,111,現金,高速代,381,0,6822597
17327,0001-20100320-53-2673-1-5807,3,2010-03-20,111,現金,高速代,1000,0,6823597
17329,0001-20100320-53-2673-1-5807,5,2010-03-20,111,現金,高速代,1000,0,6824597
17441,0001-20100322-74-2707-1-5875,0,2010-03-22,111,現金,ガソリン代,6771,0,6831368
17444,0001-20100322-74-2707-1-5875,3,2010-03-22,111,現金,高速代,5143,0,6836511
17455,0001-20100323-12-2713-1-5887,0,2010-03-23,111,現金,ガソリン代,3298,0,6839809
17458,0001-20100323-12-2713-1-5887,3,2010-03-23,111,現金,駐車代,762,0,6840571
17469,0001-20100323-54-2715-1-5891,0,2010-03-23,111,現金,高速代,1810,0,6842381
17472,0001-20100323-54-2715-1-5891,3,2010-03-23,111,現金,高速代,2572,0,6844953
17475,0001-20100323-75-2716-1-5893,0,2010-03-23,111,現金,ガソリン代,5686,0,6850639
17673,0001-20100325-138-2736-1-5933,0,2010-03-25,111,現金,高速代,4351,0,6854990
17676,0001-20100325-138-2736-1-5933,3,2010-03-25,111,現金,ガソリン代,3408,0,6858398
17678,0001-20100325-138-2736-1-5933,5,2010-03-25,111,現金,高速代,5686,0,6864084
17680,0001-20100325-138-2736-1-5933,7,2010-03-25,111,現金,高速代,4287,0,6868371
17682,0001-20100325-138-2736-1-5933,9,2010-03-25,111,現金,高速代,2569,0,6870940
17684,0001-20100325-138-2736-1-5933,11,2010-03-25,111,現金,高速代,1096,0,6872036
17686,0001-20100325-138-2736-1-5933,13,2010-03-25,111,現金,駐車代,3372,0,6875408
17740,0001-20100326-76-2743-1-5947,0,2010-03-26,111,現金,ガソリン代,4961,0,6880369
17743,0001-20100326-76-2743-1-5947,3,2010-03-26,111,現金,駐車代,572,0,6880941
17756,0001-20100327-14-2749-1-5959,0,2010-03-27,111,現金,ガソリン代,2858,0,6883799
17792,0001-20100328-137-2759-1-5979,5,2010-03-28,131,普通預金,高速料,40621,0,6924420
17825,0001-20100329-83-2762-1-5985,0,2010-03-29,111,現金,車両管理費,49048,0,6973468
17843,0001-20100330-155-2765-1-5991,0,2010-03-30,111,現金,ガソリン代,6801,0,6980269
17846,0001-20100330-155-2765-1-5991,3,2010-03-30,111,現金,高速代,1143,0,6981412
18092,0001-20100331-13-2768-1-5997,0,2010-03-31,111,現金,ガソリン代,9524,0,6990936
18183,0001-20100331-15-2769-1-5999,0,2010-03-31,111,現金,洗車代,2858,0,6993794
18228,0001-20100331-49-2772-1-6005,0,2010-03-31,322,未払金,ガソリン代,155686,0,7149480
18231,0001-20100331-49-2772-1-6005,3,2010-03-31,111,現金,ガソリン代,2626,0,7152106
18234,0001-20100331-49-2772-1-6005,6,2010-03-31,111,現金,ガソリン代,5729,0,7157835
18243,0001-20100331-55-2773-1-6007,0,2010-03-31,111,現金,車両管理費,23810,0,7181645
18246,0001-20100331-55-2773-1-6007,3,2010-03-31,111,現金,車両管理費,26667,0,7208312
18248,0001-20100331-55-2773-1-6007,5,2010-03-31,111,現金,高速代,7667,0,7215979
18279,0001-20100331-70-2778-1-6017,5,2010-03-31,131,普通預金,高速料,69824,0,7285803
,,,2010-03,,※※月計※※,高速料,675070,0,7285803
